bookid	responseid	num_sentences	Emotional_impact	Narrative_feeling	Reflection	Aesthetic_feeling	All
41143	398344	26	3	2	1	2	8
41143	397239	21	3	5	0	1	9
41143	397240	21	3	5	0	1	9
41143	397263	21	8	0	0	2	10
41143	397501	21	1	2	0	7	10
41143	193959	20	4	2	1	0	7
41143	279821	20	4	2	1	0	7
41143	397728	20	3	3	1	0	7
41143	397618	19	3	2	2	2	9
41143	397955	19	1	1	0	4	6
41143	397664	17	0	0	0	3	3
41143	397708	17	3	5	0	0	8
41143	279819	16	0	0	2	0	2
41143	397281	15	2	6	1	0	9
41143	397892	15	2	1	0	1	4
41143	397944	15	4	1	0	1	6
41143	217443	14	2	0	1	0	3
41143	279835	14	2	0	0	1	3
41143	397211	14	0	2	2	1	5
41143	397472	14	2	2	3	1	8
41143	397473	14	2	1	1	0	4
41143	397929	14	1	0	0	0	1
41143	397977	14	5	0	0	0	5
41143	397369	13	5	0	0	0	5
41143	397939	13	2	1	1	0	4
41143	398105	13	3	1	0	3	7
41143	279831	12	3	2	1	2	8
41143	279837	12	2	2	0	1	5
41143	397210	12	2	1	0	0	3
41143	397241	12	2	2	0	5	9
41143	397267	12	3	2	1	1	7
41143	397269	12	1	1	1	1	4
41143	397610	12	3	0	0	3	6
41143	397614	12	1	2	0	1	4
41143	397905	12	4	3	0	0	7
41143	183406	11	1	2	0	0	3
41143	397213	11	1	2	2	0	5
41143	397227	11	0	0	0	0	0
41143	397245	11	1	1	0	1	3
41143	397250	11	0	3	1	0	4
41143	397419	11	2	1	1	2	6
41143	397458	11	2	2	0	0	4
41143	397550	11	1	3	2	1	7
41143	397628	11	2	0	0	1	3
41143	397707	11	4	3	0	2	9
41143	397834	11	2	1	0	0	3
41143	398107	11	5	2	0	1	8
41143	398303	11	5	1	0	3	9
41143	187901	10	3	2	1	1	7
41143	200382	10	1	1	0	3	5
41143	220591	10	3	1	2	4	10
41143	279822	10	3	1	0	1	5
41143	279823	10	2	1	1	0	4
41143	397236	10	5	0	0	3	8
41143	397253	10	2	1	0	2	5
41143	397256	10	0	1	1	0	2
41143	397414	10	2	0	1	0	3
41143	397455	10	3	0	0	1	4
41143	397471	10	2	2	0	4	8
41143	397491	10	2	1	0	2	5
41143	397495	10	1	0	0	2	3
41143	398028	10	2	2	0	2	6
41143	398056	10	1	1	1	0	3
41143	398317	10	0	0	0	2	2
41143	398342	10	2	3	0	1	6
41143	185181	9	1	1	3	1	6
41143	209821	9	0	0	0	0	0
41143	212273	9	4	1	1	0	6
41143	217228	9	1	1	0	1	3
41143	219051	9	0	3	1	0	4
41143	369565	9	1	3	0	3	7
41143	397252	9	1	2	0	2	5
41143	397394	9	2	1	0	1	4
41143	397441	9	2	2	0	0	4
41143	397500	9	2	0	1	2	5
41143	397526	9	6	1	0	2	9
41143	397561	9	0	0	0	2	2
41143	397661	9	4	2	0	2	8
41143	397686	9	2	0	0	0	2
41143	397861	9	2	0	0	0	2
41143	397870	9	0	1	2	1	4
41143	397897	9	1	2	0	1	4
41143	397900	9	2	1	0	1	4
41143	397947	9	2	4	1	2	9
41143	397981	9	0	1	1	1	3
41143	398008	9	1	0	0	1	2
41143	398165	9	2	2	0	3	7
41143	398227	9	5	3	0	0	8
41143	398319	9	0	2	0	0	2
41143	398333	9	1	1	0	0	2
41143	398349	9	4	2	0	1	7
41143	189641	8	0	1	0	3	4
41143	198111	8	1	0	0	1	2
41143	279840	8	1	0	0	0	1
41143	369564	8	2	0	1	3	6
41143	397225	8	4	0	1	0	5
41143	397226	8	0	1	0	0	1
41143	397235	8	2	2	0	0	4
41143	397242	8	3	2	0	1	6
41143	397244	8	2	1	0	3	6
41143	397285	8	2	1	1	3	7
41143	397389	8	1	0	1	1	3
41143	397439	8	2	2	0	3	7
41143	397474	8	3	2	0	2	7
41143	397480	8	2	1	0	0	3
41143	397506	8	3	0	0	5	8
41143	397523	8	4	1	1	0	6
41143	397530	8	6	0	0	3	9
41143	397566	8	1	2	0	1	4
41143	397570	8	0	0	0	3	3
41143	397589	8	0	2	1	0	3
41143	397592	8	2	2	0	1	5
41143	397597	8	1	3	3	1	8
41143	397625	8	1	3	0	1	5
41143	397675	8	2	0	0	1	3
41143	397726	8	1	0	0	1	2
41143	397762	8	0	2	0	1	3
41143	397794	8	0	2	0	0	2
41143	397804	8	2	1	0	0	3
41143	397824	8	3	2	0	0	5
41143	397839	8	0	0	0	1	1
41143	397852	8	1	1	1	2	5
41143	397860	8	3	2	1	1	7
41143	397901	8	0	1	0	0	1
41143	397919	8	1	0	0	0	1
41143	397921	8	2	2	3	2	9
41143	398011	8	2	0	0	1	3
41143	398018	8	0	1	0	0	1
41143	398158	8	1	2	0	0	3
41143	398177	8	3	3	0	1	7
41143	398186	8	3	2	0	0	5
41143	398211	8	2	0	0	1	3
41143	398253	8	2	2	1	3	8
41143	398278	8	1	1	0	0	2
41143	398291	8	2	3	0	0	5
41143	398332	8	2	2	0	3	7
41143	398352	8	1	1	0	0	2
41143	183251	7	2	1	0	1	4
41143	187954	7	1	3	0	1	5
41143	213341	7	1	2	0	1	4
41143	214430	7	1	2	0	5	8
41143	214687	7	2	1	2	1	6
41143	216004	7	2	2	0	2	6
41143	220970	7	0	1	0	2	3
41143	397243	7	2	1	0	4	7
41143	397283	7	0	0	0	0	0
41143	397371	7	1	1	0	1	3
41143	397379	7	2	1	0	1	4
41143	397385	7	1	3	1	2	7
41143	397469	7	2	0	1	2	5
41143	397485	7	2	0	1	0	3
41143	397542	7	0	1	0	0	1
41143	397545	7	2	1	0	2	5
41143	397552	7	0	2	0	0	2
41143	397572	7	0	1	0	0	1
41143	397575	7	0	1	0	0	1
41143	397604	7	1	1	0	0	2
41143	397611	7	2	0	0	1	3
41143	397624	7	1	1	0	1	3
41143	397631	7	3	2	0	1	6
41143	397653	7	1	2	0	0	3
41143	397680	7	2	4	0	0	6
41143	397692	7	0	0	1	1	2
41143	397693	7	2	1	0	0	3
41143	397700	7	1	1	0	1	3
41143	397738	7	0	0	0	0	0
41143	397743	7	0	0	0	3	3
41143	397756	7	1	0	0	0	1
41143	397764	7	1	5	0	1	7
41143	397774	7	2	0	0	2	4
41143	397785	7	0	0	0	2	2
41143	397786	7	3	0	0	1	4
41143	397791	7	2	3	0	0	5
41143	397792	7	0	2	1	0	3
41143	397798	7	1	0	1	0	2
41143	397813	7	1	0	0	0	1
41143	397819	7	1	1	0	0	2
41143	397866	7	0	0	0	2	2
41143	397867	7	1	1	0	2	4
41143	397874	7	3	1	0	0	4
41143	397894	7	0	1	0	0	1
41143	397896	7	1	1	0	0	2
41143	397959	7	1	2	0	1	4
41143	397975	7	0	0	0	0	0
41143	397984	7	1	2	0	0	3
41143	397994	7	1	1	0	0	2
41143	398013	7	1	2	0	2	5
41143	398052	7	1	0	0	0	1
41143	398061	7	3	0	0	2	5
41143	398080	7	0	2	0	1	3
41143	398097	7	1	3	1	3	8
41143	398098	7	1	1	0	0	2
41143	398103	7	3	2	0	0	5
41143	398121	7	4	1	0	0	5
41143	398133	7	3	0	1	0	4
41143	398141	7	0	0	0	1	1
41143	398169	7	2	0	1	3	6
41143	398183	7	3	3	0	0	6
41143	398198	7	2	0	0	1	3
41143	398204	7	2	2	0	1	5
41143	398221	7	0	4	0	1	5
41143	398234	7	0	2	0	0	2
41143	398243	7	1	1	0	0	2
41143	398244	7	1	0	0	1	2
41143	398258	7	2	1	0	3	6
41143	398276	7	2	0	0	2	4
41143	398293	7	1	1	0	1	3
41143	398316	7	0	2	0	0	2
41143	398338	7	2	1	0	1	4
41143	398346	7	2	0	0	0	2
41143	398356	7	2	3	0	2	7
41143	398360	7	3	2	0	0	5
41143	186432	6	2	1	0	0	3
41143	197302	6	1	2	0	0	3
41143	200627	6	1	4	0	1	6
41143	204986	6	0	2	0	2	4
41143	206663	6	0	0	0	1	1
41143	207099	6	1	1	0	3	5
41143	207642	6	4	1	0	1	6
41143	216843	6	2	1	2	0	5
41143	220382	6	1	0	0	2	3
41143	220511	6	1	3	0	0	4
41143	279836	6	1	0	0	1	2
41143	279838	6	2	1	0	1	4
41143	397212	6	0	1	0	0	1
41143	397217	6	1	0	0	0	1
41143	397231	6	0	4	0	2	6
41143	397251	6	2	0	0	1	3
41143	397275	6	2	1	1	0	4
41143	397290	6	0	0	1	0	1
41143	397295	6	0	2	0	0	2
41143	397381	6	0	1	0	0	1
41143	397391	6	0	0	0	1	1
41143	397396	6	4	1	0	2	7
41143	397445	6	2	1	0	0	3
41143	397446	6	1	2	0	3	6
41143	397484	6	1	1	0	0	2
41143	397497	6	2	3	0	0	5
41143	397502	6	0	0	0	1	1
41143	397514	6	0	0	0	1	1
41143	397573	6	1	1	0	1	3
41143	397585	6	2	0	0	0	2
41143	397593	6	4	0	0	1	5
41143	397595	6	0	1	0	0	1
41143	397605	6	2	0	0	0	2
41143	397607	6	4	1	1	2	8
41143	397615	6	1	1	0	0	2
41143	397629	6	3	0	0	0	3
41143	397635	6	2	1	0	1	4
41143	397637	6	0	0	1	1	2
41143	397647	6	0	1	0	1	2
41143	397651	6	1	1	0	1	3
41143	397674	6	1	1	0	1	3
41143	397683	6	0	0	0	1	1
41143	397689	6	0	0	1	0	1
41143	397711	6	0	0	0	0	0
41143	397713	6	0	2	0	1	3
41143	397720	6	1	1	0	2	4
41143	397744	6	1	1	0	0	2
41143	397749	6	1	1	0	2	4
41143	397761	6	4	2	0	2	8
41143	397789	6	1	2	1	1	5
41143	397822	6	2	0	0	1	3
41143	397823	6	2	2	0	0	4
41143	397868	6	1	1	1	1	4
41143	397883	6	2	6	0	1	9
41143	397886	6	6	1	0	0	7
41143	397925	6	3	2	0	0	5
41143	397926	6	0	0	1	0	1
41143	397930	6	3	2	0	5	10
41143	397932	6	0	2	0	0	2
41143	397963	6	0	0	0	3	3
41143	397993	6	1	0	0	0	1
41143	398016	6	2	0	0	0	2
41143	398034	6	2	0	0	1	3
41143	398035	6	1	2	0	1	4
41143	398041	6	1	0	0	0	1
41143	398054	6	1	0	0	1	2
41143	398062	6	0	0	0	1	1
41143	398065	6	0	1	0	1	2
41143	398068	6	2	1	0	1	4
41143	398072	6	3	1	0	2	6
41143	398073	6	0	0	0	1	1
41143	398078	6	0	2	0	0	2
41143	398101	6	2	1	0	0	3
41143	398120	6	1	1	0	2	4
41143	398122	6	2	1	0	2	5
41143	398147	6	0	1	1	0	2
41143	398162	6	1	3	0	1	5
41143	398163	6	2	3	0	1	6
41143	398173	6	2	0	0	0	2
41143	398174	6	1	0	0	0	1
41143	398187	6	1	1	0	1	3
41143	398188	6	2	1	0	2	5
41143	398194	6	1	0	0	1	2
41143	398201	6	0	1	0	0	1
41143	398208	6	1	2	0	0	3
41143	398213	6	1	0	0	2	3
41143	398254	6	2	0	0	0	2
41143	184560	5	1	4	2	0	7
41143	186207	5	1	1	0	0	2
41143	188499	5	2	0	0	0	2
41143	191590	5	1	0	0	0	1
41143	191603	5	0	0	0	0	0
41143	198086	5	2	0	0	2	4
41143	198679	5	1	0	0	0	1
41143	201319	5	0	1	0	2	3
41143	201585	5	0	1	0	2	3
41143	203365	5	1	1	0	0	2
41143	204888	5	1	1	0	1	3
41143	205543	5	0	1	0	2	3
41143	207237	5	1	1	0	0	2
41143	207734	5	1	1	0	0	2
41143	215767	5	1	0	0	0	1
41143	279824	5	1	0	0	2	3
41143	369566	5	0	0	0	0	0
41143	397220	5	0	0	0	1	1
41143	397221	5	2	0	0	0	2
41143	397222	5	1	1	0	0	2
41143	397230	5	1	1	0	0	2
41143	397237	5	1	0	0	0	1
41143	397247	5	3	0	0	2	5
41143	397254	5	0	0	0	0	0
41143	397272	5	0	0	0	0	0
41143	397277	5	2	0	0	2	4
41143	397292	5	1	0	0	2	3
41143	397294	5	1	1	0	1	3
41143	397303	5	0	0	0	0	0
41143	397309	5	3	3	0	0	6
41143	397314	5	0	1	0	0	1
41143	397332	5	2	1	0	0	3
41143	397344	5	3	2	0	0	5
41143	397351	5	1	1	0	2	4
41143	397352	5	0	0	0	0	0
41143	397362	5	3	0	1	0	4
41143	397364	5	0	1	0	1	2
41143	397383	5	0	1	1	0	2
41143	397387	5	1	0	0	0	1
41143	397397	5	1	0	0	1	2
41143	397398	5	0	2	0	0	2
41143	397400	5	1	1	0	0	2
41143	397412	5	0	0	1	0	1
41143	397413	5	0	0	0	0	0
41143	397426	5	0	0	0	1	1
41143	397433	5	1	2	0	0	3
41143	397434	5	2	0	0	1	3
41143	397437	5	1	2	0	0	3
41143	397444	5	1	2	0	2	5
41143	397452	5	4	0	1	1	6
41143	397453	5	1	0	0	2	3
41143	397456	5	1	0	1	0	2
41143	397466	5	2	0	0	0	2
41143	397467	5	0	1	0	0	1
41143	397475	5	1	0	0	1	2
41143	397493	5	1	1	0	2	4
41143	397503	5	0	0	0	0	0
41143	397505	5	0	1	0	1	2
41143	397509	5	1	0	0	1	2
41143	397510	5	1	2	0	0	3
41143	397518	5	0	0	0	2	2
41143	397522	5	0	1	0	0	1
41143	397537	5	2	0	0	0	2
41143	397544	5	1	2	0	0	3
41143	397554	5	2	0	0	0	2
41143	397580	5	1	1	0	0	2
41143	397590	5	0	0	0	0	0
41143	397596	5	1	1	0	0	2
41143	397598	5	0	3	0	2	5
41143	397619	5	0	0	0	0	0
41143	397621	5	1	2	0	0	3
41143	397622	5	3	1	0	1	5
41143	397649	5	1	1	0	2	4
41143	397652	5	1	0	0	3	4
41143	397655	5	1	0	0	0	1
41143	397657	5	2	0	0	3	5
41143	397690	5	1	0	0	3	4
41143	397694	5	5	1	0	6	12
41143	397696	5	1	0	0	0	1
41143	397699	5	0	1	0	0	1
41143	397721	5	0	2	1	0	3
41143	397722	5	3	1	0	0	4
41143	397734	5	2	0	0	1	3
41143	397750	5	1	2	0	1	4
41143	397754	5	2	1	0	1	4
41143	397759	5	0	2	0	2	4
41143	397770	5	2	1	0	0	3
41143	397775	5	2	3	1	1	7
41143	397795	5	0	1	0	0	1
41143	397807	5	0	0	0	1	1
41143	397809	5	2	3	0	2	7
41143	397814	5	1	0	0	0	1
41143	397831	5	3	2	1	1	7
41143	397863	5	1	2	0	0	3
41143	397872	5	1	0	0	1	2
41143	397884	5	0	2	0	2	4
41143	397889	5	0	0	0	0	0
41143	397890	5	1	1	0	0	2
41143	397899	5	0	0	0	0	0
41143	397907	5	2	1	0	2	5
41143	397915	5	2	2	0	2	6
41143	397917	5	2	0	0	0	2
41143	397949	5	1	0	0	0	1
41143	397952	5	2	2	0	1	5
41143	397962	5	0	2	0	0	2
41143	397973	5	1	0	0	1	2
41143	397986	5	1	2	0	0	3
41143	397995	5	2	3	0	0	5
41143	398002	5	1	0	0	0	1
41143	398003	5	0	2	1	0	3
41143	398026	5	1	1	0	2	4
41143	398030	5	0	0	0	0	0
41143	398032	5	0	1	0	0	1
41143	398067	5	1	1	0	0	2
41143	398069	5	3	0	0	3	6
41143	398070	5	0	1	0	2	3
41143	398087	5	1	0	0	0	1
41143	398093	5	1	4	0	1	6
41143	398096	5	1	1	0	0	2
41143	398110	5	3	2	0	1	6
41143	398124	5	2	2	0	1	5
41143	398128	5	2	1	0	0	3
41143	398132	5	2	2	0	0	4
41143	398139	5	1	2	0	0	3
41143	398142	5	1	2	0	1	4
41143	398145	5	0	2	0	0	2
41143	398146	5	0	2	0	1	3
41143	398148	5	0	0	0	1	1
41143	398155	5	0	3	0	1	4
41143	398161	5	3	1	0	1	5
41143	398164	5	3	2	0	0	5
41143	398182	5	4	3	0	0	7
41143	398184	5	2	1	0	0	3
41143	398185	5	2	1	0	1	4
41143	398205	5	0	0	0	2	2
41143	398219	5	2	1	0	0	3
41143	398228	5	1	2	1	1	5
41143	398236	5	0	0	0	0	0
41143	398245	5	3	2	0	3	8
41143	398267	5	1	1	1	0	3
41143	398272	5	0	0	0	0	0
41143	398273	5	3	1	1	0	5
41143	398279	5	2	0	0	2	4
41143	398289	5	1	1	0	0	2
41143	398313	5	0	1	1	0	2
41143	398343	5	2	2	0	1	5
41143	398351	5	0	1	0	0	1
41143	183509	4	1	2	0	0	3
41143	184293	4	0	1	0	0	1
41143	186885	4	5	0	0	2	7
41143	189525	4	0	2	0	1	3
41143	189805	4	0	1	0	0	1
41143	193564	4	0	2	0	1	3
41143	193727	4	1	0	1	0	2
41143	195780	4	1	1	2	0	4
41143	198593	4	0	0	0	0	0
41143	201601	4	0	1	0	1	2
41143	206279	4	1	1	1	0	3
41143	207128	4	2	1	0	1	4
41143	207416	4	1	3	0	1	5
41143	207695	4	0	0	0	1	1
41143	208127	4	0	3	0	1	4
41143	208230	4	0	2	0	2	4
41143	208939	4	0	0	0	0	0
41143	214000	4	0	0	0	2	2
41143	214464	4	0	1	0	1	2
41143	215210	4	2	0	0	0	2
41143	216622	4	0	0	1	0	1
41143	279820	4	1	0	0	0	1
41143	279826	4	0	0	0	1	1
41143	279827	4	2	1	0	0	3
41143	279828	4	2	1	0	0	3
41143	279829	4	1	0	0	2	3
41143	279834	4	1	1	0	1	3
41143	279841	4	1	1	1	3	6
41143	397209	4	0	0	0	1	1
41143	397224	4	1	0	0	0	1
41143	397229	4	1	2	0	0	3
41143	397249	4	0	4	0	1	5
41143	397255	4	2	0	0	0	2
41143	397260	4	1	1	0	1	3
41143	397266	4	2	2	0	0	4
41143	397274	4	0	1	0	0	1
41143	397282	4	2	3	1	1	7
41143	397289	4	1	0	0	1	2
41143	397291	4	2	0	0	2	4
41143	397293	4	0	0	0	0	0
41143	397298	4	0	2	0	1	3
41143	397300	4	0	1	0	0	1
41143	397319	4	0	0	0	2	2
41143	397323	4	0	1	0	2	3
41143	397330	4	1	0	0	3	4
41143	397342	4	2	1	0	2	5
41143	397346	4	1	0	1	0	2
41143	397354	4	1	1	0	1	3
41143	397358	4	0	0	1	1	2
41143	397363	4	2	0	0	0	2
41143	397365	4	0	3	0	1	4
41143	397367	4	0	1	1	0	2
41143	397370	4	3	0	0	0	3
41143	397372	4	0	0	0	0	0
41143	397374	4	1	1	0	0	2
41143	397376	4	0	0	0	2	2
41143	397380	4	0	2	0	1	3
41143	397386	4	0	2	0	1	3
41143	397390	4	1	0	0	1	2
41143	397393	4	0	2	0	1	3
41143	397403	4	1	3	1	3	8
41143	397407	4	0	0	0	0	0
41143	397415	4	0	0	1	1	2
41143	397418	4	0	0	0	0	0
41143	397422	4	0	0	0	0	0
41143	397427	4	1	1	0	2	4
41143	397432	4	1	0	0	0	1
41143	397450	4	3	1	0	0	4
41143	397457	4	0	0	2	1	3
41143	397460	4	1	0	1	0	2
41143	397462	4	2	2	0	1	5
41143	397463	4	2	2	0	0	4
41143	397476	4	0	0	3	0	3
41143	397496	4	0	0	0	1	1
41143	397504	4	0	0	0	0	0
41143	397516	4	0	1	1	1	3
41143	397517	4	2	0	0	0	2
41143	397524	4	1	1	0	0	2
41143	397525	4	0	1	0	0	1
41143	397529	4	2	0	0	1	3
41143	397534	4	0	2	1	1	4
41143	397546	4	1	1	0	1	3
41143	397549	4	0	0	0	2	2
41143	397551	4	0	2	0	2	4
41143	397553	4	2	0	0	0	2
41143	397555	4	0	0	0	0	0
41143	397558	4	1	0	0	1	2
41143	397564	4	4	1	1	2	8
41143	397567	4	1	0	0	0	1
41143	397568	4	0	1	0	0	1
41143	397571	4	2	2	0	0	4
41143	397586	4	0	3	0	1	4
41143	397587	4	1	1	0	0	2
41143	397588	4	1	0	0	0	1
41143	397591	4	0	1	0	0	1
41143	397594	4	0	1	0	0	1
41143	397603	4	0	4	0	0	4
41143	397609	4	0	0	0	0	0
41143	397613	4	1	2	1	1	5
41143	397620	4	0	2	0	1	3
41143	397634	4	2	2	0	2	6
41143	397636	4	0	0	0	0	0
41143	397641	4	1	2	0	1	4
41143	397648	4	0	1	0	1	2
41143	397650	4	0	2	0	0	2
41143	397654	4	1	1	0	1	3
41143	397656	4	0	1	0	1	2
41143	397659	4	2	0	0	1	3
41143	397662	4	2	0	1	0	3
41143	397663	4	0	1	0	0	1
41143	397668	4	0	2	0	0	2
41143	397671	4	2	0	0	1	3
41143	397673	4	2	1	0	0	3
41143	397697	4	2	0	0	3	5
41143	397704	4	1	0	0	0	1
41143	397705	4	3	0	0	1	4
41143	397709	4	1	2	0	2	5
41143	397715	4	1	3	0	1	5
41143	397724	4	1	0	0	0	1
41143	397729	4	1	3	1	0	5
41143	397731	4	1	1	0	2	4
41143	397746	4	3	1	0	2	6
41143	397747	4	0	0	0	0	0
41143	397753	4	0	0	1	0	1
41143	397757	4	1	1	0	0	2
41143	397765	4	1	5	0	0	6
41143	397767	4	1	1	0	1	3
41143	397769	4	2	1	1	0	4
41143	397773	4	1	0	0	1	2
41143	397778	4	0	0	0	3	3
41143	397783	4	0	2	2	1	5
41143	397793	4	1	0	0	0	1
41143	397797	4	0	2	0	0	2
41143	397802	4	0	0	0	1	1
41143	397805	4	1	0	0	2	3
41143	397808	4	1	1	0	0	2
41143	397816	4	0	0	1	0	1
41143	397817	4	1	0	0	1	2
41143	397825	4	1	2	0	2	5
41143	397829	4	0	1	0	2	3
41143	397830	4	0	1	0	1	2
41143	397832	4	3	0	0	1	4
41143	397837	4	1	0	0	1	2
41143	397838	4	1	1	0	0	2
41143	397840	4	0	0	0	3	3
41143	397841	4	1	0	0	0	1
41143	397842	4	2	3	0	0	5
41143	397845	4	1	0	0	3	4
41143	397847	4	2	1	0	2	5
41143	397848	4	1	2	0	1	4
41143	397854	4	2	3	0	1	6
41143	397862	4	0	0	0	0	0
41143	397864	4	1	0	0	0	1
41143	397876	4	1	3	0	2	6
41143	397878	4	2	0	2	1	5
41143	397887	4	2	0	0	4	6
41143	397891	4	0	1	0	0	1
41143	397893	4	0	0	0	3	3
41143	397898	4	3	0	0	1	4
41143	397913	4	2	0	0	0	2
41143	397914	4	2	0	0	1	3
41143	397920	4	2	1	0	1	4
41143	397928	4	1	2	0	1	4
41143	397934	4	0	3	0	1	4
41143	397938	4	1	1	0	0	2
41143	397942	4	4	1	0	1	6
41143	397945	4	2	2	0	2	6
41143	397948	4	0	1	0	0	1
41143	397954	4	1	0	0	2	3
41143	397956	4	3	1	0	1	5
41143	397957	4	0	0	0	0	0
41143	397958	4	3	1	0	0	4
41143	397961	4	0	1	1	0	2
41143	397969	4	3	2	0	0	5
41143	397972	4	0	2	0	1	3
41143	397974	4	2	1	0	1	4
41143	397976	4	2	1	0	1	4
41143	397979	4	0	0	0	0	0
41143	397983	4	0	2	0	0	2
41143	397985	4	0	0	0	0	0
41143	397987	4	3	1	0	1	5
41143	397988	4	2	1	0	2	5
41143	397989	4	2	1	0	0	3
41143	397991	4	2	0	0	0	2
41143	397992	4	0	1	0	0	1
41143	397996	4	1	2	0	1	4
41143	397998	4	0	0	0	1	1
41143	398001	4	0	1	0	0	1
41143	398010	4	1	1	0	1	3
41143	398014	4	0	1	0	0	1
41143	398017	4	2	0	0	2	4
41143	398020	4	0	1	0	0	1
41143	398021	4	2	2	0	0	4
41143	398022	4	0	1	0	0	1
41143	398027	4	2	0	0	0	2
41143	398029	4	0	1	1	0	2
41143	398031	4	0	1	0	0	1
41143	398037	4	1	2	0	1	4
41143	398039	4	1	0	0	2	3
41143	398043	4	2	0	0	0	2
41143	398044	4	0	1	0	0	1
41143	398048	4	1	0	1	1	3
41143	398049	4	3	2	0	0	5
41143	398055	4	3	0	0	1	4
41143	398057	4	4	1	0	3	8
41143	398058	4	0	1	0	2	3
41143	398064	4	1	1	0	0	2
41143	398066	4	0	0	0	0	0
41143	398071	4	2	2	0	0	4
41143	398079	4	2	0	0	1	3
41143	398081	4	1	1	0	0	2
41143	398082	4	1	2	0	2	5
41143	398085	4	2	1	1	0	4
41143	398086	4	1	0	0	2	3
41143	398089	4	2	0	0	0	2
41143	398092	4	0	1	0	2	3
41143	398094	4	2	0	0	2	4
41143	398095	4	2	0	0	2	4
41143	398100	4	0	2	0	0	2
41143	398102	4	1	0	0	0	1
41143	398104	4	1	1	1	0	3
41143	398111	4	0	1	0	1	2
41143	398113	4	1	1	0	1	3
41143	398116	4	2	0	0	0	2
41143	398129	4	2	3	0	0	5
41143	398140	4	0	4	0	0	4
41143	398144	4	1	1	0	0	2
41143	398150	4	1	0	0	2	3
41143	398156	4	0	1	0	1	2
41143	398157	4	0	0	0	0	0
41143	398160	4	2	2	0	0	4
41143	398166	4	1	1	0	1	3
41143	398167	4	0	0	0	1	1
41143	398168	4	1	2	0	0	3
41143	398171	4	1	0	0	0	1
41143	398178	4	1	1	0	1	3
41143	398181	4	1	1	0	0	2
41143	398190	4	0	2	0	0	2
41143	398195	4	1	1	0	1	3
41143	398199	4	1	0	0	4	5
41143	398209	4	1	1	0	0	2
41143	398214	4	1	0	0	0	1
41143	398224	4	1	0	0	1	2
41143	398231	4	2	0	0	0	2
41143	398238	4	2	1	0	2	5
41143	398242	4	1	0	0	2	3
41143	398249	4	1	0	0	1	2
41143	398266	4	2	1	0	0	3
41143	398281	4	1	0	0	1	2
41143	398282	4	0	0	0	2	2
41143	398283	4	3	1	0	0	4
41143	398284	4	1	1	0	1	3
41143	398309	4	2	0	0	0	2
41143	398315	4	1	1	0	0	2
41143	398318	4	3	1	0	0	4
41143	398321	4	1	1	0	0	2
41143	398322	4	0	1	0	1	2
41143	398324	4	0	1	2	0	3
41143	398329	4	0	1	0	0	1
41143	398330	4	1	2	0	0	3
41143	398331	4	0	0	0	1	1
41143	398334	4	1	0	0	1	2
41143	398335	4	1	2	0	0	3
41143	398339	4	0	1	0	0	1
41143	398340	4	2	3	0	0	5
41143	398355	4	1	2	0	1	4
41143	398357	4	1	4	0	0	5
41143	185735	3	0	0	0	0	0
41143	196046	3	0	1	0	2	3
41143	199154	3	2	1	0	0	3
41143	200114	3	0	1	0	1	2
41143	202052	3	0	0	1	0	1
41143	203145	3	1	0	0	0	1
41143	203784	3	0	2	0	0	2
41143	204336	3	0	1	0	1	2
41143	205928	3	2	1	0	0	3
41143	207452	3	0	1	0	0	1
41143	207472	3	0	1	0	0	1
41143	207665	3	0	2	0	0	2
41143	207729	3	0	0	0	0	0
41143	209599	3	0	2	0	0	2
41143	209606	3	0	0	0	0	0
41143	210310	3	0	2	0	1	3
41143	210368	3	1	0	0	2	3
41143	210749	3	0	1	0	1	2
41143	210773	3	1	2	0	0	3
41143	211700	3	0	1	0	0	1
41143	212351	3	0	1	0	0	1
41143	213389	3	1	4	0	1	6
41143	214091	3	0	0	1	1	2
41143	215375	3	1	1	0	0	2
41143	216378	3	1	2	0	0	3
41143	216688	3	2	0	0	0	2
41143	216926	3	1	1	0	0	2
41143	217685	3	0	0	0	0	0
41143	218696	3	0	0	0	0	0
41143	219844	3	1	2	0	1	4
41143	221884	3	0	2	0	0	2
41143	279825	3	2	1	0	0	3
41143	279830	3	0	0	0	0	0
41143	279832	3	2	2	1	0	5
41143	279833	3	1	1	0	1	3
41143	279842	3	1	1	0	0	2
41143	397214	3	1	1	2	0	4
41143	397218	3	1	1	0	1	3
41143	397233	3	1	0	0	3	4
41143	397234	3	3	0	0	0	3
41143	397246	3	1	1	1	1	4
41143	397257	3	2	1	0	0	3
41143	397259	3	0	0	0	0	0
41143	397261	3	0	2	0	0	2
41143	397262	3	5	0	0	3	8
41143	397264	3	2	0	0	0	2
41143	397273	3	0	2	0	1	3
41143	397278	3	0	0	0	0	0
41143	397279	3	0	3	0	1	4
41143	397280	3	2	1	1	0	4
41143	397296	3	0	0	0	0	0
41143	397297	3	0	2	0	1	3
41143	397299	3	3	1	1	0	5
41143	397301	3	0	1	1	0	2
41143	397305	3	1	0	0	0	1
41143	397308	3	0	1	0	0	1
41143	397310	3	0	1	0	1	2
41143	397312	3	2	1	0	0	3
41143	397315	3	1	2	0	0	3
41143	397316	3	0	1	0	0	1
41143	397318	3	0	1	0	1	2
41143	397321	3	1	0	0	2	3
41143	397329	3	0	1	0	0	1
41143	397331	3	0	0	0	0	0
41143	397333	3	4	2	1	2	9
41143	397334	3	1	1	0	2	4
41143	397335	3	1	0	0	0	1
41143	397337	3	0	0	0	0	0
41143	397341	3	2	1	0	0	3
41143	397345	3	1	0	0	0	1
41143	397349	3	1	2	0	1	4
41143	397366	3	1	2	1	2	6
41143	397373	3	1	2	0	0	3
41143	397375	3	0	0	0	2	2
41143	397377	3	1	1	0	0	2
41143	397382	3	0	1	0	1	2
41143	397392	3	0	1	0	1	2
41143	397395	3	0	0	0	0	0
41143	397404	3	1	1	2	1	5
41143	397408	3	0	0	0	1	1
41143	397410	3	2	3	0	2	7
41143	397417	3	2	0	0	1	3
41143	397425	3	1	1	0	0	2
41143	397428	3	0	0	0	1	1
41143	397429	3	1	0	0	0	1
41143	397431	3	2	0	0	0	2
41143	397440	3	1	1	0	0	2
41143	397442	3	1	0	1	0	2
41143	397449	3	1	1	0	2	4
41143	397454	3	1	0	0	2	3
41143	397459	3	0	1	0	1	2
41143	397468	3	3	1	0	1	5
41143	397477	3	0	0	0	1	1
41143	397483	3	0	1	0	1	2
41143	397486	3	1	0	0	1	2
41143	397487	3	1	4	0	0	5
41143	397489	3	2	0	0	2	4
41143	397490	3	0	2	0	0	2
41143	397494	3	1	0	0	0	1
41143	397499	3	0	0	0	0	0
41143	397508	3	0	0	0	0	0
41143	397511	3	0	0	0	2	2
41143	397512	3	0	2	0	0	2
41143	397513	3	1	0	0	0	1
41143	397515	3	0	1	0	1	2
41143	397519	3	0	0	1	2	3
41143	397527	3	0	1	0	1	2
41143	397531	3	2	1	0	1	4
41143	397533	3	1	0	0	0	1
41143	397541	3	0	0	1	1	2
41143	397562	3	2	0	0	0	2
41143	397565	3	0	0	0	1	1
41143	397574	3	2	1	0	0	3
41143	397576	3	0	1	0	0	1
41143	397581	3	0	0	0	1	1
41143	397582	3	3	2	0	0	5
41143	397583	3	0	2	0	1	3
41143	397601	3	1	0	0	0	1
41143	397602	3	1	1	0	0	2
41143	397612	3	2	1	0	2	5
41143	397616	3	1	1	0	0	2
41143	397617	3	0	2	1	1	4
41143	397623	3	2	0	0	1	3
41143	397626	3	1	0	0	2	3
41143	397627	3	2	1	0	0	3
41143	397630	3	0	0	2	0	2
41143	397633	3	2	0	0	0	2
41143	397638	3	1	0	0	2	3
41143	397639	3	4	2	0	1	7
41143	397643	3	1	1	0	1	3
41143	397665	3	1	1	0	0	2
41143	397667	3	1	0	0	1	2
41143	397669	3	1	0	0	0	1
41143	397672	3	0	3	0	2	5
41143	397676	3	1	1	2	0	4
41143	397677	3	1	1	0	0	2
41143	397682	3	1	0	0	0	1
41143	397685	3	1	1	0	0	2
41143	397695	3	2	0	0	0	2
41143	397698	3	1	0	0	2	3
41143	397701	3	1	2	0	1	4
41143	397703	3	1	1	0	1	3
41143	397706	3	0	1	0	0	1
41143	397710	3	2	1	0	1	4
41143	397712	3	0	1	0	0	1
41143	397716	3	2	0	0	0	2
41143	397723	3	0	2	0	0	2
41143	397727	3	1	1	0	1	3
41143	397732	3	1	1	0	1	3
41143	397733	3	1	0	0	2	3
41143	397735	3	2	1	0	2	5
41143	397736	3	0	0	0	0	0
41143	397737	3	0	2	1	0	3
41143	397739	3	0	0	0	0	0
41143	397740	3	0	1	0	1	2
41143	397741	3	1	3	0	0	4
41143	397742	3	1	0	0	0	1
41143	397745	3	0	0	0	0	0
41143	397748	3	1	2	0	1	4
41143	397751	3	2	0	2	0	4
41143	397752	3	0	0	0	1	1
41143	397755	3	1	0	0	0	1
41143	397758	3	1	0	0	1	2
41143	397760	3	1	0	0	0	1
41143	397766	3	2	2	0	0	4
41143	397776	3	0	1	0	2	3
41143	397777	3	1	1	0	0	2
41143	397779	3	0	0	0	1	1
41143	397781	3	1	0	0	4	5
41143	397787	3	0	4	0	2	6
41143	397788	3	3	1	0	0	4
41143	397799	3	0	0	0	0	0
41143	397803	3	0	3	0	0	3
41143	397811	3	0	3	0	0	3
41143	397818	3	2	2	0	1	5
41143	397820	3	2	1	0	0	3
41143	397821	3	1	3	0	1	5
41143	397843	3	0	0	0	1	1
41143	397849	3	0	1	0	0	1
41143	397850	3	0	1	0	0	1
41143	397851	3	0	2	0	0	2
41143	397858	3	1	0	0	0	1
41143	397865	3	1	0	0	2	3
41143	397873	3	2	0	0	0	2
41143	397880	3	1	0	0	0	1
41143	397888	3	1	0	0	0	1
41143	397903	3	0	0	0	0	0
41143	397908	3	1	0	0	2	3
41143	397909	3	0	0	0	0	0
41143	397910	3	1	1	1	1	4
41143	397911	3	2	1	0	0	3
41143	397912	3	0	0	0	0	0
41143	397924	3	0	1	0	0	1
41143	397927	3	1	0	0	0	1
41143	397931	3	2	2	1	0	5
41143	397935	3	3	1	0	1	5
41143	397940	3	1	0	0	0	1
41143	397941	3	0	0	0	0	0
41143	397950	3	1	0	0	1	2
41143	397964	3	0	1	0	0	1
41143	397967	3	1	2	0	1	4
41143	397968	3	0	0	0	0	0
41143	397970	3	2	2	0	1	5
41143	397980	3	0	0	0	0	0
41143	397982	3	1	2	0	1	4
41143	398000	3	0	1	1	1	3
41143	398005	3	1	1	0	3	5
41143	398007	3	0	0	0	0	0
41143	398015	3	3	0	1	1	5
41143	398023	3	1	0	0	0	1
41143	398036	3	2	0	0	1	3
41143	398040	3	2	1	0	1	4
41143	398042	3	1	1	0	1	3
41143	398051	3	2	2	0	2	6
41143	398053	3	0	0	0	0	0
41143	398074	3	2	1	0	1	4
41143	398075	3	0	0	0	2	2
41143	398083	3	1	0	0	0	1
41143	398090	3	0	2	0	0	2
41143	398099	3	0	1	0	0	1
41143	398108	3	0	0	0	0	0
41143	398112	3	0	2	0	1	3
41143	398115	3	2	0	0	0	2
41143	398118	3	2	0	0	0	2
41143	398125	3	1	1	0	0	2
41143	398126	3	1	2	1	2	6
41143	398143	3	1	1	0	0	2
41143	398149	3	1	1	0	1	3
41143	398151	3	1	1	0	0	2
41143	398152	3	2	1	0	0	3
41143	398154	3	0	0	0	0	0
41143	398170	3	2	0	0	1	3
41143	398172	3	0	3	0	0	3
41143	398189	3	0	1	0	1	2
41143	398192	3	0	1	0	1	2
41143	398196	3	0	1	0	0	1
41143	398197	3	1	0	0	0	1
41143	398200	3	1	1	0	0	2
41143	398207	3	0	2	0	1	3
41143	398215	3	0	1	0	0	1
41143	398220	3	2	0	0	0	2
41143	398222	3	0	1	0	0	1
41143	398230	3	2	0	0	0	2
41143	398233	3	1	1	0	1	3
41143	398235	3	1	0	0	0	1
41143	398237	3	2	0	0	0	2
41143	398246	3	0	0	0	1	1
41143	398252	3	0	1	0	4	5
41143	398256	3	2	0	0	1	3
41143	398261	3	0	0	0	1	1
41143	398262	3	0	0	0	1	1
41143	398263	3	2	1	0	0	3
41143	398265	3	1	1	0	0	2
41143	398269	3	1	0	0	0	1
41143	398270	3	1	0	0	1	2
41143	398271	3	0	1	0	0	1
41143	398274	3	0	4	0	0	4
41143	398277	3	4	1	0	1	6
41143	398287	3	1	1	0	0	2
41143	398298	3	0	0	0	0	0
41143	398305	3	0	1	0	1	2
41143	398320	3	0	1	0	0	1
41143	398323	3	1	1	0	0	2
41143	398325	3	1	2	0	0	3
41143	398326	3	2	1	0	0	3
41143	398328	3	1	2	0	3	6
41143	398337	3	0	0	0	1	1
41143	398341	3	3	1	0	1	5
41143	398345	3	1	3	0	0	4
41143	398347	3	0	1	0	0	1
41143	398353	3	1	2	0	0	3
41143	398354	3	1	1	0	1	3
41143	398359	3	1	0	0	0	1
41143	398361	3	1	1	0	0	2
41143	181900	2	1	1	0	1	3
41143	181945	2	0	1	0	0	1
41143	183872	2	0	0	0	0	0
41143	186983	2	1	0	0	0	1
41143	187114	2	1	0	0	0	1
41143	190617	2	2	2	0	0	4
41143	191185	2	0	2	0	0	2
41143	191358	2	1	1	0	0	2
41143	192838	2	0	1	0	0	1
41143	193204	2	1	1	0	1	3
41143	200901	2	1	0	0	1	2
41143	201580	2	0	1	0	0	1
41143	202969	2	0	0	1	1	2
41143	204597	2	1	3	0	1	5
41143	205011	2	0	1	0	0	1
41143	205320	2	0	1	0	1	2
41143	207339	2	0	1	0	1	2
41143	207656	2	1	1	0	0	2
41143	211117	2	0	0	0	0	0
41143	212015	2	0	0	0	0	0
41143	212386	2	0	2	0	0	2
41143	212769	2	0	0	0	1	1
41143	213015	2	0	1	0	0	1
41143	213565	2	2	0	0	0	2
41143	216554	2	1	0	0	1	2
41143	216612	2	2	2	0	1	5
41143	218266	2	0	1	0	1	2
41143	218823	2	1	0	0	1	2
41143	279839	2	1	0	0	0	1
41143	397219	2	0	0	0	0	0
41143	397228	2	1	1	0	0	2
41143	397248	2	1	1	0	2	4
41143	397265	2	2	2	0	0	4
41143	397271	2	0	1	0	2	3
41143	397276	2	0	0	0	0	0
41143	397284	2	0	0	1	2	3
41143	397286	2	0	0	0	0	0
41143	397287	2	1	0	0	0	1
41143	397288	2	0	2	0	0	2
41143	397302	2	0	0	0	0	0
41143	397307	2	2	2	0	1	5
41143	397313	2	0	1	0	0	1
41143	397317	2	0	2	0	0	2
41143	397320	2	1	0	0	0	1
41143	397322	2	0	1	0	0	1
41143	397324	2	0	1	0	0	1
41143	397336	2	1	1	0	1	3
41143	397338	2	0	0	0	0	0
41143	397347	2	0	2	0	1	3
41143	397355	2	2	1	0	0	3
41143	397356	2	1	1	0	0	2
41143	397360	2	1	1	0	2	4
41143	397399	2	0	2	0	0	2
41143	397401	2	0	0	0	1	1
41143	397402	2	0	2	0	0	2
41143	397406	2	3	0	0	1	4
41143	397409	2	1	0	0	0	1
41143	397411	2	1	0	0	0	1
41143	397416	2	1	0	1	1	3
41143	397420	2	0	1	0	0	1
41143	397421	2	1	1	0	0	2
41143	397424	2	0	1	0	0	1
41143	397435	2	0	0	0	0	0
41143	397438	2	0	1	1	1	3
41143	397443	2	3	0	0	0	3
41143	397447	2	0	1	0	1	2
41143	397451	2	0	0	0	0	0
41143	397461	2	1	0	0	0	1
41143	397465	2	1	0	0	2	3
41143	397478	2	0	0	0	0	0
41143	397479	2	2	1	0	1	4
41143	397482	2	0	1	0	0	1
41143	397488	2	0	1	0	1	2
41143	397492	2	0	0	1	0	1
41143	397498	2	0	0	0	1	1
41143	397507	2	1	0	0	2	3
41143	397520	2	0	0	0	1	1
41143	397521	2	1	2	0	0	3
41143	397532	2	1	0	0	0	1
41143	397536	2	0	0	0	0	0
41143	397547	2	2	1	0	2	5
41143	397548	2	0	0	0	1	1
41143	397556	2	1	0	0	0	1
41143	397557	2	2	3	0	1	6
41143	397559	2	1	1	0	1	3
41143	397560	2	1	0	0	2	3
41143	397563	2	0	0	0	1	1
41143	397569	2	0	1	0	1	2
41143	397578	2	0	1	0	2	3
41143	397579	2	1	2	0	0	3
41143	397600	2	1	1	0	0	2
41143	397608	2	0	1	0	2	3
41143	397632	2	1	5	0	0	6
41143	397640	2	1	2	0	0	3
41143	397645	2	1	0	0	0	1
41143	397646	2	0	2	0	0	2
41143	397658	2	1	0	1	1	3
41143	397660	2	0	0	0	0	0
41143	397670	2	0	1	0	1	2
41143	397678	2	0	0	0	0	0
41143	397681	2	0	1	0	0	1
41143	397684	2	1	0	0	0	1
41143	397687	2	0	0	0	0	0
41143	397688	2	1	0	0	0	1
41143	397702	2	2	0	0	0	2
41143	397717	2	0	0	0	0	0
41143	397718	2	0	0	0	0	0
41143	397725	2	0	1	0	0	1
41143	397730	2	0	1	0	0	1
41143	397768	2	0	0	0	1	1
41143	397772	2	0	2	0	1	3
41143	397780	2	0	1	0	0	1
41143	397782	2	0	2	0	0	2
41143	397784	2	1	0	0	0	1
41143	397796	2	1	1	0	0	2
41143	397800	2	0	1	0	0	1
41143	397812	2	0	1	0	1	2
41143	397828	2	0	0	0	0	0
41143	397836	2	0	1	0	0	1
41143	397853	2	0	0	0	0	0
41143	397855	2	0	0	0	0	0
41143	397856	2	0	0	0	1	1
41143	397857	2	1	0	0	2	3
41143	397859	2	1	0	0	1	2
41143	397869	2	0	1	0	1	2
41143	397879	2	1	0	0	1	2
41143	397882	2	0	3	0	0	3
41143	397904	2	1	1	0	0	2
41143	397906	2	0	2	0	0	2
41143	397916	2	1	0	0	0	1
41143	397922	2	0	0	0	0	0
41143	397923	2	0	1	0	0	1
41143	397933	2	1	0	0	0	1
41143	397953	2	1	2	0	1	4
41143	397960	2	1	0	0	0	1
41143	397965	2	1	1	0	0	2
41143	397966	2	1	1	0	0	2
41143	397971	2	1	1	0	0	2
41143	397978	2	1	1	0	0	2
41143	397990	2	0	0	0	0	0
41143	397997	2	2	2	1	1	6
41143	398004	2	0	0	0	0	0
41143	398006	2	0	0	0	0	0
41143	398009	2	2	1	0	0	3
41143	398012	2	2	0	0	0	2
41143	398019	2	1	0	0	0	1
41143	398038	2	3	0	0	1	4
41143	398046	2	1	1	0	0	2
41143	398050	2	0	0	0	3	3
41143	398059	2	1	0	0	2	3
41143	398060	2	1	0	0	2	3
41143	398063	2	0	2	0	1	3
41143	398076	2	0	1	0	0	1
41143	398077	2	1	1	0	1	3
41143	398084	2	0	1	0	0	1
41143	398091	2	1	0	0	0	1
41143	398106	2	1	0	0	0	1
41143	398114	2	0	0	0	0	0
41143	398117	2	1	0	0	0	1
41143	398123	2	0	0	0	0	0
41143	398130	2	0	1	0	0	1
41143	398134	2	0	0	0	0	0
41143	398137	2	1	0	0	1	2
41143	398153	2	1	0	0	0	1
41143	398159	2	0	1	0	1	2
41143	398179	2	1	1	0	1	3
41143	398191	2	0	0	0	0	0
41143	398193	2	0	1	0	0	1
41143	398202	2	0	0	0	0	0
41143	398206	2	0	0	0	1	1
41143	398210	2	0	0	0	0	0
41143	398212	2	0	0	0	0	0
41143	398218	2	0	0	0	0	0
41143	398223	2	0	2	0	1	3
41143	398225	2	0	1	0	0	1
41143	398226	2	1	0	0	0	1
41143	398241	2	1	0	0	0	1
41143	398247	2	0	4	0	1	5
41143	398248	2	0	0	0	1	1
41143	398250	2	0	0	0	0	0
41143	398251	2	0	0	0	1	1
41143	398255	2	0	1	0	1	2
41143	398259	2	0	1	0	0	1
41143	398260	2	0	1	0	0	1
41143	398268	2	0	1	0	0	1
41143	398280	2	0	1	0	0	1
41143	398311	2	1	0	0	0	1
41143	398314	2	0	2	0	2	4
41143	398327	2	0	1	0	0	1
41143	398348	2	1	2	0	0	3
41143	398350	2	0	0	0	2	2
41143	398358	2	2	1	0	0	3
41143	86915	2	0	2	0	2	4
41143	186609	1	0	1	0	0	1
41143	186947	1	0	0	0	1	1
41143	189617	1	0	0	0	1	1
41143	190058	1	0	0	0	0	0
41143	190095	1	0	1	0	1	2
41143	190310	1	0	0	0	0	0
41143	199256	1	1	2	0	1	4
41143	200428	1	1	0	0	0	1
41143	203410	1	0	0	0	0	0
41143	206225	1	0	0	0	1	1
41143	206288	1	1	1	0	0	2
41143	209545	1	0	0	0	1	1
41143	212986	1	0	0	0	1	1
41143	213384	1	0	0	0	0	0
41143	213877	1	0	1	0	1	2
41143	214226	1	0	1	0	0	1
41143	214391	1	2	0	2	0	4
41143	214640	1	0	1	0	0	1
41143	215257	1	0	0	0	0	0
41143	218814	1	0	1	0	0	1
41143	220876	1	1	0	0	0	1
41143	221598	1	0	1	0	0	1
41143	397215	1	0	3	0	0	3
41143	397216	1	0	1	0	1	2
41143	397223	1	1	1	0	0	2
41143	397232	1	1	0	0	0	1
41143	397238	1	1	0	0	1	2
41143	397258	1	3	0	0	0	3
41143	397268	1	2	0	0	1	3
41143	397270	1	0	0	0	1	1
41143	397306	1	1	3	0	0	4
41143	397311	1	0	1	0	0	1
41143	397325	1	1	1	0	0	2
41143	397326	1	0	0	0	0	0
41143	397327	1	2	2	0	0	4
41143	397328	1	0	0	0	0	0
41143	397339	1	0	0	0	1	1
41143	397340	1	0	0	0	1	1
41143	397343	1	0	1	1	0	2
41143	397348	1	0	0	1	1	2
41143	397350	1	0	0	0	1	1
41143	397353	1	1	1	0	2	4
41143	397357	1	0	0	0	2	2
41143	397359	1	0	0	0	1	1
41143	397361	1	0	1	0	0	1
41143	397368	1	1	0	0	0	1
41143	397384	1	0	1	0	1	2
41143	397388	1	0	0	0	0	0
41143	397405	1	0	0	0	0	0
41143	397423	1	0	1	0	0	1
41143	397430	1	0	0	0	0	0
41143	397436	1	1	0	0	0	1
41143	397448	1	1	2	0	2	5
41143	397464	1	0	0	0	0	0
41143	397470	1	0	0	0	1	1
41143	397481	1	1	0	0	0	1
41143	397528	1	0	1	0	1	2
41143	397538	1	0	1	0	1	2
41143	397539	1	0	0	0	1	1
41143	397540	1	1	0	0	0	1
41143	397543	1	0	0	0	0	0
41143	397577	1	0	1	0	0	1
41143	397584	1	0	1	0	0	1
41143	397599	1	0	3	0	1	4
41143	397606	1	0	4	0	1	5
41143	397642	1	1	0	0	0	1
41143	397644	1	2	1	0	0	3
41143	397666	1	0	1	0	0	1
41143	397679	1	0	0	1	0	1
41143	397691	1	1	0	0	1	2
41143	397714	1	0	0	0	0	0
41143	397719	1	0	1	0	1	2
41143	397763	1	1	1	0	0	2
41143	397771	1	1	1	0	1	3
41143	397790	1	1	1	0	0	2
41143	397801	1	0	0	0	0	0
41143	397806	1	1	2	0	0	3
41143	397810	1	1	2	0	0	3
41143	397815	1	1	0	0	1	2
41143	397826	1	1	2	0	1	4
41143	397827	1	1	1	0	2	4
41143	397833	1	1	2	0	1	4
41143	397835	1	0	1	0	0	1
41143	397844	1	1	1	0	0	2
41143	397846	1	0	0	0	0	0
41143	397871	1	0	0	0	0	0
41143	397875	1	0	0	0	0	0
41143	397877	1	0	1	0	1	2
41143	397881	1	0	0	0	0	0
41143	397885	1	2	1	0	0	3
41143	397895	1	2	0	0	2	4
41143	397918	1	0	0	0	0	0
41143	397936	1	1	1	0	2	4
41143	397937	1	2	1	0	0	3
41143	397943	1	0	2	0	0	2
41143	397946	1	0	0	0	0	0
41143	397951	1	1	0	0	0	1
41143	397999	1	1	0	0	3	4
41143	398024	1	0	0	0	1	1
41143	398025	1	1	0	0	0	1
41143	398033	1	0	1	0	0	1
41143	398045	1	1	0	0	0	1
41143	398047	1	0	0	0	0	0
41143	398088	1	0	0	0	0	0
41143	398109	1	0	1	0	1	2
41143	398119	1	1	0	0	0	1
41143	398127	1	0	0	0	0	0
41143	398131	1	1	1	0	1	3
41143	398135	1	0	3	0	0	3
41143	398136	1	0	0	0	1	1
41143	398138	1	0	1	0	0	1
41143	398175	1	0	2	0	1	3
41143	398176	1	0	1	0	0	1
41143	398180	1	1	1	0	1	3
41143	398203	1	0	0	0	0	0
41143	398216	1	1	1	0	0	2
41143	398217	1	1	2	0	1	4
41143	398229	1	0	0	0	1	1
41143	398232	1	2	2	0	2	6
41143	398239	1	0	0	0	1	1
41143	398240	1	1	0	0	0	1
41143	398257	1	1	0	0	1	2
41143	398264	1	0	0	0	0	0
41143	398275	1	0	0	0	0	0
41143	398297	1	0	1	0	1	2
41143	398299	1	0	2	0	1	3
41143	398301	1	0	0	0	1	1
41143	398307	1	2	1	0	1	4
41143	398336	1	1	0	0	1	2
29439	278294	24	4	4	0	1	9
29439	195074	22	2	1	0	1	4
29439	220013	21	2	7	0	1	10
29439	217390	19	1	1	1	0	3
29439	403160	19	1	2	1	2	6
29439	402769	18	3	3	2	2	10
29439	185744	17	3	0	1	2	6
29439	402594	17	0	2	0	0	2
29439	216911	16	6	2	1	0	9
29439	208834	15	3	3	0	4	10
29439	278314	15	3	0	1	2	6
29439	402764	15	1	2	0	1	4
29439	402846	15	2	0	1	0	3
29439	402868	14	5	0	2	1	8
29439	103157	13	3	9	1	1	14
29439	187206	13	1	1	0	0	2
29439	278306	13	1	0	0	0	1
29439	278383	13	0	0	1	0	1
29439	278391	13	3	9	1	1	14
29439	402704	13	0	4	0	1	5
29439	278302	12	2	2	0	0	4
29439	402612	12	1	2	0	1	4
29439	402618	12	4	5	0	0	9
29439	402703	12	2	3	0	1	6
29439	402746	12	1	6	2	1	10
29439	402872	12	3	2	1	3	9
29439	402936	12	2	2	1	7	12
29439	403008	12	3	2	1	1	7
29439	63497	12	3	1	0	1	5
29439	85889	12	2	2	0	0	4
29439	278349	11	0	0	1	3	4
29439	278378	11	0	2	0	2	4
29439	402665	11	1	3	0	1	5
29439	402700	11	2	3	1	6	12
29439	402717	11	0	2	0	2	4
29439	402735	11	1	6	0	3	10
29439	402796	11	2	2	0	5	9
29439	402826	11	1	0	1	2	4
29439	402898	11	2	5	1	1	9
29439	402904	11	3	2	0	0	5
29439	403100	11	1	2	0	0	3
29439	403131	11	3	3	0	3	9
29439	403139	11	1	1	0	0	2
29439	403158	11	0	4	0	1	5
29439	93213	11	0	0	1	3	4
29439	186162	10	0	0	0	0	0
29439	201668	10	1	1	0	0	2
29439	203765	10	1	5	1	1	8
29439	211522	10	5	3	1	0	9
29439	216847	10	2	1	1	2	6
29439	278359	10	3	0	1	2	6
29439	402614	10	0	1	0	0	1
29439	402707	10	1	3	2	3	9
29439	402726	10	2	4	0	2	8
29439	402790	10	1	0	0	0	1
29439	402845	10	1	0	1	0	2
29439	402873	10	2	1	2	2	7
29439	403010	10	1	1	2	1	5
29439	403025	10	0	2	0	2	4
29439	403162	10	0	3	0	1	4
29439	83872	10	2	1	0	1	4
29439	183943	9	0	2	0	1	3
29439	191533	9	0	0	0	1	1
29439	195683	9	1	2	0	1	4
29439	198373	9	0	1	0	1	2
29439	210902	9	1	1	0	1	3
29439	213346	9	2	3	2	1	8
29439	218016	9	2	3	0	1	6
29439	278326	9	1	4	0	0	5
29439	278353	9	0	0	0	0	0
29439	278356	9	0	2	0	1	3
29439	402604	9	0	3	1	2	6
29439	402630	9	1	1	0	0	2
29439	402642	9	0	3	0	2	5
29439	402684	9	2	4	0	1	7
29439	402702	9	0	2	0	0	2
29439	402743	9	0	2	0	0	2
29439	402765	9	2	1	3	0	6
29439	402770	9	0	0	1	1	2
29439	402901	9	1	1	0	2	4
29439	402929	9	2	2	0	0	4
29439	403006	9	3	4	0	4	11
29439	57173	9	1	0	1	0	2
29439	65544	9	0	3	0	1	4
29439	88982	9	1	4	0	0	5
29439	97921	9	0	2	0	1	3
29439	100051	8	3	0	1	2	6
29439	101051	8	1	4	0	0	5
29439	186050	8	0	1	2	0	3
29439	191617	8	1	3	0	3	7
29439	193314	8	0	0	1	3	4
29439	196257	8	1	2	0	0	3
29439	206016	8	2	1	0	0	3
29439	206540	8	2	3	0	2	7
29439	207645	8	1	4	0	0	5
29439	216792	8	1	1	1	0	3
29439	217187	8	0	2	0	1	3
29439	278297	8	2	1	0	1	4
29439	278380	8	3	0	1	2	6
29439	278385	8	1	4	0	0	5
29439	402587	8	2	2	0	2	6
29439	402615	8	1	4	0	1	6
29439	402647	8	1	0	0	0	1
29439	402651	8	2	2	0	2	6
29439	402652	8	1	0	1	0	2
29439	402678	8	1	0	0	1	2
29439	402698	8	0	1	1	0	2
29439	402723	8	0	2	0	0	2
29439	402750	8	3	0	1	0	4
29439	402812	8	2	0	0	0	2
29439	402876	8	1	3	0	0	4
29439	402877	8	1	0	0	1	2
29439	402947	8	0	1	1	0	2
29439	402969	8	3	1	0	2	6
29439	402989	8	2	0	0	0	2
29439	403056	8	1	2	1	1	5
29439	403075	8	1	0	0	2	3
29439	63825	8	0	0	0	1	1
29439	80893	8	2	1	0	1	4
29439	108616	7	2	0	0	0	2
29439	186950	7	1	2	0	0	3
29439	188236	7	1	1	0	0	2
29439	189659	7	2	2	1	2	7
29439	189983	7	1	0	0	1	2
29439	199059	7	1	1	0	2	4
29439	203023	7	1	0	0	2	3
29439	206857	7	0	2	0	3	5
29439	207714	7	0	0	0	1	1
29439	217428	7	0	0	0	0	0
29439	218078	7	3	1	0	1	5
29439	278320	7	0	2	0	1	3
29439	278327	7	1	1	0	2	4
29439	278333	7	0	1	0	1	2
29439	278339	7	2	0	0	0	2
29439	278347	7	0	1	1	1	3
29439	278365	7	2	2	0	1	5
29439	278369	7	0	4	0	3	7
29439	278370	7	1	1	0	1	3
29439	278375	7	1	3	0	0	4
29439	278390	7	1	3	0	1	5
29439	402592	7	1	2	0	1	4
29439	402601	7	0	1	1	0	2
29439	402608	7	1	0	0	1	2
29439	402610	7	1	4	1	1	7
29439	402611	7	0	2	1	0	3
29439	402646	7	2	2	0	1	5
29439	402666	7	1	2	1	2	6
29439	402683	7	1	2	0	1	4
29439	402692	7	3	3	0	1	7
29439	402727	7	1	1	0	1	3
29439	402733	7	0	3	0	1	4
29439	402751	7	3	3	1	0	7
29439	402758	7	3	2	0	2	7
29439	402781	7	2	1	0	1	4
29439	402791	7	1	0	1	1	3
29439	402801	7	1	2	0	2	5
29439	402816	7	0	6	0	0	6
29439	402820	7	1	1	0	1	3
29439	402832	7	0	4	0	0	4
29439	402851	7	1	3	0	2	6
29439	402907	7	1	2	1	1	5
29439	402909	7	0	1	0	3	4
29439	402991	7	3	0	0	2	5
29439	403042	7	2	1	0	2	5
29439	403065	7	3	0	0	0	3
29439	403093	7	0	6	0	1	7
29439	403098	7	1	2	0	0	3
29439	403106	7	1	3	0	1	5
29439	403118	7	0	0	0	2	2
29439	403128	7	1	3	0	1	5
29439	403157	7	0	0	0	1	1
29439	403161	7	1	1	1	1	4
29439	403165	7	2	1	1	2	6
29439	52457	7	1	3	0	0	4
29439	55167	7	0	3	0	2	5
29439	71113	7	1	1	0	1	3
29439	91950	7	0	4	0	3	7
29439	184919	6	0	1	0	0	1
29439	188493	6	0	1	0	0	1
29439	190307	6	0	1	0	1	2
29439	194350	6	2	0	0	2	4
29439	195509	6	3	1	0	0	4
29439	195997	6	1	3	0	0	4
29439	196397	6	2	1	0	1	4
29439	198245	6	2	1	0	2	5
29439	198650	6	2	2	0	0	4
29439	202012	6	0	1	0	0	1
29439	203330	6	0	1	0	0	1
29439	203413	6	1	1	0	1	3
29439	206666	6	1	1	0	1	3
29439	210062	6	0	3	0	1	4
29439	216188	6	2	7	2	0	11
29439	217326	6	1	0	0	2	3
29439	218561	6	1	2	0	0	3
29439	221546	6	1	2	0	1	4
29439	278315	6	0	1	0	0	1
29439	278331	6	1	2	0	1	4
29439	278344	6	0	2	0	0	2
29439	278360	6	1	0	0	3	4
29439	278367	6	0	2	0	0	2
29439	278373	6	0	1	0	3	4
29439	278381	6	0	1	0	0	1
29439	278387	6	1	2	0	0	3
29439	278389	6	0	1	0	0	1
29439	402581	6	1	0	0	1	2
29439	402591	6	0	0	0	0	0
29439	402634	6	0	3	0	0	3
29439	402636	6	0	1	0	1	2
29439	402658	6	1	1	1	0	3
29439	402677	6	0	0	0	1	1
29439	402708	6	0	0	0	1	1
29439	402713	6	0	1	0	1	2
29439	402722	6	1	1	0	0	2
29439	402730	6	0	1	1	2	4
29439	402741	6	1	1	0	1	3
29439	402747	6	2	4	0	2	8
29439	402757	6	1	3	0	0	4
29439	402814	6	0	0	0	1	1
29439	402842	6	0	2	0	0	2
29439	402882	6	1	0	0	2	3
29439	402884	6	1	1	3	1	6
29439	402893	6	1	0	0	0	1
29439	402897	6	0	1	0	0	1
29439	402922	6	1	2	0	1	4
29439	402925	6	0	1	0	2	3
29439	402941	6	3	0	2	2	7
29439	402959	6	2	1	0	1	4
29439	403016	6	1	3	0	2	6
29439	403020	6	0	0	0	2	2
29439	403040	6	0	0	0	1	1
29439	403041	6	1	0	0	1	2
29439	403055	6	1	2	0	0	3
29439	403057	6	1	4	0	1	6
29439	403067	6	1	1	0	0	2
29439	403077	6	1	4	0	2	7
29439	403085	6	2	0	0	0	2
29439	403088	6	1	1	2	0	4
29439	403101	6	0	4	0	2	6
29439	403112	6	4	2	0	1	7
29439	403122	6	4	2	0	4	10
29439	403124	6	1	2	3	0	6
29439	403145	6	0	1	0	1	2
29439	403150	6	4	1	1	1	7
29439	53858	6	1	0	0	3	4
29439	54193	6	0	1	0	0	1
29439	66670	6	0	1	0	0	1
29439	70332	6	0	1	1	2	4
29439	80561	6	0	1	0	3	4
29439	93852	6	1	2	0	0	3
29439	101689	5	1	1	0	3	5
29439	104168	5	2	2	0	2	6
29439	105958	5	0	2	0	1	3
29439	183248	5	0	1	0	1	2
29439	184494	5	1	6	0	1	8
29439	188848	5	1	5	1	1	8
29439	189910	5	0	2	0	0	2
29439	190497	5	1	1	0	1	3
29439	191338	5	0	2	0	0	2
29439	193875	5	0	2	0	1	3
29439	196055	5	1	1	0	0	2
29439	196071	5	3	3	0	0	6
29439	197245	5	0	1	0	0	1
29439	200224	5	0	3	0	1	4
29439	201263	5	0	3	0	1	4
29439	201597	5	0	2	0	1	3
29439	202591	5	0	1	0	0	1
29439	202714	5	1	1	0	1	3
29439	203062	5	0	1	0	1	2
29439	203135	5	0	0	0	0	0
29439	203815	5	1	1	1	1	4
29439	204765	5	1	0	0	1	2
29439	205240	5	0	1	0	0	1
29439	205917	5	0	3	0	2	5
29439	206260	5	4	2	0	2	8
29439	207002	5	0	1	0	0	1
29439	208848	5	1	1	0	0	2
29439	211655	5	2	1	0	1	4
29439	215406	5	0	0	0	1	1
29439	216229	5	0	3	0	0	3
29439	216994	5	2	2	0	2	6
29439	217300	5	1	1	0	2	4
29439	218003	5	0	3	0	0	3
29439	219622	5	0	2	0	1	3
29439	278318	5	0	1	0	2	3
29439	278319	5	0	1	0	3	4
29439	278321	5	2	0	0	3	5
29439	278334	5	1	1	0	3	5
29439	278335	5	0	2	0	1	3
29439	278336	5	0	1	0	1	2
29439	278352	5	0	0	0	1	1
29439	278358	5	2	2	0	2	6
29439	278372	5	4	0	1	0	5
29439	278374	5	1	1	0	0	2
29439	278377	5	0	2	1	1	4
29439	278379	5	2	1	0	1	4
29439	278384	5	1	1	0	3	5
29439	402580	5	1	0	0	0	1
29439	402583	5	2	4	0	1	7
29439	402599	5	0	0	0	0	0
29439	402600	5	1	2	0	2	5
29439	402613	5	1	1	0	1	3
29439	402645	5	1	0	0	4	5
29439	402648	5	0	1	0	0	1
29439	402649	5	1	2	1	0	4
29439	402681	5	1	1	0	0	2
29439	402682	5	1	1	0	3	5
29439	402690	5	0	0	0	3	3
29439	402691	5	2	1	0	2	5
29439	402701	5	0	1	0	1	2
29439	402724	5	2	2	0	3	7
29439	402731	5	0	1	0	0	1
29439	402745	5	0	1	0	2	3
29439	402749	5	1	0	0	1	2
29439	402754	5	0	1	0	0	1
29439	402759	5	1	1	0	0	2
29439	402773	5	0	2	0	0	2
29439	402774	5	0	3	0	1	4
29439	402777	5	1	1	0	0	2
29439	402782	5	0	0	0	0	0
29439	402786	5	1	0	0	0	1
29439	402788	5	1	2	2	1	6
29439	402794	5	0	0	0	1	1
29439	402795	5	2	0	0	3	5
29439	402804	5	0	3	0	0	3
29439	402809	5	1	2	1	2	6
29439	402819	5	1	1	0	1	3
29439	402821	5	0	4	0	2	6
29439	402822	5	0	5	0	2	7
29439	402831	5	0	2	0	0	2
29439	402835	5	2	0	2	0	4
29439	402841	5	1	1	0	0	2
29439	402843	5	1	0	0	1	2
29439	402847	5	1	2	0	0	3
29439	402849	5	1	2	0	1	4
29439	402852	5	0	1	1	1	3
29439	402853	5	1	1	0	2	4
29439	402854	5	0	1	0	0	1
29439	402857	5	0	2	0	2	4
29439	402865	5	0	0	1	0	1
29439	402881	5	2	0	0	3	5
29439	402883	5	0	2	0	1	3
29439	402887	5	1	2	1	0	4
29439	402895	5	0	0	0	1	1
29439	402910	5	1	2	0	2	5
29439	402912	5	0	0	0	2	2
29439	402914	5	4	1	0	1	6
29439	402916	5	0	0	0	0	0
29439	402917	5	0	1	0	1	2
29439	402920	5	1	2	0	0	3
29439	402927	5	2	2	0	0	4
29439	402931	5	0	0	2	0	2
29439	402935	5	0	0	0	0	0
29439	402948	5	1	2	0	0	3
29439	402953	5	1	2	0	0	3
29439	402958	5	0	2	0	1	3
29439	402960	5	2	0	0	3	5
29439	402963	5	0	2	0	0	2
29439	402974	5	0	0	0	1	1
29439	402992	5	2	2	0	2	6
29439	402993	5	1	2	0	0	3
29439	402996	5	1	2	0	0	3
29439	403005	5	0	1	0	0	1
29439	403014	5	2	2	0	1	5
29439	403022	5	0	1	0	1	2
29439	403032	5	0	2	0	1	3
29439	403036	5	1	2	0	1	4
29439	403039	5	0	1	0	1	2
29439	403050	5	1	1	0	0	2
29439	403053	5	1	2	0	1	4
29439	403063	5	0	0	0	1	1
29439	403068	5	0	1	0	0	1
29439	403081	5	1	1	0	3	5
29439	403089	5	1	3	0	1	5
29439	403094	5	0	4	0	0	4
29439	403097	5	2	3	0	1	6
29439	403117	5	2	1	0	0	3
29439	403126	5	0	0	0	1	1
29439	403135	5	2	1	0	1	4
29439	403151	5	1	3	0	2	6
29439	403153	5	2	0	0	1	3
29439	403164	5	0	2	0	3	5
29439	59263	5	0	1	0	4	5
29439	64163	5	0	1	0	0	1
29439	67070	5	0	2	0	2	4
29439	70925	5	0	2	1	1	4
29439	71193	5	0	1	0	2	3
29439	77565	5	0	1	0	1	2
29439	90762	5	0	1	0	1	2
29439	184296	4	1	2	0	0	3
29439	185465	4	1	2	0	0	3
29439	186954	4	0	1	0	2	3
29439	187005	4	0	0	0	1	1
29439	187853	4	0	2	0	0	2
29439	188440	4	1	1	0	0	2
29439	189069	4	0	1	0	1	2
29439	189639	4	1	1	0	1	3
29439	190478	4	0	1	0	0	1
29439	194289	4	3	0	0	0	3
29439	195807	4	0	3	0	3	6
29439	195893	4	0	1	0	0	1
29439	196094	4	1	1	0	0	2
29439	197190	4	4	0	0	0	4
29439	199226	4	0	2	1	0	3
29439	199987	4	0	5	0	3	8
29439	203227	4	0	2	0	1	3
29439	203323	4	2	1	1	1	5
29439	203659	4	1	4	0	1	6
29439	203796	4	1	0	0	0	1
29439	204610	4	1	1	0	0	2
29439	205468	4	2	2	0	1	5
29439	207120	4	2	2	0	1	5
29439	207539	4	0	1	0	1	2
29439	208165	4	0	1	0	2	3
29439	209530	4	0	0	1	0	1
29439	210408	4	0	3	0	1	4
29439	210729	4	1	0	0	2	3
29439	211169	4	0	0	2	1	3
29439	212290	4	0	2	0	1	3
29439	212452	4	1	4	0	0	5
29439	212864	4	2	2	0	1	5
29439	213281	4	0	1	0	1	2
29439	213539	4	0	2	0	0	2
29439	213895	4	1	0	0	0	1
29439	214145	4	2	2	0	0	4
29439	214374	4	1	1	0	1	3
29439	214435	4	0	2	0	1	3
29439	214536	4	2	0	0	1	3
29439	214955	4	1	1	0	0	2
29439	215316	4	0	2	0	1	3
29439	215784	4	2	1	0	3	6
29439	216365	4	1	1	0	1	3
29439	216659	4	0	2	0	3	5
29439	216756	4	0	1	1	1	3
29439	217137	4	0	3	1	1	5
29439	219850	4	0	1	0	0	1
29439	220516	4	0	0	0	0	0
29439	278296	4	1	0	0	0	1
29439	278311	4	2	0	0	1	3
29439	278322	4	0	0	0	1	1
29439	278337	4	0	0	0	1	1
29439	278338	4	0	0	0	0	0
29439	278350	4	1	0	0	1	2
29439	278351	4	0	3	0	0	3
29439	278364	4	0	1	0	1	2
29439	278368	4	1	0	0	2	3
29439	278388	4	1	5	1	1	8
29439	402586	4	2	2	0	3	7
29439	402595	4	2	2	1	0	5
29439	402596	4	0	2	0	1	3
29439	402598	4	1	2	0	1	4
29439	402606	4	0	1	0	1	2
29439	402609	4	3	1	0	0	4
29439	402616	4	1	1	0	0	2
29439	402625	4	0	1	0	1	2
29439	402628	4	3	2	0	1	6
29439	402633	4	0	1	0	2	3
29439	402635	4	1	0	0	0	1
29439	402638	4	0	5	0	2	7
29439	402644	4	1	1	0	0	2
29439	402653	4	0	1	0	1	2
29439	402654	4	0	2	0	1	3
29439	402661	4	3	0	1	0	4
29439	402672	4	1	0	0	3	4
29439	402673	4	1	3	0	1	5
29439	402679	4	0	2	0	0	2
29439	402687	4	0	3	0	1	4
29439	402688	4	1	1	0	1	3
29439	402697	4	0	0	0	0	0
29439	402714	4	0	2	0	2	4
29439	402715	4	0	1	0	0	1
29439	402716	4	0	1	0	1	2
29439	402718	4	0	0	1	0	1
29439	402725	4	0	2	0	0	2
29439	402728	4	2	0	0	2	4
29439	402729	4	0	1	0	1	2
29439	402734	4	2	2	0	0	4
29439	402740	4	0	0	1	0	1
29439	402742	4	1	1	0	0	2
29439	402752	4	1	1	0	2	4
29439	402753	4	2	0	0	2	4
29439	402766	4	2	2	0	1	5
29439	402767	4	2	1	0	2	5
29439	402771	4	1	1	0	3	5
29439	402778	4	0	1	0	0	1
29439	402779	4	0	1	0	1	2
29439	402793	4	1	2	0	0	3
29439	402797	4	0	2	0	3	5
29439	402798	4	0	1	2	1	4
29439	402799	4	2	1	0	1	4
29439	402803	4	2	2	0	3	7
29439	402805	4	0	1	0	0	1
29439	402807	4	0	0	0	1	1
29439	402811	4	2	1	0	0	3
29439	402813	4	1	1	1	2	5
29439	402815	4	0	1	0	1	2
29439	402823	4	0	1	1	1	3
29439	402827	4	3	1	0	0	4
29439	402834	4	1	1	0	1	3
29439	402840	4	2	1	0	0	3
29439	402850	4	2	0	0	0	2
29439	402855	4	0	1	0	1	2
29439	402858	4	0	1	0	2	3
29439	402867	4	0	0	1	3	4
29439	402879	4	1	2	0	0	3
29439	402888	4	1	1	0	1	3
29439	402892	4	2	1	0	0	3
29439	402896	4	2	1	0	2	5
29439	402899	4	1	1	0	0	2
29439	402906	4	1	3	0	1	5
29439	402913	4	0	2	2	0	4
29439	402915	4	2	0	0	1	3
29439	402918	4	0	3	0	0	3
29439	402930	4	0	1	0	2	3
29439	402932	4	3	1	0	1	5
29439	402938	4	0	1	1	1	3
29439	402940	4	1	3	0	0	4
29439	402942	4	3	2	0	2	7
29439	402946	4	1	2	0	1	4
29439	402949	4	1	1	0	1	3
29439	402954	4	2	0	0	0	2
29439	402962	4	1	0	0	0	1
29439	402965	4	0	2	0	1	3
29439	402966	4	1	0	0	0	1
29439	402981	4	2	1	2	2	7
29439	402984	4	1	2	0	1	4
29439	402988	4	0	0	0	1	1
29439	402994	4	1	1	0	1	3
29439	403003	4	0	0	1	1	2
29439	403007	4	0	1	0	1	2
29439	403009	4	1	1	0	2	4
29439	403012	4	0	1	0	1	2
29439	403017	4	1	1	0	0	2
29439	403027	4	0	0	0	0	0
29439	403031	4	1	2	0	2	5
29439	403037	4	1	1	0	0	2
29439	403043	4	2	1	1	1	5
29439	403047	4	0	3	0	0	3
29439	403049	4	2	0	0	0	2
29439	403051	4	0	1	0	0	1
29439	403052	4	0	2	0	3	5
29439	403054	4	1	0	1	0	2
29439	403058	4	0	2	0	0	2
29439	403066	4	1	1	0	1	3
29439	403074	4	1	2	0	1	4
29439	403084	4	0	3	0	0	3
29439	403087	4	0	3	0	1	4
29439	403090	4	1	1	0	1	3
29439	403105	4	1	2	0	0	3
29439	403107	4	0	2	0	0	2
29439	403108	4	1	1	0	0	2
29439	403109	4	1	2	0	1	4
29439	403111	4	2	2	0	1	5
29439	403114	4	1	1	0	2	4
29439	403119	4	0	0	0	0	0
29439	403125	4	0	0	0	1	1
29439	403127	4	1	2	0	0	3
29439	403133	4	1	1	0	1	3
29439	403134	4	2	1	0	1	4
29439	403138	4	0	1	0	1	2
29439	403142	4	0	0	0	0	0
29439	403147	4	0	3	1	1	5
29439	403152	4	2	0	0	0	2
29439	403154	4	1	1	0	0	2
29439	403156	4	2	2	1	0	5
29439	403159	4	1	5	1	1	8
29439	403163	4	0	1	0	2	3
29439	59811	4	1	5	1	1	8
29439	70821	4	0	1	0	1	2
29439	86657	4	1	0	0	2	3
29439	101561	3	0	0	0	0	0
29439	102061	3	0	0	0	2	2
29439	103370	3	1	0	0	0	1
29439	182739	3	0	2	0	0	2
29439	183120	3	0	1	0	0	1
29439	183749	3	0	0	0	2	2
29439	184230	3	1	1	0	0	2
29439	184554	3	0	0	0	0	0
29439	185864	3	0	1	0	0	1
29439	186806	3	1	0	0	1	2
29439	186854	3	1	1	0	0	2
29439	187108	3	1	0	0	3	4
29439	189753	3	0	1	0	1	2
29439	190931	3	0	0	0	0	0
29439	191598	3	2	0	0	0	2
29439	192863	3	0	2	0	0	2
29439	193302	3	0	0	0	2	2
29439	194387	3	0	0	0	0	0
29439	196368	3	0	1	0	3	4
29439	196416	3	0	1	0	0	1
29439	196423	3	1	0	0	1	2
29439	196538	3	1	3	0	0	4
29439	198160	3	1	0	0	0	1
29439	198240	3	2	0	0	1	3
29439	198444	3	2	3	0	2	7
29439	198504	3	0	0	0	0	0
29439	200231	3	0	0	0	1	1
29439	201293	3	0	2	0	1	3
29439	201316	3	0	0	1	1	2
29439	202646	3	1	0	0	0	1
29439	203196	3	2	0	0	2	4
29439	203230	3	0	2	0	0	2
29439	203758	3	1	4	0	0	5
29439	203987	3	0	1	0	1	2
29439	204904	3	1	2	0	0	3
29439	204967	3	1	1	0	0	2
29439	204970	3	0	1	0	1	2
29439	205997	3	0	1	0	0	1
29439	206307	3	0	1	0	0	1
29439	206631	3	1	0	0	0	1
29439	206983	3	1	0	0	0	1
29439	207180	3	0	0	0	1	1
29439	207192	3	1	0	0	0	1
29439	207269	3	1	2	0	3	6
29439	207288	3	0	1	0	1	2
29439	207356	3	0	0	0	1	1
29439	207607	3	0	2	0	0	2
29439	207967	3	1	1	0	0	2
29439	208001	3	0	0	1	1	2
29439	208348	3	1	0	0	1	2
29439	208823	3	0	1	0	1	2
29439	208868	3	1	1	0	0	2
29439	209371	3	0	1	0	0	1
29439	209776	3	1	0	0	2	3
29439	211224	3	0	1	0	0	1
29439	211849	3	1	2	0	1	4
29439	212353	3	0	0	0	0	0
29439	212541	3	1	1	1	2	5
29439	212697	3	2	1	1	0	4
29439	212932	3	0	1	0	0	1
29439	213332	3	1	1	0	1	3
29439	213377	3	0	1	0	0	1
29439	213563	3	0	0	0	0	0
29439	213601	3	1	1	0	0	2
29439	214034	3	0	1	0	0	1
29439	214483	3	0	1	0	2	3
29439	214804	3	0	0	0	2	2
29439	215252	3	1	1	0	0	2
29439	216625	3	0	0	1	0	1
29439	216795	3	0	1	0	1	2
29439	217444	3	1	0	0	1	2
29439	218687	3	1	1	0	3	5
29439	218763	3	0	2	0	0	2
29439	220138	3	2	0	1	0	3
29439	221557	3	0	2	0	0	2
29439	278305	3	1	1	0	1	3
29439	278307	3	2	1	0	1	4
29439	278308	3	0	1	0	0	1
29439	278312	3	3	0	0	0	3
29439	278313	3	0	0	0	1	1
29439	278323	3	2	0	0	0	2
29439	278324	3	2	4	0	0	6
29439	278325	3	0	0	0	3	3
29439	278328	3	0	0	1	1	2
29439	278345	3	0	1	0	0	1
29439	278354	3	0	3	0	1	4
29439	278362	3	2	2	0	2	6
29439	278363	3	0	0	0	0	0
29439	278371	3	0	1	0	1	2
29439	278376	3	1	0	0	1	2
29439	278382	3	0	2	0	0	2
29439	278386	3	3	2	0	1	6
29439	402579	3	1	1	0	1	3
29439	402584	3	3	2	0	1	6
29439	402590	3	2	0	1	0	3
29439	402602	3	0	2	0	1	3
29439	402622	3	2	0	0	1	3
29439	402626	3	0	1	0	0	1
29439	402629	3	1	3	0	0	4
29439	402643	3	0	1	0	1	2
29439	402655	3	1	0	0	0	1
29439	402656	3	0	1	0	1	2
29439	402659	3	2	0	0	0	2
29439	402663	3	0	0	0	0	0
29439	402664	3	1	4	0	3	8
29439	402670	3	1	0	0	1	2
29439	402675	3	0	0	0	0	0
29439	402676	3	0	2	0	1	3
29439	402680	3	0	0	0	1	1
29439	402685	3	0	2	0	2	4
29439	402694	3	3	1	0	0	4
29439	402695	3	3	3	0	0	6
29439	402699	3	1	0	0	1	2
29439	402706	3	0	1	0	1	2
29439	402709	3	0	0	2	0	2
29439	402710	3	1	0	0	0	1
29439	402719	3	1	0	0	2	3
29439	402721	3	0	0	0	3	3
29439	402739	3	1	1	0	1	3
29439	402744	3	0	1	1	2	4
29439	402748	3	0	3	1	2	6
29439	402755	3	1	1	1	2	5
29439	402756	3	0	1	0	0	1
29439	402763	3	1	2	0	1	4
29439	402768	3	1	2	0	1	4
29439	402775	3	3	1	0	1	5
29439	402784	3	1	2	0	1	4
29439	402787	3	0	1	0	1	2
29439	402800	3	0	3	0	0	3
29439	402802	3	0	1	0	2	3
29439	402806	3	1	2	0	1	4
29439	402808	3	0	0	0	1	1
29439	402825	3	1	1	0	2	4
29439	402828	3	0	0	0	2	2
29439	402836	3	0	1	0	0	1
29439	402838	3	1	2	0	0	3
29439	402839	3	1	1	0	0	2
29439	402856	3	2	1	0	0	3
29439	402860	3	2	1	0	2	5
29439	402864	3	0	0	0	2	2
29439	402866	3	0	2	0	0	2
29439	402870	3	1	1	0	0	2
29439	402874	3	0	1	0	0	1
29439	402885	3	2	2	1	0	5
29439	402886	3	1	1	0	0	2
29439	402889	3	1	0	0	1	2
29439	402894	3	1	1	0	1	3
29439	402921	3	0	1	0	0	1
29439	402923	3	0	1	0	0	1
29439	402928	3	1	1	0	2	4
29439	402939	3	3	0	0	0	3
29439	402944	3	2	2	0	1	5
29439	402945	3	1	2	0	0	3
29439	402961	3	0	3	0	0	3
29439	402976	3	0	1	0	1	2
29439	402977	3	2	1	0	2	5
29439	402978	3	1	1	0	0	2
29439	402983	3	2	1	0	1	4
29439	402985	3	0	1	0	1	2
29439	402986	3	0	2	0	0	2
29439	402987	3	0	3	0	0	3
29439	402990	3	1	0	0	1	2
29439	402997	3	1	1	0	0	2
29439	403000	3	2	1	1	0	4
29439	403013	3	0	0	0	0	0
29439	403015	3	1	1	0	0	2
29439	403018	3	0	1	0	0	1
29439	403019	3	0	1	0	1	2
29439	403021	3	0	2	0	1	3
29439	403023	3	1	2	0	1	4
29439	403024	3	0	2	0	0	2
29439	403026	3	1	0	1	2	4
29439	403029	3	0	1	0	1	2
29439	403033	3	1	0	0	0	1
29439	403034	3	1	1	0	1	3
29439	403044	3	1	1	0	2	4
29439	403046	3	0	2	0	0	2
29439	403048	3	2	2	0	0	4
29439	403059	3	1	1	0	0	2
29439	403064	3	1	3	0	1	5
29439	403069	3	0	0	0	2	2
29439	403070	3	0	0	0	1	1
29439	403071	3	0	1	0	2	3
29439	403072	3	1	3	0	0	4
29439	403078	3	0	2	0	1	3
29439	403083	3	1	2	0	1	4
29439	403092	3	0	2	0	0	2
29439	403115	3	0	1	0	0	1
29439	403120	3	0	3	0	0	3
29439	403123	3	1	0	0	0	1
29439	403129	3	0	0	0	0	0
29439	403130	3	1	1	0	2	4
29439	403132	3	1	2	0	0	3
29439	403140	3	0	0	0	1	1
29439	403141	3	0	2	0	1	3
29439	403143	3	0	2	0	0	2
29439	403144	3	1	1	0	0	2
29439	403146	3	1	1	0	1	3
29439	72452	3	1	0	0	1	2
29439	85184	3	0	2	1	0	3
29439	86192	3	1	1	0	1	3
29439	102881	2	1	1	0	0	2
29439	182325	2	1	2	0	0	3
29439	183745	2	1	1	0	1	3
29439	185726	2	0	1	0	3	4
29439	186818	2	0	1	0	0	1
29439	186984	2	0	1	0	2	3
29439	187004	2	0	1	0	1	2
29439	187063	2	0	0	0	0	0
29439	188289	2	0	1	0	0	1
29439	190659	2	0	0	0	0	0
29439	191069	2	0	0	0	0	0
29439	191537	2	0	0	0	0	0
29439	192700	2	0	0	0	0	0
29439	193025	2	0	3	0	1	4
29439	193300	2	1	0	0	1	2
29439	193639	2	0	0	0	0	0
29439	193979	2	1	0	0	1	2
29439	194253	2	0	2	0	0	2
29439	194511	2	1	3	0	0	4
29439	194974	2	0	1	0	1	2
29439	195910	2	0	2	0	0	2
29439	197301	2	0	1	0	0	1
29439	198024	2	0	1	0	0	1
29439	198486	2	1	2	0	0	3
29439	198563	2	2	1	0	0	3
29439	200049	2	1	1	0	0	2
29439	200563	2	1	0	1	0	2
29439	201195	2	0	2	0	0	2
29439	201324	2	0	4	0	1	5
29439	201445	2	1	1	0	0	2
29439	201566	2	0	1	0	1	2
29439	201572	2	0	3	0	0	3
29439	201583	2	0	1	0	0	1
29439	201903	2	0	1	0	0	1
29439	203152	2	0	1	0	1	2
29439	203213	2	1	0	0	1	2
29439	203731	2	0	1	0	0	1
29439	203785	2	0	0	0	1	1
29439	203848	2	0	1	0	1	2
29439	204792	2	0	1	0	1	2
29439	206014	2	1	1	0	0	2
29439	206071	2	1	1	0	1	3
29439	206091	2	0	1	0	0	1
29439	206284	2	1	2	0	1	4
29439	207094	2	0	0	0	0	0
29439	207363	2	0	1	0	1	2
29439	207433	2	0	1	0	2	3
29439	207574	2	0	1	0	0	1
29439	207657	2	0	1	0	0	1
29439	207906	2	1	1	0	1	3
29439	208803	2	0	0	0	1	1
29439	209620	2	0	2	0	1	3
29439	210004	2	0	0	0	1	1
29439	210448	2	0	0	1	1	2
29439	211095	2	1	0	0	0	1
29439	211706	2	0	0	0	0	0
29439	211878	2	0	2	0	2	4
29439	212746	2	0	0	0	1	1
29439	213349	2	0	0	0	0	0
29439	213480	2	0	0	0	1	1
29439	214227	2	0	1	0	0	1
29439	214674	2	0	1	0	0	1
29439	215015	2	0	1	0	1	2
29439	215770	2	0	0	0	1	1
29439	216046	2	0	1	0	1	2
29439	216323	2	0	1	0	1	2
29439	216762	2	0	1	0	0	1
29439	216923	2	1	0	0	1	2
29439	216969	2	0	1	0	0	1
29439	217072	2	0	1	0	0	1
29439	217377	2	0	0	0	0	0
29439	218273	2	0	1	0	0	1
29439	218605	2	0	1	0	0	1
29439	218606	2	0	1	0	0	1
29439	218819	2	1	1	0	0	2
29439	218968	2	1	0	0	2	3
29439	219021	2	0	2	0	0	2
29439	219986	2	1	4	0	2	7
29439	220008	2	0	1	0	0	1
29439	220042	2	0	1	0	0	1
29439	220809	2	0	0	0	1	1
29439	220872	2	0	2	0	0	2
29439	278300	2	0	0	0	0	0
29439	278301	2	1	2	0	0	3
29439	278310	2	0	1	0	1	2
29439	278316	2	0	0	0	0	0
29439	278317	2	0	0	0	1	1
29439	278329	2	1	1	0	1	3
29439	278330	2	0	0	0	0	0
29439	278332	2	0	0	0	3	3
29439	278341	2	1	2	0	0	3
29439	278342	2	0	2	0	0	2
29439	278343	2	0	0	0	1	1
29439	278346	2	1	3	0	0	4
29439	278348	2	0	1	0	0	1
29439	278355	2	0	1	1	1	3
29439	278361	2	1	2	1	1	5
29439	402578	2	0	0	0	0	0
29439	402582	2	0	1	0	0	1
29439	402593	2	1	1	0	0	2
29439	402605	2	0	0	0	1	1
29439	402607	2	0	1	0	1	2
29439	402617	2	1	1	0	0	2
29439	402619	2	1	1	0	2	4
29439	402620	2	0	0	0	0	0
29439	402621	2	1	2	0	0	3
29439	402624	2	0	0	1	0	1
29439	402631	2	0	0	0	0	0
29439	402637	2	1	1	0	0	2
29439	402639	2	0	0	0	0	0
29439	402640	2	0	0	2	0	2
29439	402650	2	1	1	0	0	2
29439	402657	2	1	2	0	1	4
29439	402660	2	1	0	0	0	1
29439	402662	2	1	0	0	1	2
29439	402667	2	0	2	0	0	2
29439	402669	2	0	0	0	0	0
29439	402671	2	1	1	0	2	4
29439	402689	2	1	0	0	1	2
29439	402693	2	0	1	1	0	2
29439	402705	2	1	0	0	2	3
29439	402711	2	1	2	1	0	4
29439	402712	2	2	0	0	0	2
29439	402720	2	2	1	1	2	6
29439	402732	2	1	5	0	1	7
29439	402738	2	0	1	0	1	2
29439	402760	2	1	0	0	2	3
29439	402772	2	1	1	0	1	3
29439	402776	2	0	3	0	0	3
29439	402780	2	0	1	0	0	1
29439	402785	2	0	0	0	0	0
29439	402789	2	0	1	0	3	4
29439	402792	2	0	0	0	0	0
29439	402810	2	0	0	0	0	0
29439	402818	2	1	0	0	2	3
29439	402824	2	1	2	0	0	3
29439	402830	2	1	0	0	0	1
29439	402833	2	0	0	1	1	2
29439	402837	2	0	2	0	0	2
29439	402844	2	0	2	0	0	2
29439	402859	2	1	2	0	0	3
29439	402861	2	1	2	0	1	4
29439	402862	2	0	0	0	0	0
29439	402863	2	0	0	0	0	0
29439	402869	2	2	1	0	1	4
29439	402871	2	0	1	0	0	1
29439	402880	2	0	0	1	0	1
29439	402891	2	1	3	0	0	4
29439	402902	2	1	2	0	0	3
29439	402903	2	2	0	0	3	5
29439	402905	2	1	2	0	2	5
29439	402911	2	0	2	0	1	3
29439	402919	2	0	1	0	0	1
29439	402924	2	0	0	1	2	3
29439	402933	2	1	0	0	0	1
29439	402934	2	1	1	0	1	3
29439	402950	2	2	0	0	0	2
29439	402951	2	1	0	0	1	2
29439	402957	2	0	1	0	0	1
29439	402968	2	0	1	0	0	1
29439	402970	2	2	0	0	1	3
29439	402971	2	2	1	0	0	3
29439	402972	2	0	1	1	0	2
29439	402973	2	0	0	0	1	1
29439	402975	2	0	1	0	1	2
29439	402979	2	0	0	0	1	1
29439	402980	2	0	0	0	0	0
29439	402982	2	1	0	0	2	3
29439	402998	2	0	0	0	1	1
29439	403001	2	0	0	0	1	1
29439	403004	2	0	0	0	0	0
29439	403028	2	1	1	0	0	2
29439	403030	2	0	2	0	1	3
29439	403035	2	0	1	0	1	2
29439	403045	2	0	1	0	1	2
29439	403060	2	0	1	0	0	1
29439	403076	2	0	2	0	0	2
29439	403079	2	0	2	0	1	3
29439	403086	2	1	3	0	0	4
29439	403091	2	0	1	0	0	1
29439	403095	2	0	0	0	4	4
29439	403102	2	0	1	0	2	3
29439	403103	2	0	2	0	0	2
29439	403113	2	1	1	0	0	2
29439	403116	2	0	2	0	0	2
29439	403121	2	0	0	0	0	0
29439	403136	2	0	2	0	1	3
29439	403137	2	0	0	0	0	0
29439	403148	2	0	1	0	1	2
29439	403149	2	1	2	0	1	4
29439	50159	2	1	3	0	0	4
29439	53677	2	0	0	0	1	1
29439	65964	2	0	0	0	0	0
29439	67230	2	0	0	0	0	0
29439	84098	2	0	1	0	0	1
29439	85187	2	0	2	0	0	2
29439	95577	2	0	0	0	1	1
29439	98497	2	0	1	1	1	3
29439	98997	2	0	0	0	0	0
29439	182740	1	1	1	0	0	2
29439	183062	1	0	0	0	1	1
29439	183504	1	1	1	0	1	3
29439	185479	1	0	0	0	1	1
29439	185579	1	0	0	0	0	0
29439	185580	1	0	0	0	0	0
29439	185615	1	0	1	0	0	1
29439	185650	1	0	0	0	0	0
29439	186528	1	1	0	0	0	1
29439	186809	1	1	0	0	0	1
29439	186942	1	0	0	0	1	1
29439	187121	1	1	0	0	0	1
29439	189562	1	1	1	0	1	3
29439	190082	1	0	0	0	1	1
29439	191130	1	0	0	0	0	0
29439	191243	1	0	0	0	1	1
29439	191505	1	1	0	0	0	1
29439	191604	1	0	0	0	0	0
29439	192383	1	1	1	0	0	2
29439	192404	1	0	0	0	1	1
29439	192551	1	0	0	0	0	0
29439	193599	1	0	2	0	0	2
29439	194924	1	0	1	0	1	2
29439	195606	1	1	0	0	0	1
29439	195859	1	0	0	0	0	0
29439	197170	1	0	2	0	0	2
29439	199155	1	0	1	0	1	2
29439	199882	1	0	1	0	1	2
29439	200081	1	1	0	0	1	2
29439	200434	1	0	0	0	1	1
29439	200858	1	1	1	0	0	2
29439	201289	1	0	0	0	1	1
29439	201326	1	1	0	0	0	1
29439	201995	1	0	0	0	1	1
29439	203276	1	0	1	0	0	1
29439	203331	1	0	0	0	0	0
29439	203341	1	0	2	0	0	2
29439	204901	1	0	1	0	1	2
29439	205987	1	0	0	0	0	0
29439	206131	1	0	0	0	0	0
29439	207115	1	0	1	0	1	2
29439	207153	1	0	0	0	1	1
29439	207191	1	0	1	1	0	2
29439	207350	1	0	1	0	1	2
29439	207482	1	0	0	0	0	0
29439	207742	1	0	0	0	0	0
29439	208354	1	0	1	0	0	1
29439	209659	1	0	1	0	1	2
29439	210453	1	0	2	0	0	2
29439	211193	1	0	1	0	0	1
29439	213909	1	0	1	0	2	3
29439	214361	1	0	1	0	1	2
29439	214400	1	2	2	0	0	4
29439	215713	1	0	1	0	0	1
29439	216252	1	0	0	0	2	2
29439	216865	1	0	2	0	1	3
29439	217371	1	1	0	0	0	1
29439	217696	1	0	0	0	0	0
29439	218046	1	0	0	0	1	1
29439	218595	1	2	2	1	0	5
29439	218770	1	0	1	0	0	1
29439	220863	1	0	1	0	0	1
29439	221509	1	0	1	0	1	2
29439	221929	1	0	1	0	3	4
29439	278295	1	0	0	0	0	0
29439	278298	1	0	1	0	0	1
29439	278299	1	0	0	0	0	0
29439	278303	1	0	1	2	1	4
29439	278304	1	0	0	0	0	0
29439	278309	1	0	0	0	0	0
29439	278340	1	0	0	0	0	0
29439	278357	1	0	1	0	0	1
29439	278366	1	1	0	0	0	1
29439	402577	1	0	0	0	0	0
29439	402585	1	0	0	0	0	0
29439	402588	1	1	1	0	1	3
29439	402589	1	1	0	0	1	2
29439	402597	1	0	2	0	0	2
29439	402603	1	0	2	0	0	2
29439	402623	1	0	1	0	1	2
29439	402627	1	1	1	0	1	3
29439	402632	1	1	2	0	0	3
29439	402641	1	1	3	0	0	4
29439	402668	1	2	1	0	1	4
29439	402674	1	1	1	0	0	2
29439	402686	1	0	0	0	1	1
29439	402736	1	1	1	0	2	4
29439	402737	1	0	0	0	1	1
29439	402761	1	1	0	0	1	2
29439	402762	1	0	0	0	0	0
29439	402783	1	0	1	0	1	2
29439	402817	1	0	1	0	0	1
29439	402829	1	1	1	0	1	3
29439	402848	1	2	0	0	0	2
29439	402875	1	0	1	0	0	1
29439	402878	1	0	0	0	0	0
29439	402890	1	0	1	0	0	1
29439	402900	1	0	0	1	1	2
29439	402908	1	2	0	0	1	3
29439	402926	1	1	0	0	0	1
29439	402937	1	0	0	0	0	0
29439	402943	1	2	0	0	1	3
29439	402952	1	0	1	0	1	2
29439	402955	1	0	0	0	2	2
29439	402956	1	1	1	0	1	3
29439	402964	1	1	0	0	1	2
29439	402967	1	0	3	0	1	4
29439	402995	1	0	3	0	0	3
29439	402999	1	1	1	0	3	5
29439	403002	1	0	2	0	0	2
29439	403011	1	0	1	0	1	2
29439	403038	1	1	1	0	4	6
29439	403061	1	1	0	0	1	2
29439	403062	1	1	0	0	1	2
29439	403073	1	1	0	0	1	2
29439	403080	1	0	1	0	0	1
29439	403082	1	0	0	0	0	0
29439	403096	1	2	1	1	0	4
29439	403099	1	0	0	0	0	0
29439	403104	1	1	0	0	1	2
29439	403110	1	0	2	0	0	2
29439	403155	1	2	1	0	0	3
29439	63716	1	1	2	0	2	5
29439	70241	1	0	0	0	0	0
29439	71488	1	0	1	2	1	4
29439	71694	1	0	0	0	0	0
29439	77905	1	1	1	0	0	2
29439	79127	1	1	0	0	0	1
29439	79596	1	0	1	0	0	1
64482	63027	72	7	5	2	3	17
64482	600331	37	1	3	4	3	11
64482	600315	30	5	4	1	5	15
64482	600341	28	2	2	0	1	5
64482	600470	23	2	1	0	0	3
64482	599994	22	0	1	0	3	4
64482	599998	21	0	2	0	2	4
64482	600332	21	2	0	0	0	2
64482	300260	19	6	5	0	0	11
64482	55206	18	3	1	1	0	5
64482	300271	17	0	1	0	0	1
64482	600478	17	6	4	3	0	13
64482	85025	17	3	2	1	0	6
64482	91156	17	0	1	0	0	1
64482	599907	16	3	3	0	4	10
64482	600207	16	1	0	2	1	4
64482	600269	16	1	5	0	2	8
64482	600458	16	0	1	0	0	1
64482	300269	15	0	0	0	1	1
64482	600129	15	2	0	0	4	6
64482	600450	15	0	2	0	0	2
64482	183785	14	0	1	1	0	2
64482	219782	14	7	3	0	1	11
64482	599898	14	2	1	1	0	4
64482	599971	14	3	4	0	0	7
64482	599995	14	2	3	2	0	7
64482	600443	14	0	0	0	1	1
64482	198226	13	1	0	1	1	3
64482	600139	13	0	1	0	1	2
64482	600169	13	0	2	0	3	5
64482	600236	13	1	1	1	0	3
64482	600360	13	0	0	0	0	0
64482	600440	13	5	1	2	2	10
64482	600507	13	4	3	2	0	9
64482	221559	12	2	1	1	0	4
64482	599847	12	0	0	0	0	0
64482	599856	12	0	0	0	1	1
64482	599864	12	2	4	1	0	7
64482	599878	12	0	0	0	0	0
64482	600247	12	4	0	0	0	4
64482	600437	12	1	1	2	3	7
64482	599854	11	1	1	0	1	3
64482	599963	11	6	2	0	0	8
64482	599973	11	1	1	0	0	2
64482	599979	11	2	3	3	1	9
64482	600109	11	2	3	1	0	6
64482	600178	11	1	2	0	0	3
64482	600237	11	0	0	0	1	1
64482	600340	11	4	1	1	3	9
64482	600345	11	1	2	0	0	3
64482	600363	11	0	0	0	1	1
64482	600397	11	1	0	1	0	2
64482	600412	11	2	2	1	2	7
64482	600435	11	0	2	2	6	10
64482	599807	10	0	0	0	0	0
64482	599865	10	0	0	1	0	1
64482	599877	10	2	0	0	0	2
64482	599901	10	2	0	0	0	2
64482	599952	10	0	1	0	0	1
64482	600004	10	2	1	0	1	4
64482	600010	10	1	4	0	2	7
64482	600011	10	0	2	1	1	4
64482	600021	10	1	1	0	1	3
64482	600138	10	2	2	1	0	5
64482	600258	10	1	2	0	1	4
64482	600285	10	1	2	0	0	3
64482	600325	10	6	0	0	0	6
64482	600359	10	2	1	0	0	3
64482	600380	10	0	1	1	0	2
64482	600392	10	2	2	0	0	4
64482	600434	10	0	1	0	1	2
64482	600441	10	2	1	1	4	8
64482	600481	10	1	3	1	0	5
64482	600486	10	0	1	0	1	2
64482	600495	10	3	1	0	0	4
64482	600498	10	2	1	0	2	5
64482	600514	10	2	1	0	0	3
64482	100118	9	2	0	0	0	2
64482	300265	9	2	0	0	0	2
64482	600053	9	3	0	1	1	5
64482	600151	9	1	0	0	0	1
64482	600176	9	3	1	0	0	4
64482	600242	9	1	3	0	0	4
64482	600266	9	2	0	0	0	2
64482	600355	9	1	2	0	0	3
64482	600364	9	3	2	0	0	5
64482	600370	9	1	0	1	0	2
64482	600442	9	2	3	0	1	6
64482	600457	9	3	1	0	1	5
64482	600479	9	3	1	1	0	5
64482	600480	9	2	2	0	1	5
64482	600501	9	0	2	1	3	6
64482	186026	8	2	0	1	0	3
64482	186686	8	1	0	0	0	1
64482	192257	8	0	0	0	1	1
64482	192541	8	0	0	0	1	1
64482	193451	8	0	2	0	1	3
64482	195222	8	1	0	0	0	1
64482	201462	8	3	1	0	1	5
64482	202015	8	1	0	0	0	1
64482	211265	8	1	0	2	0	3
64482	212049	8	1	1	0	0	2
64482	599834	8	1	3	0	0	4
64482	599840	8	3	2	0	0	5
64482	599859	8	1	1	0	0	2
64482	599924	8	0	1	0	0	1
64482	600117	8	2	0	0	0	2
64482	600201	8	1	0	0	0	1
64482	600208	8	0	0	0	0	0
64482	600244	8	4	2	0	0	6
64482	600270	8	0	0	1	0	1
64482	600281	8	1	1	1	1	4
64482	600295	8	0	2	0	0	2
64482	600298	8	3	0	1	0	4
64482	600308	8	0	1	0	1	2
64482	600326	8	0	2	1	0	3
64482	600333	8	0	2	0	0	2
64482	600337	8	2	1	0	0	3
64482	600339	8	1	1	0	3	5
64482	600351	8	2	0	0	1	3
64482	600373	8	1	0	0	0	1
64482	600376	8	0	0	0	0	0
64482	600383	8	1	0	0	0	1
64482	600389	8	0	2	0	0	2
64482	600400	8	0	2	2	1	5
64482	600408	8	0	2	1	1	4
64482	600419	8	1	1	0	0	2
64482	600447	8	0	1	0	0	1
64482	600474	8	0	3	0	0	3
64482	600476	8	0	0	0	0	0
64482	600500	8	0	0	0	3	3
64482	600511	8	1	1	1	0	3
64482	87280	8	1	0	0	0	1
64482	183457	7	0	0	0	0	0
64482	203847	7	0	2	0	0	2
64482	300262	7	1	2	0	0	3
64482	300273	7	0	1	1	0	2
64482	599837	7	0	2	0	0	2
64482	599850	7	0	1	1	0	2
64482	599857	7	0	0	0	0	0
64482	599896	7	0	1	0	1	2
64482	599932	7	0	1	1	0	2
64482	599940	7	0	0	0	1	1
64482	599949	7	3	0	0	0	3
64482	599996	7	1	0	1	0	2
64482	600034	7	0	0	0	0	0
64482	600035	7	0	3	0	0	3
64482	600057	7	1	0	0	0	1
64482	600130	7	0	2	1	0	3
64482	600135	7	2	1	0	0	3
64482	600141	7	0	0	0	0	0
64482	600145	7	1	0	0	2	3
64482	600156	7	0	4	1	0	5
64482	600168	7	0	1	0	1	2
64482	600180	7	2	0	3	0	5
64482	600183	7	3	2	1	0	6
64482	600191	7	3	2	0	0	5
64482	600192	7	1	1	1	0	3
64482	600213	7	2	0	0	0	2
64482	600214	7	1	1	0	1	3
64482	600274	7	0	1	0	0	1
64482	600288	7	0	0	2	0	2
64482	600293	7	0	0	0	0	0
64482	600296	7	2	1	2	0	5
64482	600299	7	1	1	1	0	3
64482	600300	7	0	0	0	0	0
64482	600301	7	1	1	1	2	5
64482	600323	7	1	1	0	0	2
64482	600347	7	3	0	0	0	3
64482	600367	7	1	1	0	1	3
64482	600381	7	0	0	0	0	0
64482	600403	7	1	2	0	1	4
64482	600411	7	1	4	0	1	6
64482	600421	7	1	4	0	0	5
64482	600432	7	0	3	0	0	3
64482	600445	7	0	1	3	1	5
64482	600463	7	0	4	0	1	5
64482	600469	7	0	2	0	0	2
64482	600485	7	0	0	2	0	2
64482	600494	7	0	3	0	3	6
64482	600497	7	1	0	0	1	2
64482	74046	7	1	2	0	0	3
64482	84115	7	0	2	0	0	2
64482	187832	6	0	0	0	0	0
64482	187943	6	2	2	0	0	4
64482	188427	6	0	0	0	0	0
64482	212948	6	0	0	0	0	0
64482	300266	6	1	1	0	0	2
64482	599799	6	1	2	0	1	4
64482	599802	6	2	0	0	1	3
64482	599832	6	1	0	0	1	2
64482	599833	6	0	0	0	0	0
64482	599835	6	1	1	0	0	2
64482	599836	6	3	0	0	0	3
64482	599843	6	0	1	0	0	1
64482	599866	6	2	3	0	0	5
64482	599883	6	1	3	0	0	4
64482	599887	6	0	1	0	0	1
64482	599900	6	2	0	0	0	2
64482	599906	6	1	1	0	2	4
64482	599919	6	0	0	0	0	0
64482	599951	6	0	2	0	0	2
64482	599961	6	1	1	0	0	2
64482	599965	6	1	0	0	0	1
64482	599967	6	1	1	1	0	3
64482	599970	6	1	0	0	1	2
64482	599989	6	1	0	0	1	2
64482	599991	6	1	1	0	0	2
64482	600036	6	0	0	0	0	0
64482	600040	6	0	1	1	2	4
64482	600049	6	0	2	0	1	3
64482	600051	6	1	2	1	1	5
64482	600058	6	0	0	0	0	0
64482	600081	6	1	0	1	0	2
64482	600089	6	1	1	0	2	4
64482	600100	6	0	1	0	1	2
64482	600104	6	1	0	1	1	3
64482	600111	6	1	1	0	0	2
64482	600116	6	0	0	0	0	0
64482	600118	6	2	0	0	1	3
64482	600133	6	1	0	0	0	1
64482	600134	6	0	2	0	0	2
64482	600137	6	0	0	1	2	3
64482	600144	6	1	1	0	0	2
64482	600146	6	0	2	0	0	2
64482	600186	6	0	0	1	0	1
64482	600189	6	0	0	0	3	3
64482	600225	6	0	0	0	1	1
64482	600230	6	4	0	1	0	5
64482	600232	6	1	1	1	0	3
64482	600239	6	1	2	0	0	3
64482	600250	6	1	4	0	1	6
64482	600275	6	3	0	1	0	4
64482	600287	6	2	0	0	0	2
64482	600291	6	0	0	0	0	0
64482	600306	6	1	0	0	2	3
64482	600307	6	1	0	0	1	2
64482	600312	6	3	2	0	0	5
64482	600317	6	0	1	0	0	1
64482	600327	6	0	0	0	0	0
64482	600334	6	1	0	0	0	1
64482	600361	6	0	1	0	0	1
64482	600365	6	2	0	2	0	4
64482	600366	6	2	0	0	1	3
64482	600368	6	1	0	0	0	1
64482	600372	6	0	2	0	1	3
64482	600378	6	2	2	0	0	4
64482	600393	6	0	0	0	1	1
64482	600405	6	0	0	1	0	1
64482	600409	6	0	3	0	0	3
64482	600410	6	2	3	0	1	6
64482	600418	6	0	1	0	0	1
64482	600425	6	0	4	0	1	5
64482	600426	6	0	2	0	0	2
64482	600428	6	2	4	0	0	6
64482	600429	6	0	0	0	0	0
64482	600438	6	1	3	0	0	4
64482	600439	6	0	3	0	0	3
64482	600455	6	1	2	1	0	4
64482	600460	6	2	0	0	0	2
64482	600468	6	1	1	0	0	2
64482	600483	6	3	2	0	1	6
64482	600491	6	0	0	0	0	0
64482	600502	6	2	1	0	0	3
64482	600504	6	3	0	2	0	5
64482	600508	6	1	4	0	0	5
64482	71200	6	1	1	0	0	2
64482	186355	5	0	0	0	0	0
64482	204961	5	1	1	1	1	4
64482	205702	5	2	3	0	1	6
64482	212775	5	0	0	0	3	3
64482	221142	5	1	0	1	0	2
64482	300272	5	1	0	1	0	2
64482	599849	5	0	0	0	0	0
64482	599869	5	2	0	0	0	2
64482	599870	5	0	0	0	1	1
64482	599873	5	1	0	0	0	1
64482	599874	5	0	1	1	1	3
64482	599875	5	0	0	0	1	1
64482	599886	5	0	3	1	0	4
64482	599891	5	1	0	0	0	1
64482	599897	5	0	1	0	1	2
64482	599904	5	2	1	0	1	4
64482	599912	5	0	1	0	0	1
64482	599917	5	0	1	0	3	4
64482	599918	5	0	0	0	1	1
64482	599926	5	1	2	0	1	4
64482	599929	5	1	0	0	0	1
64482	599937	5	2	2	0	0	4
64482	599941	5	1	1	0	2	4
64482	599950	5	1	1	0	0	2
64482	599958	5	1	1	0	0	2
64482	599974	5	1	0	0	3	4
64482	599985	5	1	0	0	0	1
64482	599999	5	0	0	0	0	0
64482	600020	5	0	2	1	0	3
64482	600026	5	0	1	0	1	2
64482	600031	5	1	0	0	1	2
64482	600032	5	2	1	0	0	3
64482	600045	5	0	0	0	0	0
64482	600047	5	0	1	0	1	2
64482	600052	5	0	0	0	0	0
64482	600054	5	1	0	0	0	1
64482	600062	5	2	0	0	0	2
64482	600063	5	0	2	0	0	2
64482	600066	5	0	0	0	0	0
64482	600088	5	0	3	0	0	3
64482	600097	5	1	1	0	0	2
64482	600113	5	1	0	0	0	1
64482	600123	5	0	0	0	0	0
64482	600132	5	0	1	0	0	1
64482	600136	5	0	0	0	0	0
64482	600143	5	1	1	0	1	3
64482	600163	5	1	1	0	0	2
64482	600167	5	0	1	0	0	1
64482	600179	5	2	2	0	0	4
64482	600184	5	1	1	1	2	5
64482	600185	5	0	1	0	0	1
64482	600198	5	0	0	0	0	0
64482	600209	5	0	2	0	0	2
64482	600210	5	0	0	0	0	0
64482	600220	5	1	0	0	1	2
64482	600233	5	1	3	0	0	4
64482	600234	5	0	0	0	0	0
64482	600235	5	0	0	0	2	2
64482	600257	5	0	0	0	0	0
64482	600260	5	0	3	0	0	3
64482	600264	5	0	1	0	0	1
64482	600267	5	0	0	0	2	2
64482	600271	5	0	1	0	1	2
64482	600280	5	1	2	0	0	3
64482	600283	5	1	0	1	0	2
64482	600286	5	0	0	0	1	1
64482	600294	5	1	2	0	0	3
64482	600304	5	0	0	0	0	0
64482	600318	5	0	2	0	1	3
64482	600319	5	2	0	0	0	2
64482	600320	5	0	2	0	1	3
64482	600342	5	3	1	1	1	6
64482	600352	5	0	0	0	2	2
64482	600357	5	0	2	1	0	3
64482	600358	5	2	0	0	1	3
64482	600371	5	0	1	0	0	1
64482	600374	5	0	1	1	0	2
64482	600386	5	0	0	0	0	0
64482	600391	5	0	0	0	1	1
64482	600394	5	1	2	0	0	3
64482	600401	5	0	1	1	0	2
64482	600404	5	0	2	0	0	2
64482	600414	5	0	0	0	1	1
64482	600444	5	0	1	0	0	1
64482	600453	5	0	1	0	0	1
64482	600454	5	0	0	0	0	0
64482	600456	5	1	1	0	0	2
64482	600459	5	0	0	0	0	0
64482	600467	5	1	2	0	0	3
64482	600472	5	1	1	0	1	3
64482	600487	5	1	3	0	0	4
64482	600499	5	2	2	0	3	7
64482	600506	5	1	0	0	0	1
64482	600512	5	2	1	0	0	3
64482	78546	5	1	1	0	0	2
64482	181917	4	0	1	0	0	1
64482	184698	4	0	0	0	0	0
64482	195697	4	0	1	0	0	1
64482	196028	4	1	0	0	0	1
64482	199944	4	0	0	0	0	0
64482	201640	4	1	0	0	0	1
64482	203661	4	1	1	0	0	2
64482	204249	4	0	1	0	0	1
64482	205380	4	1	0	0	0	1
64482	206028	4	0	0	1	0	1
64482	208561	4	0	0	0	0	0
64482	209217	4	0	2	0	0	2
64482	217812	4	1	0	0	0	1
64482	218568	4	1	2	0	3	6
64482	300267	4	1	2	0	3	6
64482	300268	4	1	0	0	1	2
64482	300274	4	0	0	0	0	0
64482	53783	4	0	0	0	0	0
64482	599801	4	0	2	0	0	2
64482	599805	4	0	0	0	2	2
64482	599825	4	1	0	1	2	4
64482	599827	4	1	0	0	0	1
64482	599838	4	1	1	0	0	2
64482	599855	4	1	1	0	1	3
64482	599861	4	0	1	0	0	1
64482	599888	4	1	0	0	0	1
64482	599902	4	0	1	1	0	2
64482	599908	4	1	0	0	0	1
64482	599920	4	2	0	0	0	2
64482	599921	4	1	5	0	0	6
64482	599927	4	1	0	0	0	1
64482	599930	4	0	1	1	0	2
64482	599931	4	1	2	0	1	4
64482	599936	4	0	0	1	0	1
64482	599942	4	0	0	0	0	0
64482	599943	4	0	1	0	0	1
64482	599944	4	1	1	0	0	2
64482	599962	4	1	4	0	0	5
64482	599968	4	0	0	0	0	0
64482	599969	4	1	1	0	0	2
64482	599982	4	1	2	0	0	3
64482	599983	4	0	2	1	0	3
64482	599986	4	3	1	0	0	4
64482	600000	4	2	0	0	0	2
64482	600002	4	1	0	0	0	1
64482	600006	4	1	1	0	1	3
64482	600015	4	0	2	0	0	2
64482	600017	4	1	2	0	0	3
64482	600019	4	1	1	0	1	3
64482	600024	4	1	2	0	0	3
64482	600037	4	0	0	0	1	1
64482	600039	4	2	1	0	0	3
64482	600041	4	0	0	0	0	0
64482	600059	4	0	0	1	0	1
64482	600068	4	1	0	0	0	1
64482	600069	4	0	1	0	1	2
64482	600072	4	1	2	0	0	3
64482	600082	4	1	1	0	0	2
64482	600085	4	2	0	0	1	3
64482	600092	4	0	1	0	0	1
64482	600094	4	2	0	0	0	2
64482	600096	4	0	1	0	0	1
64482	600114	4	0	0	0	0	0
64482	600119	4	1	2	1	2	6
64482	600120	4	0	1	0	0	1
64482	600122	4	0	2	0	0	2
64482	600128	4	2	1	0	1	4
64482	600131	4	0	0	0	0	0
64482	600147	4	0	0	0	0	0
64482	600155	4	2	3	0	0	5
64482	600173	4	1	4	0	0	5
64482	600174	4	1	0	0	0	1
64482	600175	4	2	0	0	0	2
64482	600190	4	0	1	0	0	1
64482	600195	4	0	0	0	0	0
64482	600200	4	2	0	0	0	2
64482	600203	4	2	3	0	0	5
64482	600211	4	1	0	0	0	1
64482	600217	4	1	1	0	0	2
64482	600227	4	0	0	0	0	0
64482	600238	4	0	1	2	1	4
64482	600241	4	1	2	0	0	3
64482	600245	4	4	0	1	1	6
64482	600253	4	0	0	0	0	0
64482	600254	4	0	1	0	0	1
64482	600255	4	1	1	0	2	4
64482	600259	4	0	1	0	0	1
64482	600261	4	0	0	1	1	2
64482	600262	4	0	0	0	0	0
64482	600272	4	0	1	0	0	1
64482	600273	4	1	0	0	0	1
64482	600282	4	0	0	0	0	0
64482	600290	4	0	2	1	0	3
64482	600297	4	1	2	0	0	3
64482	600302	4	0	0	0	0	0
64482	600305	4	1	0	1	0	2
64482	600314	4	1	3	1	1	6
64482	600316	4	0	0	0	0	0
64482	600321	4	1	0	0	0	1
64482	600330	4	0	0	0	1	1
64482	600336	4	0	1	0	0	1
64482	600344	4	0	0	0	0	0
64482	600348	4	0	1	0	0	1
64482	600354	4	0	3	1	0	4
64482	600362	4	0	1	0	1	2
64482	600369	4	0	0	1	0	1
64482	600390	4	1	2	0	0	3
64482	600396	4	0	1	0	0	1
64482	600415	4	1	1	0	0	2
64482	600424	4	0	1	1	0	2
64482	600431	4	3	0	0	1	4
64482	600446	4	0	0	0	0	0
64482	600465	4	0	1	2	0	3
64482	600466	4	1	0	0	0	1
64482	600477	4	0	0	0	0	0
64482	600492	4	1	1	0	2	4
64482	600493	4	0	3	0	0	3
64482	600496	4	0	0	0	0	0
64482	600503	4	4	0	0	0	4
64482	600509	4	0	1	0	0	1
64482	600513	4	3	1	0	0	4
64482	74222	4	1	0	0	1	2
64482	94118	4	1	2	0	3	6
64482	188941	3	1	0	0	0	1
64482	188963	3	0	2	0	0	2
64482	189532	3	0	0	0	0	0
64482	190633	3	0	0	0	1	1
64482	196354	3	0	0	0	0	0
64482	196384	3	1	0	0	0	1
64482	211154	3	0	3	0	0	3
64482	211864	3	0	2	0	1	3
64482	212322	3	1	0	0	0	1
64482	599812	3	0	2	0	0	2
64482	599814	3	2	1	0	0	3
64482	599815	3	0	0	0	0	0
64482	599817	3	0	0	0	0	0
64482	599818	3	0	0	0	0	0
64482	599821	3	0	1	0	0	1
64482	599826	3	2	0	1	0	3
64482	599831	3	2	1	1	1	5
64482	599839	3	0	1	0	0	1
64482	599845	3	0	0	0	0	0
64482	599848	3	0	1	0	0	1
64482	599862	3	1	0	1	0	2
64482	599863	3	0	0	1	1	2
64482	599867	3	0	1	0	0	1
64482	599871	3	0	0	0	0	0
64482	599879	3	0	1	0	1	2
64482	599881	3	1	0	0	1	2
64482	599889	3	0	0	0	2	2
64482	599890	3	1	1	0	0	2
64482	599893	3	0	0	0	0	0
64482	599894	3	0	1	0	0	1
64482	599895	3	0	1	0	0	1
64482	599905	3	0	1	0	0	1
64482	599913	3	2	1	0	0	3
64482	599914	3	0	0	0	0	0
64482	599923	3	0	2	0	0	2
64482	599925	3	0	0	0	0	0
64482	599945	3	0	0	0	0	0
64482	599946	3	0	0	0	0	0
64482	599956	3	1	0	0	0	1
64482	599975	3	1	0	0	1	2
64482	599976	3	1	1	0	2	4
64482	599977	3	1	0	0	0	1
64482	600001	3	0	0	0	0	0
64482	600003	3	0	0	0	1	1
64482	600007	3	0	1	0	0	1
64482	600009	3	0	1	0	0	1
64482	600025	3	1	1	0	1	3
64482	600038	3	0	0	0	0	0
64482	600042	3	1	2	0	0	3
64482	600043	3	0	0	0	0	0
64482	600044	3	1	1	0	0	2
64482	600046	3	2	0	0	0	2
64482	600064	3	1	0	0	0	1
64482	600073	3	2	1	0	0	3
64482	600076	3	0	1	0	0	1
64482	600077	3	1	1	0	0	2
64482	600078	3	1	1	0	0	2
64482	600079	3	1	1	0	0	2
64482	600083	3	3	0	0	0	3
64482	600084	3	1	0	0	0	1
64482	600091	3	0	1	0	0	1
64482	600093	3	0	0	0	0	0
64482	600099	3	0	1	0	0	1
64482	600102	3	2	1	1	0	4
64482	600106	3	3	1	0	1	5
64482	600107	3	2	1	0	0	3
64482	600108	3	4	4	0	3	11
64482	600115	3	1	1	0	0	2
64482	600121	3	0	2	0	0	2
64482	600125	3	2	0	0	0	2
64482	600126	3	0	0	0	0	0
64482	600140	3	0	1	0	0	1
64482	600148	3	0	0	0	0	0
64482	600165	3	0	2	0	0	2
64482	600166	3	1	0	0	0	1
64482	600170	3	1	1	0	1	3
64482	600172	3	0	0	1	0	1
64482	600177	3	1	1	0	0	2
64482	600181	3	0	0	0	0	0
64482	600182	3	0	0	0	0	0
64482	600187	3	0	0	0	0	0
64482	600193	3	0	1	0	1	2
64482	600204	3	1	1	0	0	2
64482	600205	3	0	1	0	3	4
64482	600206	3	0	0	0	0	0
64482	600216	3	2	3	0	0	5
64482	600226	3	0	0	1	0	1
64482	600228	3	1	1	0	0	2
64482	600231	3	0	1	0	0	1
64482	600240	3	1	0	0	0	1
64482	600246	3	1	1	0	0	2
64482	600248	3	1	0	0	0	1
64482	600249	3	0	0	0	0	0
64482	600251	3	0	1	0	0	1
64482	600256	3	1	3	0	1	5
64482	600276	3	3	1	0	2	6
64482	600277	3	0	0	0	0	0
64482	600279	3	2	0	1	1	4
64482	600303	3	0	2	0	0	2
64482	600309	3	1	0	0	0	1
64482	600310	3	1	0	1	0	2
64482	600313	3	1	0	0	1	2
64482	600324	3	0	0	0	0	0
64482	600329	3	0	2	1	0	3
64482	600335	3	1	0	0	0	1
64482	600338	3	0	1	0	0	1
64482	600349	3	0	0	0	0	0
64482	600350	3	0	0	1	0	1
64482	600377	3	2	0	0	0	2
64482	600379	3	0	2	0	0	2
64482	600382	3	1	2	0	0	3
64482	600398	3	0	0	0	0	0
64482	600406	3	1	0	0	0	1
64482	600407	3	0	0	0	0	0
64482	600417	3	1	0	0	0	1
64482	600427	3	3	1	0	0	4
64482	600436	3	0	3	0	0	3
64482	600461	3	1	1	0	0	2
64482	600471	3	0	0	0	1	1
64482	600473	3	0	0	0	0	0
64482	600484	3	0	0	1	0	1
64482	600489	3	1	0	0	0	1
64482	600490	3	0	0	2	0	2
64482	84963	3	0	0	0	0	0
64482	182236	2	0	0	2	1	3
64482	187848	2	0	0	0	0	0
64482	194359	2	0	1	0	0	1
64482	203274	2	0	0	0	0	0
64482	205085	2	0	0	0	0	0
64482	206413	2	1	0	0	0	1
64482	210120	2	0	0	0	0	0
64482	212436	2	1	0	1	0	2
64482	300259	2	0	0	0	0	0
64482	300263	2	0	1	0	0	1
64482	300270	2	0	0	0	0	0
64482	56193	2	0	1	0	0	1
64482	599797	2	0	0	0	0	0
64482	599803	2	2	0	0	0	2
64482	599808	2	1	0	0	0	1
64482	599809	2	1	0	0	0	1
64482	599813	2	0	0	0	0	0
64482	599819	2	0	2	0	0	2
64482	599823	2	2	2	0	0	4
64482	599829	2	0	2	0	0	2
64482	599830	2	0	1	0	0	1
64482	599841	2	0	0	0	0	0
64482	599842	2	1	1	0	0	2
64482	599846	2	1	0	1	1	3
64482	599852	2	0	0	0	0	0
64482	599868	2	0	0	0	2	2
64482	599872	2	1	0	0	2	3
64482	599876	2	0	0	0	0	0
64482	599880	2	0	1	0	0	1
64482	599882	2	0	0	0	0	0
64482	599884	2	0	1	0	0	1
64482	599885	2	0	2	0	0	2
64482	599899	2	2	0	0	0	2
64482	599903	2	2	1	0	0	3
64482	599910	2	1	0	0	0	1
64482	599916	2	1	2	0	0	3
64482	599922	2	1	0	0	0	1
64482	599928	2	0	1	0	0	1
64482	599933	2	0	1	0	1	2
64482	599939	2	2	1	1	0	4
64482	599955	2	0	1	0	0	1
64482	599957	2	0	0	0	1	1
64482	599959	2	0	0	0	0	0
64482	599964	2	0	1	0	0	1
64482	599966	2	0	2	0	0	2
64482	599972	2	1	0	0	1	2
64482	599980	2	0	0	0	0	0
64482	599981	2	0	0	0	0	0
64482	599987	2	1	0	0	0	1
64482	599990	2	1	0	0	0	1
64482	599992	2	0	0	0	0	0
64482	599993	2	0	0	1	0	1
64482	599997	2	1	0	0	0	1
64482	600012	2	1	1	0	0	2
64482	600022	2	2	2	1	0	5
64482	600027	2	0	0	0	0	0
64482	600028	2	1	0	0	0	1
64482	600030	2	0	0	0	0	0
64482	600048	2	0	0	0	0	0
64482	600050	2	0	0	0	0	0
64482	600055	2	0	2	0	0	2
64482	600056	2	1	0	0	0	1
64482	600060	2	1	1	0	0	2
64482	600061	2	0	0	0	0	0
64482	600067	2	1	2	0	0	3
64482	600070	2	0	1	0	0	1
64482	600075	2	0	0	0	1	1
64482	600086	2	1	2	0	1	4
64482	600090	2	1	1	0	0	2
64482	600098	2	0	0	0	0	0
64482	600112	2	1	2	0	0	3
64482	600124	2	1	2	0	0	3
64482	600150	2	0	0	0	0	0
64482	600152	2	1	0	0	0	1
64482	600154	2	2	0	0	0	2
64482	600158	2	1	0	0	0	1
64482	600162	2	0	2	0	0	2
64482	600171	2	0	0	0	0	0
64482	600188	2	2	2	0	0	4
64482	600194	2	0	1	0	1	2
64482	600199	2	0	0	0	0	0
64482	600212	2	0	0	0	0	0
64482	600215	2	0	0	0	0	0
64482	600218	2	3	1	0	0	4
64482	600221	2	1	0	0	0	1
64482	600222	2	0	1	0	0	1
64482	600223	2	2	1	0	0	3
64482	600224	2	1	0	0	0	1
64482	600265	2	0	0	0	1	1
64482	600268	2	0	0	0	0	0
64482	600278	2	0	0	0	0	0
64482	600284	2	3	0	0	0	3
64482	600292	2	0	0	0	0	0
64482	600311	2	0	0	0	0	0
64482	600322	2	1	1	0	0	2
64482	600328	2	1	1	0	1	3
64482	600343	2	2	0	0	1	3
64482	600346	2	1	1	0	0	2
64482	600353	2	3	1	1	0	5
64482	600356	2	2	0	0	0	2
64482	600384	2	1	1	0	0	2
64482	600385	2	1	0	0	0	1
64482	600413	2	3	2	0	0	5
64482	600416	2	1	0	0	1	2
64482	600420	2	0	0	0	0	0
64482	600422	2	1	2	0	0	3
64482	600451	2	0	0	0	0	0
64482	600462	2	0	1	0	0	1
64482	600464	2	0	0	0	0	0
64482	600475	2	0	0	0	0	0
64482	600488	2	0	1	0	0	1
64482	600510	2	0	0	2	0	2
64482	186919	1	0	0	0	0	0
64482	187084	1	0	0	0	0	0
64482	191291	1	0	2	0	0	2
64482	196439	1	1	1	0	1	3
64482	215923	1	1	0	0	0	1
64482	300261	1	0	1	0	0	1
64482	300264	1	0	0	0	0	0
64482	599793	1	1	0	0	0	1
64482	599794	1	0	0	0	0	0
64482	599795	1	0	0	0	0	0
64482	599796	1	0	0	0	0	0
64482	599798	1	0	0	1	0	1
64482	599800	1	0	2	0	1	3
64482	599804	1	2	0	0	0	2
64482	599806	1	0	0	0	0	0
64482	599810	1	0	1	0	0	1
64482	599811	1	0	0	0	0	0
64482	599816	1	1	0	0	0	1
64482	599820	1	0	1	0	0	1
64482	599822	1	0	0	0	0	0
64482	599824	1	0	1	0	0	1
64482	599828	1	1	0	0	0	1
64482	599844	1	0	1	0	0	1
64482	599851	1	0	1	0	0	1
64482	599853	1	0	1	0	0	1
64482	599858	1	1	1	0	0	2
64482	599860	1	0	0	0	0	0
64482	599892	1	1	0	0	0	1
64482	599909	1	0	0	0	0	0
64482	599911	1	1	0	0	1	2
64482	599915	1	1	0	0	0	1
64482	599934	1	0	1	0	0	1
64482	599935	1	1	0	0	0	1
64482	599938	1	1	0	0	0	1
64482	599947	1	2	0	0	0	2
64482	599948	1	1	0	0	0	1
64482	599953	1	1	1	0	0	2
64482	599954	1	1	0	0	1	2
64482	599960	1	0	1	0	0	1
64482	599978	1	0	0	0	1	1
64482	599984	1	0	2	0	0	2
64482	599988	1	0	0	2	0	2
64482	600005	1	0	0	0	0	0
64482	600008	1	2	1	0	0	3
64482	600013	1	1	0	0	0	1
64482	600014	1	0	4	0	0	4
64482	600016	1	0	0	0	0	0
64482	600018	1	1	0	1	0	2
64482	600023	1	0	0	0	0	0
64482	600029	1	0	0	0	0	0
64482	600033	1	1	0	0	0	1
64482	600065	1	0	0	0	0	0
64482	600071	1	1	0	1	0	2
64482	600074	1	0	0	0	0	0
64482	600080	1	0	1	0	0	1
64482	600087	1	0	0	0	0	0
64482	600095	1	0	0	0	0	0
64482	600101	1	0	1	0	0	1
64482	600103	1	0	1	0	0	1
64482	600105	1	1	1	0	0	2
64482	600110	1	0	0	0	0	0
64482	600127	1	0	0	0	0	0
64482	600142	1	1	1	0	0	2
64482	600149	1	2	0	0	0	2
64482	600153	1	1	0	0	0	1
64482	600157	1	0	1	0	0	1
64482	600159	1	1	2	0	0	3
64482	600160	1	0	0	1	0	1
64482	600161	1	0	1	0	0	1
64482	600164	1	0	0	0	0	0
64482	600196	1	0	1	0	0	1
64482	600197	1	1	0	0	0	1
64482	600202	1	0	0	0	0	0
64482	600219	1	0	0	0	0	0
64482	600229	1	3	2	0	0	5
64482	600243	1	0	0	0	0	0
64482	600252	1	0	2	0	0	2
64482	600263	1	0	0	0	0	0
64482	600375	1	0	0	0	0	0
64482	600387	1	1	0	0	0	1
64482	600388	1	0	1	0	0	1
64482	600395	1	0	1	0	0	1
64482	600399	1	0	3	0	0	3
64482	600402	1	0	2	0	0	2
64482	600423	1	0	0	0	0	0
64482	600430	1	0	0	0	0	0
64482	600433	1	0	1	0	0	1
64482	600448	1	0	0	0	0	0
64482	600449	1	0	1	0	0	1
64482	600452	1	1	1	0	1	3
64482	600482	1	1	0	0	0	1
64482	600505	1	0	0	0	0	0
18467	574577	58	3	1	0	5	9
18467	212839	51	3	1	1	2	7
18467	574581	46	6	4	1	1	12
18467	574557	45	5	3	0	5	13
18467	574580	44	4	2	1	1	8
18467	574556	43	4	15	1	2	22
18467	574559	40	1	1	1	2	5
18467	574571	40	6	11	2	11	30
18467	574576	39	6	5	7	0	18
18467	574579	37	3	1	3	1	8
18467	574560	36	3	1	3	4	11
18467	574547	35	4	1	0	0	5
18467	574554	34	5	3	3	5	16
18467	574555	33	2	6	0	3	11
18467	574575	33	6	7	3	2	18
18467	574572	31	3	7	2	0	12
18467	574548	30	1	7	3	5	16
18467	574546	29	3	2	1	1	7
18467	575048	26	2	3	1	4	10
18467	574568	25	1	3	1	4	9
18467	574561	23	2	2	0	2	6
18467	574562	23	2	2	0	2	6
18467	574558	22	2	1	1	1	5
18467	574567	21	1	2	0	2	5
18467	574566	20	5	6	0	6	17
18467	574738	20	0	1	0	2	3
18467	574607	16	2	5	0	2	9
18467	574785	16	2	0	0	0	2
18467	574944	16	3	1	0	1	5
18467	574551	14	2	2	2	2	8
18467	574605	14	1	5	0	6	12
18467	575040	13	2	0	1	0	3
18467	574773	12	0	0	0	0	0
18467	210105	11	3	2	0	0	5
18467	574672	11	0	2	0	0	2
18467	574836	11	1	4	0	1	6
18467	193324	10	3	1	0	5	9
18467	574584	10	2	2	0	2	6
18467	574586	10	1	1	0	0	2
18467	574589	10	0	4	0	3	7
18467	574791	10	0	1	1	1	3
18467	191352	9	1	2	0	1	4
18467	214485	9	1	1	1	3	6
18467	214486	9	1	1	1	3	6
18467	277061	9	0	0	0	1	1
18467	574928	9	5	4	0	0	9
18467	574952	9	4	0	0	2	6
18467	575044	9	1	1	0	0	2
18467	575068	9	0	2	0	2	4
18467	186061	8	0	1	1	3	5
18467	202056	8	1	2	0	3	6
18467	218067	8	1	1	3	2	7
18467	574613	8	1	2	0	2	5
18467	574662	8	3	2	2	0	7
18467	574778	8	1	3	0	0	4
18467	574808	8	2	4	0	1	7
18467	574816	8	1	1	0	1	3
18467	574844	8	1	0	0	2	3
18467	574848	8	2	2	1	5	10
18467	574853	8	1	0	0	1	2
18467	574890	8	0	4	0	0	4
18467	574898	8	0	1	0	2	3
18467	574932	8	1	2	0	3	6
18467	574998	8	1	1	1	0	3
18467	575050	8	1	0	0	2	3
18467	189658	7	0	2	1	0	3
18467	201655	7	2	1	1	3	7
18467	203027	7	2	1	0	3	6
18467	205256	7	0	1	0	1	2
18467	205294	7	3	2	1	1	7
18467	277056	7	0	1	0	0	1
18467	468072	7	1	0	1	0	2
18467	574552	7	0	2	0	1	3
18467	574553	7	0	2	0	1	3
18467	574565	7	0	3	0	2	5
18467	574591	7	1	1	0	0	2
18467	574595	7	0	0	0	3	3
18467	574598	7	1	1	0	2	4
18467	574608	7	1	1	1	0	3
18467	574618	7	1	2	1	2	6
18467	574627	7	0	0	0	1	1
18467	574734	7	1	5	1	0	7
18467	574757	7	1	2	0	2	5
18467	574762	7	1	1	0	0	2
18467	574777	7	2	4	0	1	7
18467	574786	7	1	1	0	2	4
18467	574831	7	0	4	0	1	5
18467	574868	7	2	1	0	3	6
18467	574934	7	1	2	0	2	5
18467	575009	7	1	1	0	2	4
18467	575011	7	2	4	0	1	7
18467	575070	7	3	0	1	0	4
18467	575079	7	2	1	0	1	4
18467	575106	7	2	5	1	2	10
18467	575146	7	3	0	0	1	4
18467	206674	6	0	0	0	1	1
18467	212291	6	2	3	0	2	7
18467	216242	6	1	1	0	5	7
18467	219849	6	2	2	1	1	6
18467	277067	6	0	0	0	1	1
18467	574582	6	3	1	0	5	9
18467	574593	6	1	0	0	0	1
18467	574604	6	1	2	0	1	4
18467	574610	6	1	0	0	1	2
18467	574656	6	2	4	0	0	6
18467	574659	6	1	0	0	0	1
18467	574702	6	0	0	0	2	2
18467	574706	6	3	0	0	2	5
18467	574707	6	0	1	0	0	1
18467	574713	6	1	0	1	1	3
18467	574716	6	5	1	0	1	7
18467	574740	6	1	3	0	2	6
18467	574753	6	0	1	0	3	4
18467	574776	6	2	1	1	0	4
18467	574797	6	1	2	0	1	4
18467	574832	6	1	0	0	0	1
18467	574834	6	0	2	2	0	4
18467	574859	6	3	4	0	2	9
18467	574882	6	1	2	1	1	5
18467	574904	6	2	0	0	0	2
18467	574911	6	3	1	0	1	5
18467	574921	6	0	1	0	1	2
18467	574945	6	1	0	0	2	3
18467	574962	6	0	0	0	0	0
18467	574978	6	1	2	0	0	3
18467	574984	6	1	0	0	1	2
18467	574999	6	2	3	0	5	10
18467	575003	6	4	0	0	1	5
18467	575012	6	1	2	0	1	4
18467	575029	6	0	0	0	0	0
18467	575033	6	0	4	1	1	6
18467	575052	6	0	2	0	1	3
18467	575065	6	2	0	0	1	3
18467	575069	6	1	1	0	0	2
18467	575082	6	1	2	0	3	6
18467	575083	6	1	4	0	0	5
18467	575105	6	3	3	0	2	8
18467	575117	6	0	4	0	4	8
18467	575123	6	2	1	0	1	4
18467	575138	6	1	1	0	1	3
18467	575143	6	0	0	0	0	0
18467	183503	5	1	0	1	0	2
18467	184666	5	0	2	1	2	5
18467	185514	5	0	0	0	1	1
18467	193887	5	0	0	0	1	1
18467	203703	5	0	0	0	2	2
18467	209482	5	0	2	0	1	3
18467	210074	5	1	1	0	2	4
18467	212473	5	1	2	0	1	4
18467	214031	5	0	0	0	0	0
18467	219038	5	0	0	0	1	1
18467	220597	5	1	0	0	0	1
18467	277057	5	0	1	0	0	1
18467	277060	5	0	0	0	1	1
18467	277064	5	0	0	0	0	0
18467	468071	5	1	0	0	2	3
18467	468073	5	0	1	0	2	3
18467	574563	5	0	1	0	3	4
18467	574578	5	1	1	0	1	3
18467	574583	5	0	1	0	2	3
18467	574587	5	0	0	0	0	0
18467	574603	5	1	0	0	3	4
18467	574612	5	0	0	0	1	1
18467	574652	5	1	3	0	2	6
18467	574674	5	1	3	0	2	6
18467	574679	5	4	2	0	1	7
18467	574686	5	0	1	0	0	1
18467	574699	5	2	3	1	1	7
18467	574703	5	1	1	0	0	2
18467	574723	5	0	2	0	3	5
18467	574724	5	1	0	0	0	1
18467	574726	5	1	2	0	1	4
18467	574727	5	0	0	0	1	1
18467	574742	5	0	1	0	1	2
18467	574743	5	2	1	0	0	3
18467	574746	5	0	0	0	0	0
18467	574750	5	2	3	0	1	6
18467	574759	5	1	0	0	0	1
18467	574781	5	0	2	0	0	2
18467	574790	5	2	3	0	1	6
18467	574798	5	2	1	0	0	3
18467	574806	5	3	0	0	0	3
18467	574810	5	0	2	0	0	2
18467	574813	5	0	0	0	0	0
18467	574824	5	0	1	1	2	4
18467	574828	5	2	2	0	0	4
18467	574838	5	1	3	0	1	5
18467	574842	5	0	1	0	1	2
18467	574843	5	1	1	0	2	4
18467	574850	5	1	2	0	0	3
18467	574857	5	0	0	1	3	4
18467	574858	5	2	1	0	1	4
18467	574866	5	0	0	0	0	0
18467	574871	5	2	3	0	1	6
18467	574879	5	1	0	0	1	2
18467	574887	5	2	1	1	0	4
18467	574897	5	0	4	0	0	4
18467	574917	5	1	0	1	1	3
18467	574941	5	1	0	0	3	4
18467	574946	5	0	0	0	1	1
18467	574950	5	1	2	0	1	4
18467	574951	5	0	1	0	1	2
18467	574957	5	2	0	0	1	3
18467	574958	5	1	2	0	1	4
18467	574964	5	1	0	0	0	1
18467	574966	5	2	1	0	2	5
18467	574974	5	0	1	0	1	2
18467	574981	5	1	0	0	1	2
18467	574986	5	0	1	0	2	3
18467	574989	5	1	1	0	1	3
18467	575006	5	1	1	0	0	2
18467	575010	5	0	0	0	4	4
18467	575021	5	1	0	0	1	2
18467	575023	5	0	1	0	2	3
18467	575024	5	2	1	0	4	7
18467	575028	5	2	1	0	0	3
18467	575054	5	2	2	0	2	6
18467	575056	5	0	0	0	1	1
18467	575060	5	0	0	1	1	2
18467	575063	5	0	0	0	0	0
18467	575066	5	0	0	1	1	2
18467	575080	5	0	0	0	3	3
18467	575084	5	0	0	0	0	0
18467	575085	5	1	2	1	1	5
18467	575087	5	0	1	0	1	2
18467	575090	5	1	0	1	0	2
18467	575095	5	1	2	0	3	6
18467	575114	5	0	1	0	1	2
18467	575116	5	0	0	0	0	0
18467	575122	5	0	0	0	1	1
18467	575129	5	0	0	0	0	0
18467	575133	5	0	1	0	2	3
18467	575139	5	1	0	0	0	1
18467	183961	4	0	0	0	1	1
18467	186662	4	0	0	0	0	0
18467	190320	4	1	1	0	2	4
18467	192227	4	0	1	0	1	2
18467	192416	4	1	0	0	2	3
18467	192911	4	1	1	0	0	2
18467	193579	4	0	1	0	1	2
18467	198430	4	2	2	0	0	4
18467	199180	4	1	0	0	1	2
18467	203814	4	2	1	1	0	4
18467	204975	4	1	0	0	2	3
18467	206980	4	2	0	0	0	2
18467	207251	4	1	0	0	0	1
18467	209516	4	0	0	0	0	0
18467	210477	4	0	1	1	0	2
18467	214215	4	1	1	0	2	4
18467	220582	4	0	0	0	1	1
18467	220869	4	0	0	0	0	0
18467	277065	4	0	0	0	0	0
18467	277066	4	0	0	0	1	1
18467	468074	4	0	0	0	3	3
18467	468078	4	3	0	0	1	4
18467	574550	4	1	1	0	3	5
18467	574570	4	0	1	0	1	2
18467	574574	4	2	3	0	2	7
18467	574588	4	0	2	0	0	2
18467	574602	4	2	0	0	0	2
18467	574611	4	1	3	0	1	5
18467	574615	4	0	0	0	2	2
18467	574625	4	1	0	0	0	1
18467	574633	4	0	2	1	0	3
18467	574645	4	0	2	1	0	3
18467	574646	4	0	1	0	1	2
18467	574665	4	0	2	0	0	2
18467	574666	4	0	0	0	3	3
18467	574670	4	1	0	0	2	3
18467	574675	4	0	0	1	1	2
18467	574677	4	0	4	0	0	4
18467	574685	4	0	1	0	0	1
18467	574687	4	2	2	1	1	6
18467	574689	4	0	1	0	1	2
18467	574694	4	0	0	0	0	0
18467	574695	4	0	0	0	1	1
18467	574704	4	1	0	0	2	3
18467	574725	4	0	0	0	0	0
18467	574732	4	0	1	0	1	2
18467	574741	4	1	0	0	0	1
18467	574747	4	0	1	0	1	2
18467	574755	4	0	2	1	1	4
18467	574756	4	1	0	0	1	2
18467	574760	4	1	2	0	0	3
18467	574763	4	0	0	0	1	1
18467	574764	4	1	1	0	1	3
18467	574766	4	1	1	1	1	4
18467	574767	4	0	2	0	0	2
18467	574770	4	2	0	0	1	3
18467	574775	4	0	0	0	1	1
18467	574780	4	2	0	0	2	4
18467	574784	4	1	0	0	0	1
18467	574787	4	1	0	0	0	1
18467	574789	4	1	1	1	1	4
18467	574792	4	1	1	0	2	4
18467	574795	4	0	2	0	1	3
18467	574796	4	1	0	0	0	1
18467	574801	4	0	0	0	3	3
18467	574815	4	0	4	0	4	8
18467	574817	4	0	1	0	2	3
18467	574818	4	0	0	0	2	2
18467	574819	4	1	2	0	0	3
18467	574822	4	1	2	0	0	3
18467	574835	4	1	0	0	1	2
18467	574840	4	2	0	1	2	5
18467	574860	4	0	1	0	0	1
18467	574863	4	1	0	0	1	2
18467	574864	4	2	0	0	0	2
18467	574867	4	1	2	0	0	3
18467	574873	4	1	1	0	1	3
18467	574881	4	0	0	0	1	1
18467	574886	4	0	0	0	2	2
18467	574891	4	2	0	0	0	2
18467	574903	4	1	2	1	1	5
18467	574905	4	1	0	0	1	2
18467	574907	4	0	2	0	1	3
18467	574909	4	0	1	0	0	1
18467	574919	4	0	1	1	1	3
18467	574933	4	1	1	0	1	3
18467	574935	4	0	1	0	1	2
18467	574936	4	0	1	0	1	2
18467	574938	4	2	0	0	1	3
18467	574947	4	0	0	0	0	0
18467	574954	4	1	0	0	0	1
18467	574956	4	0	4	1	3	8
18467	574959	4	0	1	0	0	1
18467	574967	4	2	2	0	0	4
18467	574968	4	0	1	0	2	3
18467	574973	4	1	3	0	0	4
18467	574979	4	1	2	0	2	5
18467	574991	4	1	0	1	2	4
18467	574992	4	0	1	1	0	2
18467	574993	4	1	1	0	0	2
18467	574997	4	1	1	0	0	2
18467	575001	4	0	1	0	2	3
18467	575015	4	0	1	0	2	3
18467	575022	4	1	1	0	6	8
18467	575026	4	0	0	0	1	1
18467	575031	4	0	0	0	0	0
18467	575034	4	2	0	0	0	2
18467	575039	4	1	1	0	0	2
18467	575045	4	1	1	0	1	3
18467	575049	4	1	0	0	0	1
18467	575061	4	1	1	0	1	3
18467	575062	4	3	0	0	0	3
18467	575078	4	1	1	0	0	2
18467	575081	4	2	0	0	1	3
18467	575093	4	1	1	0	1	3
18467	575094	4	2	1	1	4	8
18467	575097	4	1	0	0	2	3
18467	575100	4	0	0	0	1	1
18467	575107	4	0	2	0	0	2
18467	575108	4	1	0	0	0	1
18467	575109	4	0	0	0	0	0
18467	575111	4	0	1	0	1	2
18467	575119	4	2	1	2	0	5
18467	575121	4	1	0	0	1	2
18467	575126	4	1	2	0	0	3
18467	575127	4	1	1	1	2	5
18467	575128	4	0	1	0	1	2
18467	575132	4	0	0	0	0	0
18467	575137	4	0	1	0	0	1
18467	575140	4	0	0	0	0	0
18467	575145	4	1	2	0	2	5
18467	575150	4	2	1	0	0	3
18467	575151	4	2	1	0	0	3
18467	183485	3	1	1	0	2	4
18467	184549	3	0	0	0	1	1
18467	185211	3	0	0	0	1	1
18467	185627	3	0	2	0	0	2
18467	186276	3	1	0	0	0	1
18467	186956	3	0	0	1	1	2
18467	187104	3	1	1	0	1	3
18467	188253	3	1	0	0	2	3
18467	191594	3	0	2	0	0	2
18467	195617	3	0	1	0	0	1
18467	196421	3	1	0	0	0	1
18467	197294	3	0	1	0	0	1
18467	200421	3	1	1	0	0	2
18467	200644	3	1	0	0	0	1
18467	204516	3	0	1	0	2	3
18467	205001	3	1	0	0	0	1
18467	206469	3	0	0	0	0	0
18467	207692	3	2	0	0	1	3
18467	207960	3	1	2	0	2	5
18467	210314	3	0	0	0	3	3
18467	210770	3	1	1	0	1	3
18467	211409	3	1	2	0	0	3
18467	211986	3	0	5	0	1	6
18467	213386	3	0	0	0	1	1
18467	213961	3	0	0	0	2	2
18467	214475	3	1	0	0	3	4
18467	214971	3	0	0	0	3	3
18467	215400	3	0	0	0	1	1
18467	215769	3	0	0	0	0	0
18467	216364	3	0	2	0	0	2
18467	217227	3	0	1	0	0	1
18467	217678	3	1	0	0	1	2
18467	217693	3	0	1	0	2	3
18467	217807	3	0	0	0	0	0
18467	218604	3	2	2	0	0	4
18467	220596	3	0	0	0	1	1
18467	277058	3	0	0	0	4	4
18467	277062	3	0	1	0	2	3
18467	277063	3	0	0	0	0	0
18467	468077	3	0	1	0	0	1
18467	574549	3	1	1	0	1	3
18467	574569	3	1	3	0	0	4
18467	574590	3	1	2	0	1	4
18467	574594	3	1	0	0	0	1
18467	574596	3	0	1	0	0	1
18467	574597	3	1	1	0	0	2
18467	574600	3	0	0	0	0	0
18467	574601	3	1	0	0	1	2
18467	574621	3	0	0	0	1	1
18467	574622	3	0	1	2	3	6
18467	574623	3	1	0	0	2	3
18467	574626	3	0	0	0	1	1
18467	574628	3	0	1	0	0	1
18467	574631	3	0	1	1	0	2
18467	574632	3	1	1	0	0	2
18467	574636	3	0	0	0	1	1
18467	574637	3	3	0	0	4	7
18467	574638	3	2	3	1	1	7
18467	574639	3	1	0	0	1	2
18467	574647	3	0	2	0	0	2
18467	574650	3	1	1	0	2	4
18467	574655	3	1	1	0	1	3
18467	574657	3	0	0	0	1	1
18467	574664	3	0	0	0	2	2
18467	574667	3	1	2	0	0	3
18467	574671	3	1	3	0	0	4
18467	574673	3	1	0	0	2	3
18467	574678	3	1	1	0	0	2
18467	574680	3	1	0	0	0	1
18467	574681	3	0	1	0	0	1
18467	574682	3	0	0	0	0	0
18467	574683	3	0	0	0	0	0
18467	574688	3	2	4	0	0	6
18467	574690	3	1	0	0	1	2
18467	574691	3	0	2	0	1	3
18467	574697	3	0	1	0	1	2
18467	574712	3	1	3	0	3	7
18467	574715	3	2	0	0	0	2
18467	574719	3	1	1	0	1	3
18467	574721	3	2	0	0	0	2
18467	574728	3	1	0	2	0	3
18467	574729	3	0	1	0	0	1
18467	574731	3	1	1	0	4	6
18467	574739	3	1	0	0	0	1
18467	574745	3	2	0	0	0	2
18467	574748	3	0	0	0	0	0
18467	574751	3	0	0	0	2	2
18467	574752	3	1	2	0	1	4
18467	574754	3	0	0	0	3	3
18467	574772	3	0	0	0	0	0
18467	574782	3	1	0	0	0	1
18467	574783	3	0	1	0	0	1
18467	574788	3	1	3	0	1	5
18467	574794	3	0	4	0	1	5
18467	574804	3	0	2	1	1	4
18467	574805	3	0	1	0	0	1
18467	574811	3	0	0	1	1	2
18467	574814	3	1	1	0	1	3
18467	574837	3	1	0	0	1	2
18467	574839	3	0	1	0	0	1
18467	574846	3	0	0	0	0	0
18467	574849	3	0	2	1	1	4
18467	574852	3	1	2	0	1	4
18467	574855	3	0	0	0	3	3
18467	574856	3	0	1	0	0	1
18467	574865	3	0	1	0	2	3
18467	574875	3	2	0	0	0	2
18467	574878	3	0	0	0	0	0
18467	574880	3	0	0	1	0	1
18467	574883	3	0	2	2	0	4
18467	574888	3	1	0	1	1	3
18467	574892	3	1	1	0	0	2
18467	574893	3	0	1	0	1	2
18467	574896	3	0	1	0	1	2
18467	574899	3	0	0	0	1	1
18467	574902	3	0	2	0	1	3
18467	574908	3	1	0	0	0	1
18467	574912	3	0	0	1	2	3
18467	574916	3	1	0	1	1	3
18467	574918	3	0	0	0	2	2
18467	574925	3	1	0	2	0	3
18467	574926	3	2	0	0	0	2
18467	574931	3	0	0	0	0	0
18467	574939	3	2	0	1	2	5
18467	574940	3	1	1	0	2	4
18467	574943	3	0	0	0	2	2
18467	574953	3	2	1	0	0	3
18467	574960	3	0	1	0	2	3
18467	574969	3	1	1	0	1	3
18467	574970	3	1	1	1	1	4
18467	574975	3	0	0	0	0	0
18467	574976	3	0	0	0	2	2
18467	574977	3	0	2	0	0	2
18467	574980	3	0	0	1	2	3
18467	574982	3	2	0	0	1	3
18467	574987	3	1	0	0	0	1
18467	574990	3	1	1	0	0	2
18467	574995	3	2	0	0	0	2
18467	574996	3	1	1	0	0	2
18467	575004	3	0	1	1	0	2
18467	575005	3	0	0	1	1	2
18467	575007	3	0	1	0	0	1
18467	575016	3	0	1	0	0	1
18467	575018	3	0	2	0	1	3
18467	575019	3	0	0	0	1	1
18467	575025	3	0	2	0	0	2
18467	575032	3	0	1	0	3	4
18467	575035	3	0	3	0	1	4
18467	575037	3	0	1	0	0	1
18467	575038	3	0	1	0	1	2
18467	575046	3	0	1	0	1	2
18467	575047	3	1	0	0	0	1
18467	575051	3	0	0	0	0	0
18467	575057	3	1	4	0	0	5
18467	575059	3	0	1	0	0	1
18467	575067	3	0	2	0	0	2
18467	575071	3	0	0	0	1	1
18467	575074	3	2	0	2	0	4
18467	575075	3	1	0	0	0	1
18467	575077	3	1	1	0	1	3
18467	575086	3	1	0	1	1	3
18467	575091	3	1	3	0	0	4
18467	575098	3	0	0	0	0	0
18467	575103	3	0	0	0	1	1
18467	575104	3	1	0	0	2	3
18467	575110	3	0	1	0	0	1
18467	575118	3	0	1	0	1	2
18467	575120	3	2	0	0	1	3
18467	575130	3	1	1	0	3	5
18467	575131	3	0	2	0	1	3
18467	575134	3	0	1	0	0	1
18467	575144	3	1	1	0	1	3
18467	575147	3	1	2	0	0	3
18467	575149	3	0	0	0	0	0
18467	186808	2	2	1	0	0	3
18467	187956	2	0	0	0	0	0
18467	188478	2	0	1	0	1	2
18467	190016	2	0	1	0	1	2
18467	190051	2	1	1	0	1	3
18467	192459	2	1	1	0	0	2
18467	193203	2	1	0	0	1	2
18467	195607	2	0	0	0	0	0
18467	198262	2	0	0	0	1	1
18467	198502	2	0	0	0	2	2
18467	201238	2	1	0	0	2	3
18467	201254	2	1	2	0	1	4
18467	201672	2	0	0	0	0	0
18467	203151	2	0	1	0	1	2
18467	203202	2	0	1	0	0	1
18467	203321	2	0	1	0	0	1
18467	204887	2	0	1	0	2	3
18467	206231	2	0	1	0	1	2
18467	206330	2	0	1	0	1	2
18467	206630	2	1	2	0	0	3
18467	207476	2	0	0	0	0	0
18467	209617	2	0	0	0	1	1
18467	210603	2	0	1	0	1	2
18467	211098	2	0	0	0	1	1
18467	211218	2	1	0	0	1	2
18467	212497	2	0	0	0	1	1
18467	212677	2	0	0	0	1	1
18467	212770	2	0	1	0	3	4
18467	212936	2	0	0	1	0	1
18467	213351	2	1	1	0	0	2
18467	213385	2	2	0	0	0	2
18467	214398	2	0	0	0	3	3
18467	215267	2	0	1	0	0	1
18467	215358	2	0	1	0	0	1
18467	216745	2	0	0	0	2	2
18467	217070	2	0	1	0	1	2
18467	217414	2	0	0	0	0	0
18467	218894	2	0	1	0	0	1
18467	220003	2	0	2	0	1	3
18467	221922	2	1	2	0	1	4
18467	277059	2	0	1	0	0	1
18467	277068	2	0	0	0	1	1
18467	468076	2	1	0	0	1	2
18467	574585	2	1	0	0	2	3
18467	574592	2	1	1	0	1	3
18467	574599	2	0	1	0	1	2
18467	574606	2	0	2	0	3	5
18467	574614	2	0	1	0	0	1
18467	574619	2	0	0	1	0	1
18467	574620	2	0	1	0	0	1
18467	574624	2	0	1	0	1	2
18467	574630	2	0	0	0	1	1
18467	574634	2	0	1	0	1	2
18467	574635	2	0	0	0	0	0
18467	574640	2	0	1	0	0	1
18467	574641	2	0	1	0	1	2
18467	574643	2	0	0	0	1	1
18467	574658	2	0	2	0	1	3
18467	574660	2	0	2	0	1	3
18467	574669	2	2	0	0	1	3
18467	574693	2	0	1	0	0	1
18467	574696	2	0	0	0	1	1
18467	574698	2	0	4	0	1	5
18467	574705	2	1	0	0	1	2
18467	574708	2	0	1	0	0	1
18467	574709	2	1	1	0	0	2
18467	574710	2	0	0	0	0	0
18467	574711	2	0	0	0	1	1
18467	574714	2	1	1	0	0	2
18467	574717	2	0	0	0	1	1
18467	574718	2	0	0	0	0	0
18467	574720	2	0	1	0	1	2
18467	574722	2	2	1	0	1	4
18467	574733	2	1	1	0	1	3
18467	574735	2	0	1	1	0	2
18467	574737	2	0	0	0	0	0
18467	574744	2	1	0	0	0	1
18467	574749	2	1	2	0	3	6
18467	574758	2	1	0	0	0	1
18467	574761	2	0	0	0	1	1
18467	574765	2	3	1	0	0	4
18467	574768	2	0	0	0	2	2
18467	574769	2	0	0	0	1	1
18467	574771	2	2	0	0	1	3
18467	574779	2	1	0	0	0	1
18467	574800	2	0	1	0	0	1
18467	574802	2	1	0	0	0	1
18467	574809	2	2	1	0	0	3
18467	574812	2	0	2	0	1	3
18467	574821	2	1	1	0	1	3
18467	574823	2	0	1	0	3	4
18467	574826	2	0	1	0	1	2
18467	574827	2	1	0	0	0	1
18467	574829	2	0	0	0	1	1
18467	574830	2	0	0	1	0	1
18467	574833	2	2	0	0	0	2
18467	574841	2	0	0	0	1	1
18467	574847	2	0	0	0	0	0
18467	574851	2	0	0	0	1	1
18467	574854	2	0	1	1	0	2
18467	574861	2	0	0	0	1	1
18467	574862	2	0	3	0	1	4
18467	574869	2	1	0	0	0	1
18467	574870	2	0	1	0	1	2
18467	574872	2	0	0	0	0	0
18467	574884	2	1	0	0	0	1
18467	574885	2	0	0	0	2	2
18467	574889	2	1	0	0	0	1
18467	574894	2	0	2	1	1	4
18467	574895	2	2	1	0	0	3
18467	574906	2	0	0	2	0	2
18467	574913	2	1	2	0	2	5
18467	574915	2	0	1	0	2	3
18467	574922	2	1	0	0	0	1
18467	574923	2	0	1	0	1	2
18467	574929	2	0	1	0	2	3
18467	574930	2	0	1	0	1	2
18467	574937	2	0	1	0	0	1
18467	574942	2	1	1	0	0	2
18467	574948	2	0	1	1	1	3
18467	574963	2	0	2	0	0	2
18467	574965	2	2	0	0	1	3
18467	574972	2	0	1	0	0	1
18467	574983	2	0	1	0	2	3
18467	574985	2	0	0	0	0	0
18467	574988	2	0	0	0	1	1
18467	575002	2	1	2	0	0	3
18467	575008	2	2	1	0	0	3
18467	575013	2	0	1	0	0	1
18467	575017	2	0	1	0	0	1
18467	575020	2	1	1	0	0	2
18467	575027	2	0	1	0	3	4
18467	575030	2	0	0	0	0	0
18467	575042	2	0	0	0	1	1
18467	575043	2	0	0	0	2	2
18467	575053	2	0	0	0	0	0
18467	575055	2	0	2	0	0	2
18467	575058	2	1	0	0	0	1
18467	575064	2	0	0	0	0	0
18467	575072	2	0	1	0	0	1
18467	575073	2	1	0	0	0	1
18467	575076	2	1	1	0	1	3
18467	575088	2	0	0	0	0	0
18467	575089	2	0	0	0	2	2
18467	575096	2	1	2	1	0	4
18467	575101	2	0	2	0	3	5
18467	575102	2	1	1	0	0	2
18467	575112	2	0	1	0	0	1
18467	575115	2	0	1	0	0	1
18467	575124	2	1	1	0	1	3
18467	575135	2	0	1	0	1	2
18467	575136	2	1	2	0	0	3
18467	575141	2	3	0	0	0	3
18467	575142	2	0	1	0	1	2
18467	575148	2	0	0	0	0	0
18467	182347	1	0	0	0	0	0
18467	183743	1	0	1	0	1	2
18467	183870	1	1	1	2	0	4
18467	186946	1	1	0	0	2	3
18467	186982	1	0	0	0	1	1
18467	187151	1	0	0	0	0	0
18467	189579	1	0	0	0	0	0
18467	190092	1	0	2	0	0	2
18467	190515	1	0	0	0	1	1
18467	191239	1	1	0	0	1	2
18467	192597	1	1	1	0	0	2
18467	193732	1	0	0	0	0	0
18467	195860	1	1	0	0	1	2
18467	198253	1	0	1	0	0	1
18467	201382	1	0	1	0	0	1
18467	202112	1	0	0	0	1	1
18467	203782	1	0	0	0	1	1
18467	205013	1	1	0	0	2	3
18467	205986	1	0	0	0	0	0
18467	207280	1	0	0	0	0	0
18467	207355	1	0	1	0	1	2
18467	207905	1	0	0	0	1	1
18467	213995	1	0	1	0	0	1
18467	214058	1	1	0	0	0	1
18467	214488	1	0	1	0	1	2
18467	216862	1	0	2	0	0	2
18467	217408	1	0	1	0	1	2
18467	218630	1	0	0	0	0	0
18467	218697	1	0	0	0	1	1
18467	221077	1	1	1	0	2	4
18467	468075	1	0	0	0	1	1
18467	574564	1	0	4	0	0	4
18467	574573	1	3	2	0	2	7
18467	574609	1	1	2	0	0	3
18467	574616	1	0	0	0	1	1
18467	574617	1	0	0	0	1	1
18467	574629	1	0	1	2	1	4
18467	574642	1	1	1	0	0	2
18467	574644	1	0	0	0	0	0
18467	574648	1	0	1	0	0	1
18467	574649	1	0	0	0	0	0
18467	574651	1	1	0	0	1	2
18467	574653	1	1	0	0	0	1
18467	574654	1	0	1	0	0	1
18467	574661	1	1	1	0	0	2
18467	574663	1	1	0	0	0	1
18467	574676	1	0	0	0	0	0
18467	574684	1	0	0	0	0	0
18467	574692	1	0	1	0	1	2
18467	574700	1	0	0	0	2	2
18467	574701	1	1	1	0	0	2
18467	574730	1	0	0	0	0	0
18467	574736	1	0	0	0	1	1
18467	574774	1	0	1	0	0	1
18467	574793	1	2	0	0	0	2
18467	574803	1	0	0	0	0	0
18467	574807	1	0	0	0	1	1
18467	574820	1	0	1	0	1	2
18467	574825	1	0	0	0	1	1
18467	574845	1	2	2	1	1	6
18467	574876	1	0	1	0	1	2
18467	574877	1	0	0	0	0	0
18467	574900	1	0	0	0	1	1
18467	574901	1	0	0	0	0	0
18467	574910	1	0	0	0	0	0
18467	574914	1	0	0	0	1	1
18467	574920	1	0	1	0	0	1
18467	574924	1	0	1	0	0	1
18467	574927	1	0	0	0	1	1
18467	574949	1	0	1	0	0	1
18467	574955	1	0	0	0	0	0
18467	574961	1	0	0	0	1	1
18467	574971	1	0	0	0	0	0
18467	575000	1	0	0	0	0	0
18467	575014	1	0	1	0	0	1
18467	575036	1	0	0	0	0	0
18467	575041	1	0	0	0	1	1
18467	575092	1	1	0	0	0	1
18467	575099	1	1	0	0	2	3
18467	575113	1	1	1	0	0	2
18467	575125	1	0	0	0	0	0
9523	460929	39	0	1	2	2	5
9523	210664	30	4	6	3	1	14
9523	460715	30	4	6	3	1	14
9523	461192	28	2	3	3	3	11
9523	461083	23	3	5	3	2	13
9523	460968	21	2	0	0	4	6
9523	460963	20	0	0	2	0	2
9523	460791	18	2	4	0	5	11
9523	460965	18	2	2	2	1	7
9523	460805	16	2	5	2	0	9
9523	460717	13	2	1	0	0	3
9523	460830	13	0	1	0	0	1
9523	461086	13	1	0	2	1	4
9523	460713	12	3	4	2	3	12
9523	460872	12	0	0	0	0	0
9523	461004	12	3	2	1	2	8
9523	461050	12	3	1	1	2	7
9523	285434	11	5	2	2	0	9
9523	460748	11	1	5	1	3	10
9523	460810	11	2	4	0	2	8
9523	460942	11	1	0	0	1	2
9523	460972	11	0	1	0	0	1
9523	461091	11	0	0	2	0	2
9523	461128	11	1	0	0	1	2
9523	461193	11	3	1	1	0	5
9523	195006	10	0	2	0	0	2
9523	460798	10	1	1	0	0	2
9523	460839	10	0	0	2	0	2
9523	460865	10	0	1	2	2	5
9523	460870	10	0	0	0	0	0
9523	460957	10	1	3	0	0	4
9523	461140	10	3	1	2	0	6
9523	461151	10	0	4	0	0	4
9523	460719	9	1	1	1	0	3
9523	460782	9	1	0	0	1	2
9523	461035	9	0	2	0	0	2
9523	461049	9	2	4	0	0	6
9523	461051	9	1	1	1	0	3
9523	461084	9	1	1	0	0	2
9523	461122	9	0	0	1	0	1
9523	215225	8	1	0	0	1	2
9523	285435	8	2	2	0	0	4
9523	460709	8	2	2	0	0	4
9523	460800	8	2	0	1	3	6
9523	460802	8	4	1	1	0	6
9523	460823	8	1	1	2	0	4
9523	460831	8	1	0	0	1	2
9523	460855	8	0	0	2	0	2
9523	460874	8	1	2	0	0	3
9523	460904	8	1	0	1	0	2
9523	460939	8	3	0	0	1	4
9523	460975	8	2	1	0	0	3
9523	461010	8	2	0	1	0	3
9523	461016	8	0	3	0	0	3
9523	461028	8	2	2	0	0	4
9523	461046	8	0	1	2	1	4
9523	461160	8	1	1	0	0	2
9523	461170	8	0	1	1	0	2
9523	186040	7	3	0	0	1	4
9523	193847	7	2	2	0	0	4
9523	214083	7	0	1	0	0	1
9523	285432	7	1	1	1	0	3
9523	460703	7	4	1	0	0	5
9523	460710	7	2	4	1	1	8
9523	460716	7	1	2	0	0	3
9523	460759	7	0	1	0	0	1
9523	460763	7	1	1	0	0	2
9523	460789	7	4	0	0	1	5
9523	460816	7	2	2	0	0	4
9523	460833	7	2	0	0	0	2
9523	460848	7	1	1	0	1	3
9523	460854	7	0	0	0	0	0
9523	460858	7	2	1	1	2	6
9523	460867	7	2	0	1	0	3
9523	460880	7	1	0	0	0	1
9523	460890	7	2	1	2	1	6
9523	460907	7	1	2	0	0	3
9523	460912	7	0	0	1	0	1
9523	460946	7	2	2	2	2	8
9523	460966	7	2	1	0	1	4
9523	460973	7	1	1	0	1	3
9523	461000	7	1	3	1	0	5
9523	461007	7	2	1	2	0	5
9523	461025	7	1	1	0	2	4
9523	461030	7	1	1	0	0	2
9523	461076	7	1	1	0	0	2
9523	461087	7	2	2	0	0	4
9523	461175	7	0	1	0	0	1
9523	461176	7	0	1	0	0	1
9523	194970	6	1	2	1	0	4
9523	211006	6	1	4	0	0	5
9523	214017	6	4	4	1	0	9
9523	460704	6	0	3	0	1	4
9523	460722	6	1	0	1	0	2
9523	460742	6	0	1	0	0	1
9523	460792	6	1	0	0	0	1
9523	460826	6	5	2	1	0	8
9523	460832	6	1	0	0	0	1
9523	460841	6	0	1	1	1	3
9523	460843	6	2	1	0	2	5
9523	460847	6	1	1	0	1	3
9523	460856	6	0	0	0	0	0
9523	460857	6	1	1	1	0	3
9523	460866	6	1	2	0	0	3
9523	460878	6	1	0	1	1	3
9523	460882	6	0	0	1	0	1
9523	460884	6	3	0	0	1	4
9523	460889	6	2	0	0	1	3
9523	460909	6	2	0	0	1	3
9523	460911	6	0	1	0	0	1
9523	460915	6	0	2	0	0	2
9523	460923	6	1	2	1	0	4
9523	460960	6	1	1	0	1	3
9523	460978	6	0	1	0	1	2
9523	460990	6	1	2	1	0	4
9523	461003	6	3	1	0	0	4
9523	461011	6	2	0	1	1	4
9523	461015	6	1	2	1	0	4
9523	461019	6	0	2	3	0	5
9523	461032	6	0	1	0	0	1
9523	461038	6	2	1	0	0	3
9523	461040	6	5	0	1	1	7
9523	461056	6	0	4	2	0	6
9523	461065	6	2	1	0	0	3
9523	461081	6	2	0	0	0	2
9523	461085	6	2	2	0	0	4
9523	461097	6	0	0	0	1	1
9523	461104	6	1	1	2	0	4
9523	461119	6	0	1	0	1	2
9523	461153	6	0	1	0	0	1
9523	461161	6	0	1	1	0	2
9523	461181	6	0	1	0	0	1
9523	461184	6	0	0	0	0	0
9523	461190	6	2	1	1	0	4
9523	185817	5	1	1	0	0	2
9523	189810	5	0	2	0	1	3
9523	194477	5	2	0	1	0	3
9523	195865	5	1	0	0	1	2
9523	199695	5	0	0	0	0	0
9523	199766	5	1	2	1	0	4
9523	201354	5	0	0	0	0	0
9523	207761	5	0	2	1	0	3
9523	212359	5	2	0	1	0	3
9523	215933	5	2	2	0	0	4
9523	217938	5	0	1	0	0	1
9523	220377	5	1	1	1	0	3
9523	460707	5	0	1	0	0	1
9523	460720	5	0	0	0	0	0
9523	460745	5	0	1	0	1	2
9523	460749	5	2	2	0	1	5
9523	460751	5	1	2	0	0	3
9523	460755	5	2	2	0	0	4
9523	460775	5	0	1	0	1	2
9523	460777	5	1	1	0	0	2
9523	460804	5	1	2	0	0	3
9523	460813	5	1	0	0	2	3
9523	460817	5	1	1	0	1	3
9523	460818	5	0	0	0	0	0
9523	460819	5	0	1	0	1	2
9523	460828	5	0	0	0	1	1
9523	460849	5	0	0	0	1	1
9523	460851	5	2	0	4	0	6
9523	460853	5	2	0	0	0	2
9523	460860	5	0	0	0	2	2
9523	460864	5	1	2	0	0	3
9523	460871	5	0	2	0	1	3
9523	460879	5	1	0	1	2	4
9523	460883	5	0	0	0	0	0
9523	460899	5	1	1	0	0	2
9523	460902	5	1	0	0	0	1
9523	460905	5	0	2	0	0	2
9523	460914	5	0	1	0	0	1
9523	460926	5	1	1	0	0	2
9523	460933	5	1	0	1	0	2
9523	460934	5	2	0	1	0	3
9523	460935	5	0	2	0	0	2
9523	460938	5	0	0	0	1	1
9523	460958	5	1	0	1	0	2
9523	460959	5	0	1	0	0	1
9523	460967	5	1	2	1	1	5
9523	460979	5	2	1	0	0	3
9523	460996	5	0	0	2	0	2
9523	461008	5	1	1	0	0	2
9523	461017	5	2	0	0	1	3
9523	461039	5	0	2	0	0	2
9523	461047	5	0	1	0	0	1
9523	461067	5	2	2	0	0	4
9523	461069	5	2	0	2	0	4
9523	461082	5	3	0	1	1	5
9523	461099	5	1	1	0	0	2
9523	461103	5	1	1	0	0	2
9523	461125	5	1	1	0	0	2
9523	461130	5	0	1	1	0	2
9523	461135	5	1	0	0	1	2
9523	461149	5	0	0	1	0	1
9523	461152	5	1	1	0	0	2
9523	461172	5	0	0	1	0	1
9523	461173	5	0	1	1	0	2
9523	461204	5	2	0	1	1	4
9523	461205	5	2	2	0	0	4
9523	461207	5	0	0	0	0	0
9523	461211	5	1	1	3	0	5
9523	181897	4	1	1	0	0	2
9523	185301	4	0	0	1	0	1
9523	189129	4	0	1	1	0	2
9523	189686	4	1	0	0	0	1
9523	193189	4	0	2	2	0	4
9523	195938	4	2	0	0	0	2
9523	195955	4	2	0	0	0	2
9523	197309	4	1	1	0	0	2
9523	201228	4	2	3	0	0	5
9523	202774	4	0	1	1	0	2
9523	204598	4	1	1	0	0	2
9523	206485	4	1	0	0	0	1
9523	206670	4	0	1	0	0	1
9523	207568	4	1	1	0	0	2
9523	217707	4	0	2	0	0	2
9523	219047	4	1	2	0	0	3
9523	285433	4	0	1	0	0	1
9523	460706	4	0	1	0	1	2
9523	460708	4	1	2	1	1	5
9523	460718	4	0	1	0	0	1
9523	460724	4	1	1	0	0	2
9523	460727	4	1	1	0	0	2
9523	460733	4	1	1	0	1	3
9523	460761	4	1	0	0	0	1
9523	460768	4	0	1	0	0	1
9523	460770	4	0	0	0	0	0
9523	460773	4	0	0	0	0	0
9523	460780	4	1	0	0	1	2
9523	460806	4	0	0	1	0	1
9523	460809	4	0	0	0	0	0
9523	460811	4	0	0	0	0	0
9523	460812	4	0	3	0	1	4
9523	460820	4	1	0	0	0	1
9523	460822	4	1	1	0	1	3
9523	460824	4	2	0	0	0	2
9523	460829	4	0	1	0	0	1
9523	460834	4	0	1	0	3	4
9523	460835	4	2	0	0	0	2
9523	460838	4	1	1	2	0	4
9523	460840	4	1	0	0	0	1
9523	460846	4	1	1	1	0	3
9523	460862	4	0	1	0	0	1
9523	460875	4	0	0	0	0	0
9523	460877	4	0	1	0	0	1
9523	460881	4	0	0	0	0	0
9523	460888	4	2	1	0	0	3
9523	460891	4	0	0	0	0	0
9523	460895	4	0	0	0	0	0
9523	460900	4	2	1	0	0	3
9523	460901	4	1	1	0	0	2
9523	460913	4	0	0	0	1	1
9523	460918	4	0	0	0	0	0
9523	460919	4	1	0	0	0	1
9523	460924	4	0	2	0	0	2
9523	460925	4	1	1	0	0	2
9523	460928	4	0	4	0	0	4
9523	460930	4	0	0	0	0	0
9523	460932	4	1	1	0	2	4
9523	460944	4	0	1	1	0	2
9523	460977	4	1	1	0	0	2
9523	460984	4	0	2	0	0	2
9523	460995	4	0	1	0	0	1
9523	461005	4	0	1	0	0	1
9523	461021	4	2	1	0	0	3
9523	461023	4	1	0	0	1	2
9523	461029	4	1	0	0	0	1
9523	461037	4	0	1	2	0	3
9523	461043	4	0	2	0	0	2
9523	461048	4	0	0	0	3	3
9523	461055	4	0	0	0	0	0
9523	461057	4	0	0	0	0	0
9523	461059	4	0	0	0	0	0
9523	461062	4	0	0	2	0	2
9523	461063	4	1	0	1	0	2
9523	461072	4	0	0	0	2	2
9523	461074	4	1	0	1	0	2
9523	461079	4	1	0	0	0	1
9523	461093	4	0	2	0	0	2
9523	461107	4	1	1	0	0	2
9523	461120	4	1	0	0	0	1
9523	461137	4	1	1	0	0	2
9523	461141	4	1	1	0	0	2
9523	461148	4	1	1	1	0	3
9523	461154	4	1	1	0	1	3
9523	461156	4	0	0	0	2	2
9523	461159	4	0	0	1	0	1
9523	461165	4	0	1	1	0	2
9523	461169	4	0	3	0	0	3
9523	461189	4	0	0	0	0	0
9523	461198	4	0	1	0	0	1
9523	461201	4	1	0	0	2	3
9523	461212	4	0	1	0	1	2
9523	461213	4	0	3	0	0	3
9523	183734	3	0	1	0	0	1
9523	190970	3	1	3	1	0	5
9523	191081	3	1	0	0	0	1
9523	193574	3	0	1	0	0	1
9523	194174	3	2	0	0	0	2
9523	197422	3	0	1	1	0	2
9523	198041	3	1	1	0	0	2
9523	200118	3	2	1	0	0	3
9523	203019	3	1	0	0	0	1
9523	203686	3	1	0	0	0	1
9523	206408	3	1	1	0	0	2
9523	207364	3	0	0	0	0	0
9523	207808	3	0	0	0	0	0
9523	210586	3	0	0	0	0	0
9523	212443	3	2	1	0	0	3
9523	214059	3	2	1	0	0	3
9523	216824	3	0	1	0	0	1
9523	217182	3	0	1	0	0	1
9523	219845	3	0	1	0	0	1
9523	219943	3	0	0	0	0	0
9523	220761	3	0	2	0	1	3
9523	460705	3	0	1	0	0	1
9523	460712	3	1	0	0	0	1
9523	460714	3	1	2	1	0	4
9523	460723	3	0	1	0	0	1
9523	460725	3	0	0	0	1	1
9523	460729	3	0	2	0	0	2
9523	460731	3	1	1	0	0	2
9523	460734	3	0	1	0	1	2
9523	460743	3	1	1	0	0	2
9523	460744	3	0	1	0	1	2
9523	460753	3	1	1	1	0	3
9523	460771	3	0	1	0	0	1
9523	460781	3	0	1	0	0	1
9523	460783	3	0	1	0	0	1
9523	460784	3	0	3	0	0	3
9523	460794	3	1	0	0	0	1
9523	460796	3	1	0	0	0	1
9523	460799	3	0	0	0	0	0
9523	460801	3	0	1	0	0	1
9523	460808	3	0	1	0	0	1
9523	460814	3	0	0	0	0	0
9523	460836	3	0	1	0	1	2
9523	460837	3	0	1	0	0	1
9523	460844	3	0	1	1	0	2
9523	460845	3	0	2	0	1	3
9523	460852	3	0	0	1	0	1
9523	460868	3	1	0	0	0	1
9523	460876	3	0	1	0	0	1
9523	460886	3	0	0	0	0	0
9523	460893	3	1	1	1	0	3
9523	460908	3	0	1	0	0	1
9523	460910	3	0	0	0	0	0
9523	460916	3	2	0	0	0	2
9523	460937	3	0	1	0	0	1
9523	460943	3	0	0	0	0	0
9523	460945	3	1	3	0	0	4
9523	460947	3	1	0	0	0	1
9523	460948	3	1	0	0	1	2
9523	460950	3	1	1	0	0	2
9523	460951	3	0	0	0	1	1
9523	460952	3	0	0	0	1	1
9523	460953	3	1	0	0	0	1
9523	460964	3	1	1	0	0	2
9523	460969	3	1	0	1	0	2
9523	460974	3	0	1	0	0	1
9523	460981	3	1	0	0	0	1
9523	460989	3	0	0	0	0	0
9523	460993	3	1	0	0	0	1
9523	460998	3	0	0	0	0	0
9523	460999	3	0	2	0	0	2
9523	461001	3	0	0	0	0	0
9523	461002	3	0	0	0	1	1
9523	461012	3	1	1	0	0	2
9523	461020	3	1	0	0	0	1
9523	461022	3	2	2	0	0	4
9523	461026	3	0	0	0	0	0
9523	461034	3	0	2	0	0	2
9523	461036	3	0	1	0	0	1
9523	461053	3	0	1	0	0	1
9523	461054	3	0	0	0	0	0
9523	461064	3	2	2	0	0	4
9523	461070	3	0	2	0	0	2
9523	461071	3	0	0	0	0	0
9523	461075	3	1	1	1	0	3
9523	461089	3	0	0	2	0	2
9523	461094	3	0	1	0	1	2
9523	461100	3	2	0	1	0	3
9523	461105	3	0	0	0	0	0
9523	461108	3	0	0	0	0	0
9523	461110	3	0	1	0	0	1
9523	461111	3	0	0	1	0	1
9523	461112	3	0	0	0	0	0
9523	461116	3	2	1	0	0	3
9523	461118	3	1	1	0	0	2
9523	461121	3	0	3	0	1	4
9523	461123	3	1	0	0	0	1
9523	461126	3	1	1	1	0	3
9523	461145	3	2	1	0	0	3
9523	461146	3	1	0	0	0	1
9523	461155	3	4	0	0	0	4
9523	461157	3	1	1	1	0	3
9523	461158	3	0	0	1	1	2
9523	461163	3	1	2	2	0	5
9523	461164	3	1	2	1	0	4
9523	461177	3	0	0	0	1	1
9523	461179	3	0	1	1	0	2
9523	461180	3	0	1	0	0	1
9523	461182	3	1	1	0	0	2
9523	461185	3	0	0	1	0	1
9523	461187	3	0	1	1	0	2
9523	461194	3	0	0	0	0	0
9523	461195	3	1	1	0	0	2
9523	461196	3	0	1	0	1	2
9523	461197	3	1	0	0	0	1
9523	461206	3	2	1	0	0	3
9523	461208	3	0	1	1	0	2
9523	461210	3	0	1	1	1	3
9523	182346	2	0	1	0	0	1
9523	185149	2	1	0	0	0	1
9523	186286	2	0	0	0	0	0
9523	192012	2	0	3	0	0	3
9523	200433	2	0	2	0	0	2
9523	204923	2	0	1	0	0	1
9523	206381	2	1	0	0	0	1
9523	213910	2	0	0	0	0	0
9523	214728	2	0	0	0	0	0
9523	215702	2	2	0	0	0	2
9523	217289	2	0	0	0	0	0
9523	220594	2	0	2	0	0	2
9523	460711	2	0	1	0	0	1
9523	460721	2	2	1	0	0	3
9523	460726	2	1	2	0	0	3
9523	460730	2	1	1	0	0	2
9523	460736	2	0	0	0	0	0
9523	460737	2	0	1	0	1	2
9523	460738	2	0	3	0	1	4
9523	460739	2	1	1	1	0	3
9523	460741	2	1	1	0	0	2
9523	460746	2	0	0	0	1	1
9523	460747	2	1	1	0	0	2
9523	460754	2	0	0	0	0	0
9523	460756	2	0	1	0	0	1
9523	460757	2	0	1	0	0	1
9523	460762	2	0	3	0	0	3
9523	460764	2	0	2	0	2	4
9523	460765	2	0	0	0	0	0
9523	460766	2	1	2	0	0	3
9523	460767	2	1	1	1	0	3
9523	460776	2	1	2	1	0	4
9523	460786	2	0	2	1	0	3
9523	460787	2	0	0	0	1	1
9523	460788	2	1	1	1	0	3
9523	460793	2	1	0	0	0	1
9523	460795	2	1	1	0	0	2
9523	460797	2	0	0	1	3	4
9523	460803	2	0	1	0	0	1
9523	460807	2	0	0	0	0	0
9523	460821	2	1	2	1	0	4
9523	460825	2	1	1	0	0	2
9523	460850	2	0	0	0	1	1
9523	460863	2	0	1	0	0	1
9523	460873	2	0	0	0	0	0
9523	460885	2	0	1	0	0	1
9523	460887	2	2	0	0	0	2
9523	460892	2	0	0	0	1	1
9523	460894	2	0	0	0	0	0
9523	460898	2	0	3	0	0	3
9523	460917	2	0	0	0	0	0
9523	460920	2	2	1	0	0	3
9523	460921	2	0	0	0	0	0
9523	460931	2	2	1	1	0	4
9523	460941	2	0	0	0	0	0
9523	460949	2	0	1	0	0	1
9523	460954	2	1	0	0	0	1
9523	460962	2	0	0	0	0	0
9523	460971	2	1	2	0	1	4
9523	460980	2	0	0	0	0	0
9523	460983	2	0	1	0	1	2
9523	460985	2	0	0	0	0	0
9523	460986	2	0	2	0	1	3
9523	460987	2	0	0	0	0	0
9523	460997	2	0	0	0	0	0
9523	461006	2	1	1	0	0	2
9523	461013	2	1	1	0	0	2
9523	461014	2	2	1	0	0	3
9523	461018	2	0	0	0	0	0
9523	461024	2	1	2	0	0	3
9523	461027	2	0	1	0	0	1
9523	461033	2	0	1	0	0	1
9523	461041	2	0	0	0	0	0
9523	461042	2	0	1	0	1	2
9523	461045	2	0	1	0	0	1
9523	461052	2	0	0	0	0	0
9523	461060	2	0	1	0	0	1
9523	461061	2	0	1	0	0	1
9523	461068	2	0	0	0	0	0
9523	461073	2	1	0	0	0	1
9523	461078	2	0	0	0	0	0
9523	461080	2	1	0	1	0	2
9523	461088	2	0	1	0	0	1
9523	461090	2	1	1	0	1	3
9523	461095	2	0	1	1	0	2
9523	461098	2	0	2	1	0	3
9523	461101	2	3	0	0	2	5
9523	461102	2	0	0	0	0	0
9523	461109	2	0	1	0	0	1
9523	461113	2	1	2	0	0	3
9523	461124	2	0	1	1	0	2
9523	461133	2	0	0	0	0	0
9523	461134	2	0	1	0	0	1
9523	461136	2	2	1	0	0	3
9523	461138	2	0	1	0	0	1
9523	461142	2	0	0	0	0	0
9523	461143	2	0	2	0	0	2
9523	461144	2	0	1	0	0	1
9523	461147	2	0	1	0	0	1
9523	461150	2	2	0	0	0	2
9523	461166	2	0	1	0	0	1
9523	461167	2	0	0	0	0	0
9523	461171	2	1	0	0	0	1
9523	461178	2	0	0	0	0	0
9523	461183	2	0	0	0	0	0
9523	461186	2	1	0	0	0	1
9523	461191	2	4	0	0	0	4
9523	461202	2	0	0	0	0	0
9523	461209	2	0	0	0	0	0
9523	191332	1	1	0	0	0	1
9523	192735	1	0	0	1	0	1
9523	199105	1	1	0	0	0	1
9523	199850	1	0	0	0	0	0
9523	199963	1	0	1	0	0	1
9523	203282	1	0	0	0	0	0
9523	206707	1	1	0	0	0	1
9523	207063	1	0	1	1	0	2
9523	207630	1	0	0	0	0	0
9523	207635	1	1	0	0	0	1
9523	210771	1	0	0	0	2	2
9523	212799	1	0	0	0	0	0
9523	213879	1	0	0	0	0	0
9523	214232	1	0	0	0	0	0
9523	214404	1	0	1	0	0	1
9523	216606	1	0	2	0	0	2
9523	217415	1	0	0	0	0	0
9523	219000	1	0	0	0	0	0
9523	219005	1	0	0	0	0	0
9523	285436	1	0	0	0	0	0
9523	460728	1	0	0	0	1	1
9523	460732	1	0	1	0	0	1
9523	460735	1	0	3	0	0	3
9523	460740	1	0	1	0	0	1
9523	460750	1	0	0	0	0	0
9523	460752	1	0	1	0	0	1
9523	460758	1	0	0	0	0	0
9523	460760	1	0	2	0	1	3
9523	460769	1	0	0	0	1	1
9523	460772	1	2	0	0	0	2
9523	460774	1	0	0	0	0	0
9523	460778	1	0	0	0	0	0
9523	460779	1	1	2	0	0	3
9523	460785	1	1	3	0	0	4
9523	460790	1	1	1	0	0	2
9523	460815	1	1	0	0	0	1
9523	460827	1	2	2	0	0	4
9523	460842	1	0	3	0	2	5
9523	460859	1	0	1	0	0	1
9523	460861	1	0	0	0	0	0
9523	460869	1	0	0	0	0	0
9523	460896	1	1	0	1	0	2
9523	460897	1	0	0	1	0	1
9523	460903	1	0	0	0	0	0
9523	460906	1	0	0	0	0	0
9523	460922	1	1	1	0	0	2
9523	460927	1	1	0	0	0	1
9523	460936	1	0	0	1	0	1
9523	460940	1	2	0	0	0	2
9523	460955	1	0	0	0	0	0
9523	460956	1	0	0	1	1	2
9523	460961	1	0	1	0	2	3
9523	460970	1	1	1	0	0	2
9523	460976	1	0	1	0	0	1
9523	460982	1	1	0	0	1	2
9523	460988	1	0	1	0	0	1
9523	460991	1	0	1	0	0	1
9523	460992	1	0	1	0	0	1
9523	460994	1	0	1	0	0	1
9523	461009	1	1	1	0	0	2
9523	461031	1	0	1	0	0	1
9523	461044	1	1	0	0	0	1
9523	461058	1	0	0	0	0	0
9523	461066	1	0	0	0	0	0
9523	461077	1	1	2	0	0	3
9523	461092	1	0	0	0	1	1
9523	461096	1	2	1	1	0	4
9523	461106	1	0	0	0	0	0
9523	461114	1	0	1	0	3	4
9523	461115	1	1	0	1	0	2
9523	461117	1	1	0	0	0	1
9523	461127	1	1	0	0	0	1
9523	461129	1	1	0	0	0	1
9523	461131	1	0	0	0	0	0
9523	461132	1	0	1	0	0	1
9523	461139	1	0	0	0	0	0
9523	461162	1	0	0	0	0	0
9523	461168	1	1	1	1	0	3
9523	461174	1	0	0	0	0	0
9523	461188	1	0	0	0	0	0
9523	461199	1	0	0	0	0	0
9523	461200	1	0	1	0	0	1
9523	461203	1	0	0	0	0	0
16372	83938	33	0	0	1	4	5
16372	73370	27	1	2	0	6	9
16372	75131	27	0	2	1	4	7
16372	82944	25	2	1	0	2	5
16372	99236	25	3	4	0	3	10
16372	72919	24	3	1	0	9	13
16372	66358	23	3	6	2	12	23
16372	104256	19	1	4	0	1	6
16372	49592	19	1	3	1	1	6
16372	65549	19	3	1	0	0	4
16372	78228	19	1	3	0	2	6
16372	90378	19	3	4	1	6	14
16372	433300	15	1	1	0	2	4
16372	433304	15	7	2	3	0	12
16372	191428	14	2	3	1	3	9
16372	287473	14	1	3	1	4	9
16372	433323	14	1	3	1	4	9
16372	433494	14	0	1	1	2	4
16372	433515	14	3	2	0	5	10
16372	433521	14	1	1	1	1	4
16372	52416	14	1	3	1	4	9
16372	184604	13	2	1	0	0	3
16372	433306	13	3	3	1	0	7
16372	433369	13	1	3	0	1	5
16372	433626	13	1	3	0	1	5
16372	99931	13	0	3	1	3	7
16372	193319	12	2	3	0	0	5
16372	433313	12	2	2	0	2	6
16372	433370	12	2	1	0	2	5
16372	433536	12	1	1	1	0	3
16372	100840	11	2	4	0	1	7
16372	101001	11	2	1	1	1	5
16372	287472	11	2	1	1	1	5
16372	433361	11	1	3	2	1	7
16372	433432	11	3	3	2	1	9
16372	433514	11	1	3	1	4	9
16372	53539	11	1	0	0	1	2
16372	433357	10	1	6	1	0	8
16372	433537	10	1	0	2	1	4
16372	88189	10	3	0	0	2	5
16372	287474	9	1	1	0	3	5
16372	287476	9	1	0	1	2	4
16372	433268	9	1	3	1	2	7
16372	433303	9	1	1	0	3	5
16372	433309	9	1	3	1	4	9
16372	433360	9	1	0	1	2	4
16372	433383	9	1	0	0	5	6
16372	433399	9	1	0	0	2	3
16372	433425	9	1	1	1	1	4
16372	433428	9	1	4	0	1	6
16372	433488	9	0	0	0	0	0
16372	433524	9	2	1	0	1	4
16372	433601	9	2	3	0	1	6
16372	73818	9	0	2	0	2	4
16372	86541	9	2	3	0	2	7
16372	86896	9	0	3	0	2	5
16372	203026	8	1	1	0	5	7
16372	210370	8	4	0	0	6	10
16372	210725	8	1	1	0	2	4
16372	214987	8	1	6	2	3	12
16372	219035	8	4	1	0	1	6
16372	433288	8	5	3	0	4	12
16372	433305	8	0	1	0	0	1
16372	433396	8	1	2	0	0	3
16372	433429	8	0	2	0	1	3
16372	433459	8	0	1	0	3	4
16372	433464	8	2	1	0	1	4
16372	433546	8	2	1	0	3	6
16372	433603	8	2	1	0	5	8
16372	55742	8	2	2	0	2	6
16372	101483	7	0	1	1	3	5
16372	104076	7	1	0	0	1	2
16372	183484	7	1	1	0	2	4
16372	204377	7	0	0	1	2	3
16372	433280	7	1	3	1	4	9
16372	433294	7	0	2	0	0	2
16372	433295	7	1	0	0	4	5
16372	433315	7	0	1	1	1	3
16372	433322	7	2	3	2	1	8
16372	433327	7	0	0	0	2	2
16372	433329	7	0	2	0	0	2
16372	433339	7	2	0	0	5	7
16372	433340	7	1	0	0	1	2
16372	433345	7	0	0	1	0	1
16372	433372	7	0	0	0	3	3
16372	433446	7	1	2	0	2	5
16372	433461	7	0	0	2	0	2
16372	433481	7	2	5	0	3	10
16372	433484	7	4	3	0	0	7
16372	433487	7	1	0	0	0	1
16372	433490	7	3	1	1	0	5
16372	433493	7	1	2	1	1	5
16372	433499	7	3	0	0	1	4
16372	433522	7	1	2	0	0	3
16372	433542	7	3	2	1	1	7
16372	433571	7	0	4	1	0	5
16372	433586	7	0	0	0	1	1
16372	433615	7	0	1	0	3	4
16372	433625	7	2	4	0	4	10
16372	55686	7	2	2	0	2	6
16372	55689	7	0	0	0	1	1
16372	61668	7	0	3	0	2	5
16372	65360	7	1	0	0	2	3
16372	96518	7	0	0	1	0	1
16372	184551	6	1	0	1	0	2
16372	188260	6	0	1	0	0	1
16372	191321	6	0	1	0	0	1
16372	208218	6	0	1	0	0	1
16372	211222	6	1	1	0	1	3
16372	220500	6	0	0	0	2	2
16372	287464	6	0	0	1	2	3
16372	287465	6	0	0	0	2	2
16372	287469	6	1	0	0	4	5
16372	287480	6	0	1	0	0	1
16372	433273	6	3	2	0	1	6
16372	433279	6	2	3	0	0	5
16372	433312	6	2	4	1	0	7
16372	433321	6	1	2	0	0	3
16372	433332	6	3	0	0	0	3
16372	433348	6	1	2	0	0	3
16372	433350	6	1	3	0	0	4
16372	433355	6	3	6	0	0	9
16372	433366	6	2	0	0	0	2
16372	433368	6	0	1	0	3	4
16372	433376	6	1	2	0	1	4
16372	433395	6	0	0	1	0	1
16372	433400	6	0	0	0	0	0
16372	433427	6	3	2	0	2	7
16372	433431	6	1	3	0	0	4
16372	433447	6	1	1	0	4	6
16372	433449	6	0	1	0	0	1
16372	433450	6	0	0	0	0	0
16372	433453	6	3	1	0	0	4
16372	433498	6	1	3	0	0	4
16372	433500	6	1	1	0	0	2
16372	433507	6	2	0	1	4	7
16372	433511	6	1	2	0	4	7
16372	433532	6	0	0	0	1	1
16372	433556	6	0	1	0	3	4
16372	433558	6	0	0	1	4	5
16372	433573	6	0	1	0	0	1
16372	433585	6	1	2	0	0	3
16372	433598	6	3	5	0	1	9
16372	433609	6	2	3	1	1	7
16372	433624	6	3	3	1	2	9
16372	55332	6	0	1	0	0	1
16372	64938	6	0	1	0	1	2
16372	76064	6	1	1	0	1	3
16372	84386	6	0	0	1	2	3
16372	88477	6	1	0	0	0	1
16372	91661	6	0	1	0	0	1
16372	103871	5	0	0	0	0	0
16372	184295	5	2	0	0	2	4
16372	196789	5	0	0	0	1	1
16372	198166	5	0	0	0	0	0
16372	198167	5	0	0	0	0	0
16372	203320	5	0	0	1	1	2
16372	206269	5	0	2	0	4	6
16372	207096	5	0	1	0	0	1
16372	207282	5	0	0	0	2	2
16372	207646	5	1	0	0	1	2
16372	213482	5	1	0	0	0	1
16372	216550	5	1	0	0	0	1
16372	218872	5	1	0	0	0	1
16372	287471	5	1	0	0	1	2
16372	433263	5	2	1	0	2	5
16372	433264	5	1	2	0	0	3
16372	433272	5	1	1	0	2	4
16372	433278	5	2	3	1	0	6
16372	433284	5	0	0	0	2	2
16372	433286	5	2	2	0	3	7
16372	433290	5	3	1	0	1	5
16372	433299	5	2	2	0	2	6
16372	433302	5	1	0	0	1	2
16372	433310	5	0	1	1	0	2
16372	433314	5	2	0	0	1	3
16372	433316	5	0	0	0	0	0
16372	433320	5	1	0	0	0	1
16372	433324	5	0	2	0	1	3
16372	433326	5	3	0	0	0	3
16372	433328	5	0	1	0	0	1
16372	433331	5	1	0	1	0	2
16372	433333	5	0	1	0	0	1
16372	433337	5	1	0	0	2	3
16372	433358	5	1	4	0	0	5
16372	433371	5	1	0	0	0	1
16372	433388	5	5	0	1	2	8
16372	433393	5	1	0	0	1	2
16372	433403	5	0	1	0	5	6
16372	433416	5	1	1	0	0	2
16372	433426	5	0	0	0	0	0
16372	433434	5	0	0	0	1	1
16372	433436	5	0	1	0	0	1
16372	433440	5	0	2	0	0	2
16372	433442	5	1	1	0	3	5
16372	433452	5	0	0	1	0	1
16372	433467	5	0	1	0	2	3
16372	433476	5	2	1	0	0	3
16372	433480	5	2	2	2	1	7
16372	433485	5	1	0	1	1	3
16372	433492	5	1	4	0	0	5
16372	433506	5	0	0	0	2	2
16372	433530	5	2	2	0	2	6
16372	433534	5	1	2	2	1	6
16372	433543	5	0	0	0	0	0
16372	433554	5	2	2	0	0	4
16372	433563	5	2	1	0	2	5
16372	433572	5	1	0	0	2	3
16372	433597	5	0	2	0	1	3
16372	433614	5	1	2	0	3	6
16372	433619	5	0	1	0	0	1
16372	55328	5	0	1	0	2	3
16372	63460	5	1	1	1	0	3
16372	63981	5	1	0	0	3	4
16372	71770	5	0	1	0	2	3
16372	86656	5	1	0	0	1	2
16372	88271	5	0	3	0	1	4
16372	88456	5	0	0	0	2	2
16372	98750	5	0	2	0	2	4
16372	99310	5	0	0	0	3	3
16372	184629	4	2	1	0	0	3
16372	184675	4	1	0	0	0	1
16372	190308	4	0	0	0	0	0
16372	194349	4	0	1	0	1	2
16372	201270	4	0	0	0	1	1
16372	203259	4	1	0	0	0	1
16372	205364	4	1	1	0	2	4
16372	210311	4	0	0	0	2	2
16372	213889	4	2	1	0	0	3
16372	219990	4	0	1	0	1	2
16372	287459	4	1	2	0	4	7
16372	287460	4	0	1	0	6	7
16372	287467	4	0	1	1	2	4
16372	287470	4	0	2	0	0	2
16372	287477	4	0	0	0	0	0
16372	287485	4	0	0	0	0	0
16372	433266	4	1	0	0	0	1
16372	433277	4	0	3	0	2	5
16372	433281	4	1	0	0	1	2
16372	433287	4	1	0	0	1	2
16372	433289	4	0	1	0	0	1
16372	433291	4	1	0	0	1	2
16372	433296	4	0	1	0	3	4
16372	433297	4	0	2	0	2	4
16372	433298	4	0	1	0	3	4
16372	433301	4	1	0	0	1	2
16372	433317	4	0	1	1	0	2
16372	433318	4	0	0	0	0	0
16372	433319	4	3	1	0	0	4
16372	433325	4	1	2	1	0	4
16372	433338	4	1	0	0	0	1
16372	433343	4	0	0	0	0	0
16372	433346	4	0	1	0	0	1
16372	433347	4	0	1	0	1	2
16372	433352	4	0	0	0	4	4
16372	433353	4	0	1	0	2	3
16372	433362	4	0	1	0	1	2
16372	433363	4	2	1	1	1	5
16372	433379	4	2	1	0	2	5
16372	433381	4	1	2	0	1	4
16372	433382	4	1	3	0	1	5
16372	433384	4	1	3	0	1	5
16372	433387	4	0	1	1	1	3
16372	433405	4	1	0	0	2	3
16372	433406	4	1	0	0	0	1
16372	433408	4	1	0	0	0	1
16372	433409	4	0	2	1	1	4
16372	433411	4	1	1	0	2	4
16372	433413	4	0	1	0	0	1
16372	433414	4	0	1	0	2	3
16372	433435	4	1	3	0	1	5
16372	433438	4	0	0	0	1	1
16372	433448	4	0	1	0	1	2
16372	433462	4	1	0	0	5	6
16372	433466	4	1	1	0	0	2
16372	433471	4	0	2	0	0	2
16372	433473	4	0	0	0	2	2
16372	433478	4	1	1	0	0	2
16372	433486	4	0	0	0	0	0
16372	433496	4	1	4	0	1	6
16372	433497	4	1	2	0	1	4
16372	433501	4	0	0	0	0	0
16372	433502	4	1	2	0	0	3
16372	433504	4	1	0	0	2	3
16372	433505	4	1	1	0	0	2
16372	433509	4	1	1	0	1	3
16372	433510	4	0	2	0	1	3
16372	433512	4	1	0	0	0	1
16372	433513	4	1	0	0	1	2
16372	433518	4	1	0	1	0	2
16372	433533	4	0	2	1	1	4
16372	433535	4	2	2	0	1	5
16372	433541	4	3	0	0	0	3
16372	433544	4	1	3	0	1	5
16372	433545	4	0	2	0	0	2
16372	433548	4	0	1	0	2	3
16372	433561	4	1	1	0	2	4
16372	433562	4	0	1	1	6	8
16372	433564	4	0	1	0	1	2
16372	433566	4	0	1	0	1	2
16372	433569	4	2	0	0	1	3
16372	433577	4	2	0	0	0	2
16372	433582	4	1	1	0	0	2
16372	433591	4	1	0	0	0	1
16372	433594	4	3	0	1	0	4
16372	433599	4	2	1	0	4	7
16372	433605	4	0	1	0	0	1
16372	433607	4	1	2	0	1	4
16372	433617	4	1	2	0	0	3
16372	433618	4	2	3	0	1	6
16372	433629	4	1	4	1	6	12
16372	69654	4	0	1	0	6	7
16372	71333	4	1	2	0	4	7
16372	72673	4	1	0	0	0	1
16372	83913	4	1	0	0	2	3
16372	86763	4	1	0	0	0	1
16372	98493	4	0	2	0	0	2
16372	186244	3	2	1	0	2	5
16372	186795	3	1	0	0	3	4
16372	186804	3	0	0	0	0	0
16372	189723	3	1	0	0	1	2
16372	189928	3	1	0	0	0	1
16372	191556	3	0	1	0	3	4
16372	191640	3	0	1	0	0	1
16372	193740	3	1	0	0	0	1
16372	193757	3	1	1	0	1	3
16372	194385	3	0	0	0	1	1
16372	198499	3	0	0	0	0	0
16372	201242	3	0	0	0	1	1
16372	206457	3	1	0	0	0	1
16372	206549	3	0	0	0	0	0
16372	207164	3	1	0	0	1	2
16372	207480	3	1	0	0	0	1
16372	207497	3	0	0	0	0	0
16372	210452	3	2	0	0	4	6
16372	212488	3	0	0	0	0	0
16372	212795	3	1	0	0	0	1
16372	214256	3	0	0	0	2	2
16372	214434	3	0	0	0	2	2
16372	214590	3	2	2	0	1	5
16372	217695	3	0	0	0	0	0
16372	217806	3	0	0	0	0	0
16372	218005	3	0	0	1	1	2
16372	219791	3	0	0	2	0	2
16372	287475	3	2	0	0	2	4
16372	287481	3	0	0	0	0	0
16372	287482	3	1	0	0	0	1
16372	287483	3	1	0	0	0	1
16372	433267	3	1	0	0	0	1
16372	433269	3	0	2	0	0	2
16372	433270	3	2	2	0	0	4
16372	433271	3	0	2	0	0	2
16372	433275	3	0	1	0	1	2
16372	433282	3	2	0	0	1	3
16372	433293	3	2	1	0	0	3
16372	433307	3	0	2	1	1	4
16372	433308	3	0	0	0	1	1
16372	433334	3	0	2	0	1	3
16372	433336	3	0	0	0	0	0
16372	433341	3	1	0	0	2	3
16372	433344	3	0	0	0	4	4
16372	433351	3	0	1	1	4	6
16372	433364	3	0	0	0	0	0
16372	433373	3	2	0	0	0	2
16372	433377	3	0	1	0	2	3
16372	433380	3	2	0	0	2	4
16372	433386	3	0	0	0	0	0
16372	433391	3	5	1	0	0	6
16372	433394	3	0	1	0	1	2
16372	433397	3	0	1	0	0	1
16372	433398	3	1	1	0	0	2
16372	433402	3	0	0	0	0	0
16372	433410	3	2	3	0	0	5
16372	433412	3	1	1	0	1	3
16372	433417	3	1	0	0	0	1
16372	433422	3	0	2	1	0	3
16372	433423	3	2	1	0	0	3
16372	433424	3	0	1	0	0	1
16372	433437	3	4	3	1	0	8
16372	433451	3	0	3	0	0	3
16372	433454	3	1	1	0	5	7
16372	433456	3	1	2	1	0	4
16372	433458	3	1	0	0	2	3
16372	433463	3	1	3	0	0	4
16372	433465	3	2	0	0	1	3
16372	433468	3	0	1	0	0	1
16372	433469	3	0	1	0	2	3
16372	433472	3	1	1	0	1	3
16372	433474	3	1	2	0	1	4
16372	433477	3	1	0	0	1	2
16372	433479	3	1	0	0	1	2
16372	433483	3	0	2	0	0	2
16372	433489	3	1	0	1	0	2
16372	433491	3	1	3	2	3	9
16372	433495	3	0	0	0	0	0
16372	433503	3	2	1	0	1	4
16372	433508	3	0	0	0	1	1
16372	433516	3	1	0	0	0	1
16372	433517	3	1	1	0	0	2
16372	433520	3	0	0	0	1	1
16372	433523	3	0	1	0	1	2
16372	433525	3	1	1	0	0	2
16372	433527	3	1	1	0	0	2
16372	433529	3	2	1	0	2	5
16372	433531	3	2	0	1	3	6
16372	433550	3	0	1	0	1	2
16372	433551	3	1	1	0	0	2
16372	433553	3	0	1	0	2	3
16372	433555	3	0	2	0	1	3
16372	433559	3	0	1	0	2	3
16372	433565	3	3	1	0	0	4
16372	433567	3	0	1	2	0	3
16372	433568	3	0	1	1	3	5
16372	433570	3	0	2	1	2	5
16372	433574	3	1	0	0	1	2
16372	433578	3	2	1	0	1	4
16372	433579	3	0	1	0	0	1
16372	433581	3	0	5	0	5	10
16372	433588	3	1	0	0	0	1
16372	433589	3	0	2	0	1	3
16372	433592	3	0	0	0	0	0
16372	433600	3	2	1	0	0	3
16372	433602	3	1	0	0	0	1
16372	433604	3	1	3	0	0	4
16372	433606	3	1	2	0	0	3
16372	433611	3	3	2	0	1	6
16372	433622	3	2	4	0	1	7
16372	433623	3	0	1	0	0	1
16372	433627	3	0	0	0	0	0
16372	433628	3	2	0	0	0	2
16372	53245	3	2	1	0	1	4
16372	56258	3	1	0	0	0	1
16372	86911	3	0	4	1	0	5
16372	92434	3	0	1	0	1	2
16372	97039	3	0	0	0	0	0
16372	185538	2	0	0	0	0	0
16372	186814	2	2	0	0	1	3
16372	187530	2	0	0	0	0	0
16372	188488	2	0	0	0	2	2
16372	191406	2	0	4	0	0	4
16372	192401	2	0	0	0	1	1
16372	195648	2	0	0	0	1	1
16372	195659	2	0	1	0	0	1
16372	198684	2	1	1	0	0	2
16372	200033	2	2	0	0	0	2
16372	201997	2	0	0	0	2	2
16372	203233	2	1	1	0	0	2
16372	204941	2	2	0	0	0	2
16372	205346	2	0	0	0	1	1
16372	206632	2	0	1	1	0	2
16372	206749	2	0	1	0	1	2
16372	211230	2	0	0	0	0	0
16372	212803	2	0	0	0	0	0
16372	212898	2	0	1	0	0	1
16372	215163	2	0	0	1	0	1
16372	215403	2	0	0	0	0	0
16372	217292	2	0	0	0	1	1
16372	218667	2	0	0	0	1	1
16372	220873	2	0	0	0	0	0
16372	287461	2	0	1	0	0	1
16372	287462	2	0	2	0	3	5
16372	287463	2	0	1	0	1	2
16372	287466	2	0	1	0	1	2
16372	287468	2	0	1	0	0	1
16372	287478	2	0	0	0	0	0
16372	287487	2	1	0	0	1	2
16372	433276	2	0	1	0	1	2
16372	433285	2	1	0	0	0	1
16372	433292	2	1	0	1	1	3
16372	433311	2	0	1	0	1	2
16372	433330	2	1	0	0	1	2
16372	433335	2	0	0	0	1	1
16372	433349	2	0	0	0	1	1
16372	433356	2	0	0	0	3	3
16372	433359	2	0	0	0	0	0
16372	433378	2	0	3	0	0	3
16372	433385	2	1	1	0	2	4
16372	433389	2	3	0	0	1	4
16372	433390	2	0	0	0	2	2
16372	433392	2	0	0	0	1	1
16372	433401	2	1	3	0	1	5
16372	433404	2	0	1	0	0	1
16372	433407	2	0	0	1	0	1
16372	433419	2	1	1	0	3	5
16372	433421	2	0	0	0	0	0
16372	433430	2	0	2	0	1	3
16372	433433	2	0	1	0	0	1
16372	433439	2	0	2	0	1	3
16372	433443	2	0	0	0	1	1
16372	433445	2	1	1	0	0	2
16372	433460	2	0	0	0	1	1
16372	433470	2	0	1	0	0	1
16372	433475	2	0	1	0	1	2
16372	433482	2	0	1	0	2	3
16372	433519	2	1	2	0	2	5
16372	433526	2	0	0	0	1	1
16372	433528	2	0	0	0	0	0
16372	433539	2	0	1	0	1	2
16372	433540	2	1	1	0	1	3
16372	433547	2	0	0	0	0	0
16372	433549	2	1	0	0	0	1
16372	433557	2	1	0	0	0	1
16372	433575	2	0	0	0	0	0
16372	433580	2	0	0	0	0	0
16372	433583	2	1	1	0	0	2
16372	433584	2	0	0	0	5	5
16372	433587	2	0	0	0	0	0
16372	433590	2	0	0	0	0	0
16372	433593	2	0	0	0	0	0
16372	433595	2	1	0	0	1	2
16372	433596	2	2	2	0	0	4
16372	433610	2	0	0	0	0	0
16372	433612	2	1	0	0	0	1
16372	433613	2	0	0	0	1	1
16372	433616	2	1	0	0	0	1
16372	433620	2	1	0	0	0	1
16372	433621	2	0	1	0	0	1
16372	50350	2	1	0	0	1	2
16372	56032	2	1	0	0	1	2
16372	64316	2	0	2	0	3	5
16372	71484	2	0	1	0	0	1
16372	86683	2	0	1	0	1	2
16372	96553	2	0	0	0	0	0
16372	105228	1	0	1	0	2	3
16372	182329	1	0	0	0	0	0
16372	183506	1	2	0	0	0	2
16372	183744	1	0	0	0	1	1
16372	186945	1	0	0	0	1	1
16372	190514	1	0	1	0	1	2
16372	195504	1	2	1	0	0	3
16372	198449	1	1	0	0	1	2
16372	200043	1	0	0	0	2	2
16372	200297	1	0	0	0	0	0
16372	203348	1	0	1	0	0	1
16372	203786	1	0	0	0	0	0
16372	205014	1	1	0	0	1	2
16372	206009	1	0	0	0	2	2
16372	207820	1	0	0	0	1	1
16372	207825	1	1	1	0	0	2
16372	216610	1	0	0	0	1	1
16372	221150	1	0	1	0	0	1
16372	221924	1	1	0	0	1	2
16372	287479	1	0	0	0	0	0
16372	287484	1	0	0	0	1	1
16372	287486	1	0	1	0	1	2
16372	433265	1	0	0	0	0	0
16372	433274	1	0	1	0	1	2
16372	433283	1	0	0	0	1	1
16372	433342	1	1	0	0	3	4
16372	433354	1	0	0	0	1	1
16372	433365	1	0	3	1	1	5
16372	433367	1	0	0	0	0	0
16372	433374	1	0	0	0	0	0
16372	433375	1	0	0	0	0	0
16372	433415	1	1	2	0	1	4
16372	433418	1	0	1	0	0	1
16372	433420	1	0	0	0	0	0
16372	433441	1	1	0	0	2	3
16372	433444	1	1	0	0	0	1
16372	433455	1	1	2	0	3	6
16372	433457	1	1	0	0	0	1
16372	433538	1	0	0	0	1	1
16372	433552	1	1	1	0	0	2
16372	433560	1	1	2	0	1	4
16372	433576	1	0	0	0	0	0
16372	433608	1	1	0	0	1	2
16372	54882	1	0	0	0	1	1
44647	219919	51	2	2	4	0	8
44647	210659	40	3	5	1	4	13
44647	375876	40	3	5	1	4	13
44647	186110	27	2	4	0	0	6
44647	199597	27	2	2	1	1	6
44647	295140	26	2	4	0	0	6
44647	376034	26	2	2	0	0	4
44647	375889	23	3	1	1	0	5
44647	295132	19	4	3	1	2	10
44647	375933	19	0	1	3	0	4
44647	204761	17	4	1	0	2	7
44647	295128	17	0	2	0	1	3
44647	375998	16	0	2	0	0	2
44647	194892	15	3	2	1	1	7
44647	199830	15	0	2	1	1	4
44647	375902	15	1	0	0	1	2
44647	376019	15	0	1	1	1	3
44647	207720	14	3	0	1	0	4
44647	216783	14	3	1	0	0	4
44647	375839	14	0	1	0	0	1
44647	375886	14	3	4	2	2	11
44647	188906	13	0	2	0	1	3
44647	189757	13	3	4	2	2	11
44647	211560	13	0	2	2	0	4
44647	375919	13	0	2	0	1	3
44647	187065	12	1	3	0	0	4
44647	217394	12	0	1	0	3	4
44647	375887	12	2	4	2	1	9
44647	375893	12	1	1	2	0	4
44647	375900	12	0	0	0	1	1
44647	375948	12	2	1	0	1	4
44647	375959	12	3	1	0	0	4
44647	375976	12	0	0	1	0	1
44647	376031	12	1	1	0	0	2
44647	376063	12	0	3	0	1	4
44647	376105	12	0	1	0	0	1
44647	184108	11	0	0	1	1	2
44647	295129	11	3	1	1	0	5
44647	375854	11	1	1	1	0	3
44647	375873	11	4	7	1	1	13
44647	375890	11	2	4	0	1	7
44647	375901	11	5	2	0	1	8
44647	375903	11	2	5	3	0	10
44647	375958	11	0	0	1	1	2
44647	375993	11	1	5	0	0	6
44647	376026	11	1	1	0	0	2
44647	192228	10	0	1	0	0	1
44647	295124	10	0	2	0	0	2
44647	375899	10	2	2	0	1	5
44647	375947	10	0	1	0	1	2
44647	376038	10	1	3	2	0	6
44647	376061	10	0	1	0	0	1
44647	183244	9	0	2	0	1	3
44647	184553	9	0	2	0	0	2
44647	192584	9	2	2	0	0	4
44647	198068	9	3	1	0	0	4
44647	295126	9	2	3	0	2	7
44647	295157	9	0	0	1	2	3
44647	295158	9	2	3	0	0	5
44647	295164	9	2	2	0	0	4
44647	375875	9	2	2	0	0	4
44647	375923	9	2	1	1	1	5
44647	375939	9	1	1	0	1	3
44647	375971	9	1	2	0	0	3
44647	376007	9	0	0	0	0	0
44647	376018	9	3	3	0	0	6
44647	376041	9	1	2	0	0	3
44647	376064	9	1	1	0	0	2
44647	186062	8	0	3	0	1	4
44647	197217	8	1	1	0	1	3
44647	201223	8	1	2	0	0	3
44647	216924	8	1	1	0	0	2
44647	295147	8	3	4	0	0	7
44647	295161	8	1	2	0	0	3
44647	375863	8	0	4	0	1	5
44647	375872	8	2	4	0	1	7
44647	375916	8	1	6	0	0	7
44647	375965	8	0	0	0	0	0
44647	375984	8	4	2	2	0	8
44647	375997	8	2	1	1	0	4
44647	376014	8	0	0	0	0	0
44647	376021	8	1	4	0	1	6
44647	376035	8	1	2	0	0	3
44647	376069	8	0	2	1	0	3
44647	376079	8	2	2	0	0	4
44647	376082	8	1	3	0	0	4
44647	376085	8	1	2	0	0	3
44647	376090	8	2	1	0	1	4
44647	183418	7	0	2	0	1	3
44647	185101	7	1	2	0	0	3
44647	185466	7	0	1	0	0	1
44647	185873	7	2	1	1	1	5
44647	190473	7	3	0	0	1	4
44647	197213	7	0	2	0	0	2
44647	201612	7	1	1	0	0	2
44647	201900	7	2	1	1	0	4
44647	202000	7	0	1	0	2	3
44647	208007	7	1	2	0	2	5
44647	211848	7	2	1	0	0	3
44647	214104	7	0	2	1	0	3
44647	219009	7	1	2	0	1	4
44647	295127	7	1	1	0	0	2
44647	295141	7	0	0	0	0	0
44647	295151	7	1	1	1	2	5
44647	375850	7	3	4	0	0	7
44647	375858	7	1	0	0	0	1
44647	375870	7	0	2	0	1	3
44647	375920	7	1	1	0	2	4
44647	375942	7	3	4	0	0	7
44647	375953	7	1	2	0	0	3
44647	375982	7	0	3	0	2	5
44647	375999	7	0	1	0	1	2
44647	376002	7	1	1	0	0	2
44647	376005	7	1	2	0	0	3
44647	376011	7	2	5	1	0	8
44647	376030	7	2	1	0	0	3
44647	376033	7	1	1	0	0	2
44647	376037	7	2	2	0	0	4
44647	376052	7	3	0	0	2	5
44647	376057	7	0	0	1	0	1
44647	376076	7	2	0	0	1	3
44647	376078	7	2	0	0	1	3
44647	376093	7	0	3	0	1	4
44647	376104	7	3	1	0	1	5
44647	185332	6	0	0	0	0	0
44647	188256	6	2	1	0	0	3
44647	189692	6	1	0	0	0	1
44647	190450	6	1	0	0	0	1
44647	190658	6	2	2	0	0	4
44647	193176	6	1	2	0	0	3
44647	193881	6	1	1	1	0	3
44647	198651	6	0	2	0	0	2
44647	199995	6	0	1	0	0	1
44647	200420	6	1	3	0	0	4
44647	201295	6	1	2	0	1	4
44647	204433	6	0	0	0	2	2
44647	206644	6	0	3	0	1	4
44647	207112	6	2	4	0	0	6
44647	212644	6	2	0	1	0	3
44647	214481	6	1	3	0	0	4
44647	216771	6	1	1	0	0	2
44647	217004	6	0	0	0	0	0
44647	295136	6	1	1	1	0	3
44647	295153	6	2	2	0	0	4
44647	295155	6	0	0	0	0	0
44647	295156	6	0	0	0	0	0
44647	295159	6	3	0	0	0	3
44647	295162	6	3	0	0	1	4
44647	375851	6	0	2	2	2	6
44647	375855	6	1	2	1	1	5
44647	375859	6	2	0	0	0	2
44647	375861	6	2	2	0	0	4
44647	375880	6	1	0	0	0	1
44647	375894	6	2	1	2	1	6
44647	375896	6	2	0	0	1	3
44647	375907	6	1	2	0	0	3
44647	375911	6	1	1	0	0	2
44647	375922	6	0	0	0	0	0
44647	375928	6	0	0	1	0	1
44647	375945	6	0	0	0	0	0
44647	375974	6	1	1	1	2	5
44647	375986	6	2	2	0	3	7
44647	375994	6	1	1	0	0	2
44647	375996	6	0	2	0	0	2
44647	376012	6	1	3	0	1	5
44647	376016	6	1	0	0	0	1
44647	376017	6	0	0	0	0	0
44647	376020	6	1	1	0	0	2
44647	376044	6	2	1	0	0	3
44647	376048	6	0	1	0	0	1
44647	376077	6	0	0	0	0	0
44647	376081	6	2	2	0	0	4
44647	185255	5	0	1	0	2	3
44647	186860	5	0	1	0	0	1
44647	187527	5	0	1	0	0	1
44647	189635	5	1	0	0	0	1
44647	191084	5	1	1	0	0	2
44647	192367	5	2	1	0	0	3
44647	192824	5	0	2	0	0	2
44647	194208	5	2	1	0	0	3
44647	194531	5	1	1	0	0	2
44647	195892	5	0	1	0	0	1
44647	196113	5	1	3	0	0	4
44647	198685	5	2	2	0	1	5
44647	199106	5	0	1	1	0	2
44647	200416	5	1	0	0	0	1
44647	201914	5	1	1	0	0	2
44647	203192	5	0	0	0	3	3
44647	205898	5	0	2	0	0	2
44647	206534	5	0	1	0	0	1
44647	207694	5	1	1	0	0	2
44647	213900	5	0	0	0	0	0
44647	214372	5	1	1	0	0	2
44647	216035	5	0	2	0	0	2
44647	216773	5	0	0	0	0	0
44647	217438	5	1	1	0	0	2
44647	217674	5	1	2	0	0	3
44647	218785	5	2	0	0	0	2
44647	218862	5	0	1	0	0	1
44647	295137	5	1	0	0	1	2
44647	295149	5	0	1	0	0	1
44647	375831	5	1	5	0	1	7
44647	375833	5	1	1	0	0	2
44647	375840	5	0	0	0	0	0
44647	375844	5	2	1	0	1	4
44647	375852	5	2	0	0	0	2
44647	375853	5	1	3	0	1	5
44647	375891	5	1	0	0	1	2
44647	375892	5	1	1	0	0	2
44647	375898	5	2	1	0	1	4
44647	375909	5	1	0	0	1	2
44647	375910	5	2	1	0	0	3
44647	375912	5	0	2	0	0	2
44647	375915	5	4	0	0	2	6
44647	375925	5	1	0	0	0	1
44647	375936	5	0	2	0	0	2
44647	375941	5	0	2	0	1	3
44647	375944	5	1	1	0	0	2
44647	375946	5	1	2	0	0	3
44647	375957	5	0	2	0	1	3
44647	375960	5	2	0	0	0	2
44647	375969	5	0	2	0	0	2
44647	375987	5	0	0	0	0	0
44647	375988	5	0	0	0	0	0
44647	375995	5	0	0	0	0	0
44647	376000	5	1	0	0	0	1
44647	376003	5	0	0	0	0	0
44647	376009	5	1	1	0	0	2
44647	376022	5	1	0	0	0	1
44647	376027	5	2	3	0	0	5
44647	376028	5	0	1	1	0	2
44647	376029	5	0	0	0	0	0
44647	376042	5	3	2	1	2	8
44647	376047	5	2	2	0	0	4
44647	376054	5	0	0	0	0	0
44647	376055	5	0	1	0	0	1
44647	376067	5	1	0	0	0	1
44647	376068	5	3	1	1	1	6
44647	376071	5	0	0	0	0	0
44647	376074	5	1	5	0	0	6
44647	376088	5	1	1	0	0	2
44647	376100	5	0	1	0	0	1
44647	376101	5	0	2	0	1	3
44647	183496	4	1	0	0	0	1
44647	183957	4	0	1	0	0	1
44647	184888	4	1	2	0	2	5
44647	186812	4	2	0	0	0	2
44647	186975	4	0	3	0	0	3
44647	188954	4	0	2	0	1	3
44647	189863	4	1	0	0	0	1
44647	190039	4	0	0	0	1	1
44647	190313	4	0	1	0	0	1
44647	193307	4	0	2	0	0	2
44647	193598	4	0	2	0	1	3
44647	194331	4	1	2	0	0	3
44647	200654	4	1	2	0	0	3
44647	204867	4	1	1	0	0	2
44647	204900	4	1	0	0	1	2
44647	204939	4	1	0	0	0	1
44647	206291	4	0	0	0	0	0
44647	207341	4	1	0	0	0	1
44647	207590	4	3	1	1	0	5
44647	207907	4	1	1	0	0	2
44647	207968	4	0	1	0	3	4
44647	208847	4	0	0	0	0	0
44647	211212	4	0	1	0	1	2
44647	211993	4	1	1	0	3	5
44647	212016	4	2	1	0	1	4
44647	212450	4	2	1	0	0	3
44647	213664	4	0	0	0	0	0
44647	214219	4	1	1	0	1	3
44647	215253	4	1	0	0	0	1
44647	215779	4	0	0	0	0	0
44647	216027	4	0	0	0	0	0
44647	216078	4	1	1	0	1	3
44647	216693	4	1	0	0	0	1
44647	217056	4	1	0	0	0	1
44647	217897	4	0	1	0	0	1
44647	218002	4	0	0	0	0	0
44647	295130	4	1	0	0	0	1
44647	295134	4	1	0	0	0	1
44647	295135	4	0	2	0	0	2
44647	295138	4	0	1	0	0	1
44647	295139	4	1	1	0	0	2
44647	295142	4	0	3	1	1	5
44647	295144	4	0	1	0	0	1
44647	295148	4	1	2	0	0	3
44647	295152	4	1	2	0	2	5
44647	295154	4	1	1	0	1	3
44647	295163	4	1	0	0	0	1
44647	375842	4	1	0	0	0	1
44647	375849	4	1	0	0	0	1
44647	375877	4	1	4	0	1	6
44647	375897	4	1	3	0	1	5
44647	375908	4	1	0	0	0	1
44647	375913	4	0	1	0	0	1
44647	375918	4	1	1	0	0	2
44647	375924	4	2	2	0	0	4
44647	375927	4	0	2	0	0	2
44647	375932	4	0	0	1	0	1
44647	375940	4	1	2	0	2	5
44647	375955	4	3	0	0	0	3
44647	375962	4	1	0	0	0	1
44647	375978	4	0	2	0	0	2
44647	375980	4	0	0	0	0	0
44647	375981	4	1	1	0	0	2
44647	375985	4	1	0	0	0	1
44647	375989	4	0	2	0	0	2
44647	375990	4	2	0	0	0	2
44647	376001	4	0	1	0	0	1
44647	376004	4	1	0	0	1	2
44647	376008	4	2	0	0	0	2
44647	376023	4	2	0	1	0	3
44647	376032	4	2	1	0	2	5
44647	376043	4	0	0	0	0	0
44647	376045	4	1	1	1	1	4
44647	376046	4	0	1	1	1	3
44647	376049	4	1	1	0	0	2
44647	376056	4	0	1	0	2	3
44647	376062	4	0	0	0	0	0
44647	376080	4	2	0	0	0	2
44647	376087	4	1	2	0	0	3
44647	376094	4	1	0	0	0	1
44647	376103	4	0	0	0	0	0
44647	182732	3	0	0	0	0	0
44647	183826	3	2	0	0	0	2
44647	183848	3	1	0	0	0	1
44647	183973	3	1	2	0	0	3
44647	185629	3	1	0	0	0	1
44647	185725	3	0	1	0	0	1
44647	187014	3	1	1	0	0	2
44647	187228	3	0	0	1	0	1
44647	192412	3	0	2	0	0	2
44647	192434	3	0	0	0	0	0
44647	193636	3	1	0	0	0	1
44647	193978	3	0	2	0	0	2
44647	195535	3	0	1	1	0	2
44647	195797	3	1	0	0	0	1
44647	196049	3	0	0	1	0	1
44647	196083	3	1	3	0	0	4
44647	196792	3	0	0	0	0	0
44647	197888	3	0	0	0	0	0
44647	198078	3	1	0	0	0	1
44647	198263	3	1	1	0	0	2
44647	198380	3	1	2	0	1	4
44647	198435	3	0	1	0	1	2
44647	198440	3	0	1	0	0	1
44647	200865	3	0	2	0	0	2
44647	201315	3	1	2	0	0	3
44647	201951	3	1	2	0	0	3
44647	205360	3	1	2	0	0	3
44647	206013	3	1	0	0	0	1
44647	207268	3	2	0	0	0	2
44647	207299	3	1	1	0	0	2
44647	207447	3	0	0	0	0	0
44647	207478	3	0	1	0	0	1
44647	208346	3	2	2	0	0	4
44647	209331	3	0	2	0	0	2
44647	209413	3	0	0	1	1	2
44647	209685	3	1	3	0	0	4
44647	210017	3	1	3	0	0	4
44647	210736	3	0	1	0	0	1
44647	211802	3	1	2	0	1	4
44647	212796	3	0	1	0	0	1
44647	213323	3	1	1	0	0	2
44647	214363	3	0	1	0	0	1
44647	215264	3	2	2	0	0	4
44647	217361	3	0	0	0	0	0
44647	217419	3	0	1	0	0	1
44647	218693	3	0	0	0	0	0
44647	218827	3	2	0	0	0	2
44647	219853	3	0	0	0	0	0
44647	219993	3	0	4	0	0	4
44647	220031	3	1	0	0	1	2
44647	220368	3	0	0	0	0	0
44647	221935	3	1	0	0	1	2
44647	295131	3	1	0	0	0	1
44647	295133	3	0	2	0	0	2
44647	295143	3	0	0	0	0	0
44647	295146	3	0	1	0	0	1
44647	375841	3	0	0	0	0	0
44647	375843	3	0	1	0	1	2
44647	375846	3	1	2	0	1	4
44647	375860	3	0	2	0	0	2
44647	375862	3	1	1	0	0	2
44647	375864	3	0	2	0	2	4
44647	375866	3	0	0	0	0	0
44647	375869	3	4	0	0	0	4
44647	375874	3	1	3	0	0	4
44647	375878	3	0	0	0	0	0
44647	375879	3	1	1	0	0	2
44647	375881	3	1	0	0	0	1
44647	375883	3	0	2	0	0	2
44647	375895	3	1	0	0	0	1
44647	375904	3	0	1	0	0	1
44647	375905	3	0	2	0	0	2
44647	375914	3	0	1	0	0	1
44647	375921	3	0	0	0	0	0
44647	375926	3	0	1	0	0	1
44647	375929	3	0	1	0	1	2
44647	375930	3	0	1	0	1	2
44647	375935	3	0	0	0	0	0
44647	375937	3	0	1	0	0	1
44647	375949	3	0	0	0	0	0
44647	375950	3	0	0	0	0	0
44647	375951	3	1	0	0	0	1
44647	375956	3	0	1	0	0	1
44647	375961	3	0	2	0	0	2
44647	375966	3	0	0	0	0	0
44647	375973	3	0	1	0	1	2
44647	375975	3	1	1	0	1	3
44647	375977	3	0	1	0	1	2
44647	375979	3	1	1	0	1	3
44647	375991	3	0	3	0	0	3
44647	375992	3	0	0	0	0	0
44647	376006	3	0	0	0	0	0
44647	376010	3	0	1	0	0	1
44647	376013	3	1	2	0	0	3
44647	376036	3	0	0	0	0	0
44647	376039	3	1	1	0	0	2
44647	376060	3	1	1	0	0	2
44647	376072	3	1	1	0	0	2
44647	376073	3	0	0	0	0	0
44647	376083	3	1	0	0	0	1
44647	376089	3	0	1	0	0	1
44647	376092	3	1	0	1	1	3
44647	376095	3	0	0	0	0	0
44647	376098	3	0	1	0	0	1
44647	376102	3	1	1	0	0	2
44647	185489	2	1	0	0	0	1
44647	185614	2	0	1	0	0	1
44647	185919	2	1	1	0	0	2
44647	187122	2	2	0	0	0	2
44647	192458	2	0	1	0	0	1
44647	192794	2	2	0	0	0	2
44647	193056	2	0	0	0	0	0
44647	193684	2	0	1	0	0	1
44647	194344	2	0	0	0	0	0
44647	195923	2	0	0	0	0	0
44647	196022	2	1	4	0	0	5
44647	197209	2	0	2	0	0	2
44647	198720	2	0	1	0	0	1
44647	199152	2	1	1	0	0	2
44647	199861	2	0	0	0	0	0
44647	199986	2	0	1	0	0	1
44647	200016	2	0	1	0	0	1
44647	200080	2	1	1	1	0	3
44647	200295	2	1	0	0	0	1
44647	200817	2	1	0	0	0	1
44647	201271	2	0	0	0	0	0
44647	203036	2	0	2	0	0	2
44647	203232	2	1	1	0	0	2
44647	203332	2	0	0	0	1	1
44647	203407	2	0	2	0	0	2
44647	203816	2	0	0	0	0	0
44647	205010	2	0	1	0	0	1
44647	206073	2	0	1	0	0	1
44647	207177	2	0	0	0	0	0
44647	208892	2	1	4	0	0	5
44647	209777	2	0	3	0	0	3
44647	210766	2	0	0	0	0	0
44647	212352	2	0	0	0	0	0
44647	212935	2	0	1	0	0	1
44647	215709	2	0	0	0	0	0
44647	216608	2	0	1	0	0	1
44647	217073	2	1	0	0	0	1
44647	220097	2	0	0	0	0	0
44647	221094	2	0	1	0	2	3
44647	295150	2	0	0	0	0	0
44647	295160	2	0	1	0	0	1
44647	375832	2	0	1	0	0	1
44647	375834	2	0	0	0	0	0
44647	375837	2	1	1	0	0	2
44647	375838	2	0	2	0	0	2
44647	375845	2	2	4	0	0	6
44647	375848	2	1	1	0	0	2
44647	375856	2	0	3	0	0	3
44647	375857	2	0	1	0	1	2
44647	375868	2	0	0	0	0	0
44647	375882	2	0	0	1	0	1
44647	375884	2	0	1	0	0	1
44647	375888	2	1	0	0	0	1
44647	375917	2	0	0	0	1	1
44647	375931	2	0	2	0	0	2
44647	375934	2	1	2	0	0	3
44647	375938	2	0	0	0	0	0
44647	375964	2	0	0	0	0	0
44647	375967	2	0	0	0	0	0
44647	375972	2	0	2	0	0	2
44647	376015	2	0	1	0	2	3
44647	376024	2	0	1	0	0	1
44647	376025	2	0	1	0	0	1
44647	376040	2	0	0	0	0	0
44647	376050	2	0	0	0	0	0
44647	376053	2	1	0	0	0	1
44647	376059	2	0	2	0	0	2
44647	376065	2	0	4	0	0	4
44647	376070	2	0	0	0	0	0
44647	376084	2	1	0	0	0	1
44647	376096	2	1	0	0	1	2
44647	376097	2	0	0	0	0	0
44647	376099	2	0	0	0	1	1
44647	185321	1	0	0	0	0	0
44647	185478	1	0	0	0	1	1
44647	186273	1	0	0	0	0	0
44647	188485	1	0	0	0	0	0
44647	189137	1	0	0	0	0	0
44647	189609	1	0	0	0	0	0
44647	190036	1	0	0	0	0	0
44647	190081	1	0	0	0	0	0
44647	191242	1	1	0	0	0	1
44647	192782	1	2	0	0	0	2
44647	192855	1	1	1	0	0	2
44647	194288	1	0	1	0	0	1
44647	195864	1	1	0	0	0	1
44647	195952	1	0	0	0	0	0
44647	199851	1	0	1	0	0	1
44647	203077	1	0	3	0	0	3
44647	203339	1	1	1	0	0	2
44647	205323	1	0	0	0	0	0
44647	205979	1	0	1	0	0	1
44647	206703	1	0	1	0	0	1
44647	207598	1	0	0	1	0	1
44647	207822	1	0	3	0	2	5
44647	208799	1	1	0	0	0	1
44647	212384	1	0	0	0	0	0
44647	212510	1	0	0	0	0	0
44647	213325	1	0	0	0	0	0
44647	214037	1	0	0	0	0	0
44647	214450	1	0	0	0	0	0
44647	215350	1	0	0	0	0	0
44647	216247	1	0	1	0	0	1
44647	295125	1	0	1	0	0	1
44647	295145	1	0	0	0	0	0
44647	375830	1	0	0	0	1	1
44647	375835	1	0	0	0	0	0
44647	375836	1	0	1	0	0	1
44647	375847	1	0	0	0	0	0
44647	375865	1	0	0	0	0	0
44647	375867	1	1	2	0	0	3
44647	375871	1	0	0	0	0	0
44647	375885	1	0	0	0	0	0
44647	375906	1	1	1	0	0	2
44647	375943	1	0	0	0	0	0
44647	375952	1	1	0	0	0	1
44647	375954	1	0	0	0	0	0
44647	375963	1	1	2	0	0	3
44647	375968	1	0	0	0	0	0
44647	375970	1	0	2	0	0	2
44647	375983	1	0	1	0	0	1
44647	376051	1	0	1	0	0	1
44647	376058	1	0	0	0	0	0
44647	376066	1	0	0	0	0	0
44647	376075	1	1	0	0	0	1
44647	376091	1	1	0	0	0	1
120751	425894	51	4	4	0	1	9
120751	425889	42	1	8	2	1	12
120751	425890	33	2	6	2	3	13
120751	425895	26	4	2	7	3	16
120751	425919	15	4	3	1	0	8
120751	426068	14	2	1	0	0	3
120751	425973	13	3	2	0	2	7
120751	425918	12	3	2	2	0	7
120751	426152	12	1	0	0	1	2
120751	426320	12	0	1	0	2	3
120751	425984	11	1	4	0	0	5
120751	426011	11	3	5	0	2	10
120751	426111	11	5	0	1	0	6
120751	426226	10	2	1	0	0	3
120751	426227	10	1	0	0	0	1
120751	425904	9	1	1	0	0	2
120751	425977	9	1	1	0	0	2
120751	426147	9	3	2	0	2	7
120751	426216	9	0	3	0	0	3
120751	425952	8	0	2	1	0	3
120751	426067	8	0	0	0	0	0
120751	426076	8	0	1	0	2	3
120751	426144	8	0	2	0	1	3
120751	426154	8	1	1	0	1	3
120751	426155	8	3	1	0	0	4
120751	426167	8	2	3	0	1	6
120751	426207	8	1	0	0	1	2
120751	426234	8	3	1	0	0	4
120751	426248	8	0	1	0	0	1
120751	426291	8	1	0	2	1	4
120751	426310	8	2	2	0	0	4
120751	426426	8	1	0	0	1	2
120751	425887	7	0	0	0	0	0
120751	425899	7	0	0	0	0	0
120751	425946	7	1	0	0	7	8
120751	425968	7	1	0	0	1	2
120751	425991	7	2	0	0	0	2
120751	426012	7	0	0	1	0	1
120751	426050	7	0	3	0	1	4
120751	426091	7	4	0	0	0	4
120751	426127	7	1	0	0	0	1
120751	426237	7	3	3	0	0	6
120751	426240	7	2	1	1	0	4
120751	426268	7	1	1	0	0	2
120751	426276	7	2	0	0	0	2
120751	426293	7	1	2	1	0	4
120751	426299	7	1	2	0	0	3
120751	426302	7	2	1	0	1	4
120751	426303	7	0	0	0	0	0
120751	426376	7	1	1	0	0	2
120751	425877	6	2	3	0	0	5
120751	425880	6	3	0	0	0	3
120751	425883	6	1	2	0	1	4
120751	425901	6	0	0	0	1	1
120751	425905	6	2	3	0	1	6
120751	425926	6	2	1	0	0	3
120751	425957	6	0	0	0	0	0
120751	425958	6	2	2	0	0	4
120751	425960	6	1	1	0	0	2
120751	425963	6	0	0	0	0	0
120751	425964	6	0	1	0	0	1
120751	426032	6	1	2	0	1	4
120751	426090	6	1	1	0	0	2
120751	426094	6	1	2	0	0	3
120751	426128	6	3	1	0	0	4
120751	426131	6	1	0	1	1	3
120751	426173	6	2	2	0	0	4
120751	426179	6	0	0	0	1	1
120751	426180	6	0	0	0	0	0
120751	426206	6	0	2	0	0	2
120751	426210	6	1	3	0	0	4
120751	426213	6	0	1	0	1	2
120751	426217	6	2	0	0	0	2
120751	426228	6	1	0	0	1	2
120751	426256	6	0	0	0	0	0
120751	426266	6	2	2	0	0	4
120751	426278	6	1	2	0	1	4
120751	426279	6	1	0	0	2	3
120751	426289	6	0	0	0	0	0
120751	426313	6	1	3	0	0	4
120751	426337	6	0	1	0	0	1
120751	426351	6	3	0	1	0	4
120751	426352	6	1	0	0	0	1
120751	426356	6	2	1	0	0	3
120751	426365	6	0	0	0	1	1
120751	426368	6	0	0	0	1	1
120751	426371	6	4	1	1	1	7
120751	426382	6	0	1	0	0	1
120751	426394	6	2	1	0	0	3
120751	426397	6	2	3	0	0	5
120751	425892	5	4	2	0	2	8
120751	425903	5	0	2	1	0	3
120751	425907	5	1	0	0	0	1
120751	425908	5	0	2	0	0	2
120751	425916	5	0	3	0	0	3
120751	425923	5	1	2	0	1	4
120751	425932	5	1	1	0	2	4
120751	425933	5	3	0	0	1	4
120751	425938	5	0	3	0	0	3
120751	425951	5	1	1	0	0	2
120751	425974	5	1	1	0	0	2
120751	425978	5	1	0	0	0	1
120751	425986	5	1	1	0	0	2
120751	425998	5	0	0	2	0	2
120751	426008	5	2	1	0	0	3
120751	426009	5	2	1	0	0	3
120751	426018	5	1	1	0	0	2
120751	426031	5	0	1	0	0	1
120751	426034	5	1	1	0	1	3
120751	426038	5	1	1	0	0	2
120751	426040	5	0	3	0	0	3
120751	426042	5	1	0	1	1	3
120751	426043	5	2	1	0	0	3
120751	426044	5	3	0	0	0	3
120751	426046	5	4	1	0	0	5
120751	426072	5	0	0	1	0	1
120751	426073	5	0	2	0	1	3
120751	426084	5	6	1	0	0	7
120751	426097	5	2	1	0	0	3
120751	426100	5	1	0	0	1	2
120751	426103	5	0	2	0	0	2
120751	426109	5	1	3	0	0	4
120751	426123	5	0	2	0	4	6
120751	426137	5	1	0	0	2	3
120751	426138	5	3	1	0	0	4
120751	426149	5	0	0	0	1	1
120751	426151	5	1	1	0	0	2
120751	426159	5	1	1	0	0	2
120751	426162	5	0	1	0	0	1
120751	426170	5	1	0	0	0	1
120751	426178	5	2	0	0	0	2
120751	426194	5	1	1	0	0	2
120751	426195	5	1	1	0	0	2
120751	426204	5	2	0	0	0	2
120751	426235	5	0	0	0	0	0
120751	426246	5	0	0	0	0	0
120751	426259	5	0	0	0	1	1
120751	426260	5	1	0	0	0	1
120751	426262	5	3	4	1	0	8
120751	426263	5	1	2	0	0	3
120751	426267	5	0	0	0	1	1
120751	426275	5	1	2	0	0	3
120751	426296	5	1	1	1	0	3
120751	426305	5	4	1	0	0	5
120751	426308	5	0	1	0	0	1
120751	426312	5	2	1	0	0	3
120751	426323	5	3	1	0	0	4
120751	426330	5	1	1	0	0	2
120751	426350	5	0	2	0	0	2
120751	426362	5	0	0	1	1	2
120751	426377	5	0	0	0	0	0
120751	426381	5	0	0	0	0	0
120751	426385	5	1	2	0	0	3
120751	426402	5	0	0	0	0	0
120751	426404	5	0	1	0	1	2
120751	426408	5	0	2	1	0	3
120751	426413	5	1	0	0	0	1
120751	426419	5	1	0	0	0	1
120751	426421	5	1	0	0	0	1
120751	426432	5	0	1	0	0	1
120751	426433	5	1	3	0	1	5
120751	425885	4	1	2	0	0	3
120751	425886	4	0	1	0	0	1
120751	425891	4	0	2	0	2	4
120751	425911	4	2	2	0	2	6
120751	425912	4	2	3	0	1	6
120751	425921	4	0	2	1	0	3
120751	425940	4	0	0	0	0	0
120751	425948	4	2	1	0	1	4
120751	425950	4	0	1	0	0	1
120751	425959	4	0	1	0	0	1
120751	425962	4	0	1	0	0	1
120751	425971	4	0	0	1	0	1
120751	425980	4	0	0	0	1	1
120751	425983	4	1	2	0	0	3
120751	425990	4	4	1	0	0	5
120751	425995	4	1	1	0	0	2
120751	425996	4	2	1	0	0	3
120751	425997	4	0	1	0	0	1
120751	426000	4	1	0	0	0	1
120751	426007	4	2	1	0	1	4
120751	426015	4	1	0	0	1	2
120751	426017	4	1	0	0	0	1
120751	426022	4	1	0	0	0	1
120751	426024	4	1	1	0	2	4
120751	426033	4	1	1	0	0	2
120751	426036	4	3	0	0	1	4
120751	426037	4	1	0	0	0	1
120751	426039	4	0	1	0	0	1
120751	426045	4	0	2	0	0	2
120751	426053	4	3	1	0	0	4
120751	426055	4	1	1	0	0	2
120751	426056	4	1	1	0	1	3
120751	426061	4	1	0	0	0	1
120751	426064	4	1	0	0	1	2
120751	426070	4	1	0	0	0	1
120751	426071	4	0	2	0	0	2
120751	426080	4	1	0	0	1	2
120751	426082	4	0	2	0	0	2
120751	426088	4	0	1	0	0	1
120751	426089	4	2	1	0	0	3
120751	426120	4	1	3	0	1	5
120751	426129	4	0	2	0	0	2
120751	426130	4	1	0	0	0	1
120751	426133	4	2	0	0	0	2
120751	426140	4	1	3	0	0	4
120751	426142	4	1	1	1	1	4
120751	426148	4	1	0	0	0	1
120751	426161	4	1	2	0	0	3
120751	426172	4	1	1	0	0	2
120751	426182	4	1	0	0	0	1
120751	426189	4	0	0	0	0	0
120751	426192	4	2	0	0	0	2
120751	426200	4	0	2	0	1	3
120751	426202	4	2	2	0	0	4
120751	426222	4	2	0	0	0	2
120751	426233	4	2	0	0	0	2
120751	426236	4	1	1	1	0	3
120751	426238	4	1	0	0	0	1
120751	426243	4	0	2	0	0	2
120751	426250	4	1	3	0	0	4
120751	426254	4	1	1	0	0	2
120751	426258	4	1	1	0	1	3
120751	426261	4	1	3	0	0	4
120751	426271	4	2	0	0	0	2
120751	426272	4	1	0	0	0	1
120751	426274	4	0	0	0	0	0
120751	426277	4	0	1	0	0	1
120751	426283	4	2	0	0	0	2
120751	426292	4	2	4	0	0	6
120751	426295	4	0	2	0	1	3
120751	426319	4	0	2	0	0	2
120751	426321	4	0	1	0	0	1
120751	426334	4	1	2	0	1	4
120751	426338	4	3	1	0	0	4
120751	426341	4	1	1	0	0	2
120751	426347	4	0	1	0	0	1
120751	426349	4	1	0	1	2	4
120751	426353	4	0	0	0	0	0
120751	426359	4	0	2	0	0	2
120751	426364	4	1	1	0	0	2
120751	426366	4	0	2	0	1	3
120751	426369	4	0	1	0	1	2
120751	426370	4	1	1	0	0	2
120751	426378	4	0	2	1	0	3
120751	426386	4	1	0	0	0	1
120751	426388	4	3	0	0	0	3
120751	426390	4	2	1	0	0	3
120751	426393	4	0	0	0	0	0
120751	426395	4	1	3	0	0	4
120751	426398	4	0	0	0	2	2
120751	426400	4	1	1	0	0	2
120751	426403	4	0	0	0	0	0
120751	426414	4	0	1	0	0	1
120751	426415	4	1	1	0	0	2
120751	426416	4	1	2	0	0	3
120751	426429	4	2	3	0	2	7
120751	425879	3	0	0	0	0	0
120751	425881	3	1	3	0	0	4
120751	425898	3	3	1	2	0	6
120751	425900	3	2	0	0	0	2
120751	425906	3	1	2	0	0	3
120751	425915	3	1	0	0	0	1
120751	425922	3	1	1	0	1	3
120751	425924	3	1	1	0	0	2
120751	425925	3	0	1	1	1	3
120751	425930	3	4	1	0	0	5
120751	425934	3	1	3	0	1	5
120751	425935	3	3	0	0	0	3
120751	425942	3	0	1	0	0	1
120751	425945	3	1	0	0	1	2
120751	425947	3	1	0	0	0	1
120751	425953	3	1	0	0	0	1
120751	425954	3	1	0	0	0	1
120751	425955	3	0	3	0	0	3
120751	425956	3	0	0	0	0	0
120751	425965	3	0	0	0	2	2
120751	425966	3	0	0	0	1	1
120751	425967	3	0	0	0	0	0
120751	425970	3	1	1	1	0	3
120751	425972	3	0	2	0	0	2
120751	425975	3	2	0	0	0	2
120751	425976	3	1	0	0	0	1
120751	425979	3	1	1	0	3	5
120751	425981	3	2	0	0	0	2
120751	425985	3	1	0	0	0	1
120751	425992	3	0	0	0	0	0
120751	425993	3	0	2	0	0	2
120751	425994	3	0	2	0	0	2
120751	425999	3	1	2	0	0	3
120751	426002	3	1	1	0	0	2
120751	426005	3	0	0	0	0	0
120751	426016	3	0	0	0	0	0
120751	426019	3	0	1	0	0	1
120751	426020	3	1	0	0	0	1
120751	426025	3	2	2	0	0	4
120751	426026	3	1	0	0	0	1
120751	426029	3	1	0	0	0	1
120751	426035	3	1	0	1	0	2
120751	426047	3	1	0	0	0	1
120751	426054	3	0	2	1	0	3
120751	426059	3	2	2	0	0	4
120751	426060	3	0	0	1	0	1
120751	426063	3	0	1	0	0	1
120751	426069	3	0	3	0	0	3
120751	426092	3	0	0	0	0	0
120751	426095	3	1	1	0	0	2
120751	426104	3	1	0	0	0	1
120751	426110	3	0	3	0	0	3
120751	426119	3	0	2	0	0	2
120751	426122	3	0	1	0	1	2
120751	426124	3	0	2	0	0	2
120751	426125	3	1	1	0	0	2
120751	426126	3	1	3	0	0	4
120751	426134	3	2	1	0	0	3
120751	426136	3	0	0	0	1	1
120751	426146	3	1	3	0	1	5
120751	426150	3	1	2	0	0	3
120751	426153	3	0	0	1	0	1
120751	426156	3	2	2	0	0	4
120751	426158	3	0	0	0	0	0
120751	426168	3	1	0	0	0	1
120751	426176	3	0	0	0	0	0
120751	426177	3	1	0	0	0	1
120751	426183	3	0	0	0	3	3
120751	426184	3	0	0	0	0	0
120751	426186	3	1	0	0	0	1
120751	426188	3	1	1	0	0	2
120751	426191	3	1	0	1	0	2
120751	426193	3	1	0	0	0	1
120751	426196	3	0	0	1	0	1
120751	426199	3	1	0	0	0	1
120751	426209	3	0	1	0	0	1
120751	426211	3	1	1	0	1	3
120751	426212	3	0	1	0	0	1
120751	426215	3	0	1	0	1	2
120751	426218	3	1	1	0	1	3
120751	426220	3	1	0	0	0	1
120751	426229	3	3	1	0	0	4
120751	426231	3	3	0	0	1	4
120751	426232	3	1	2	0	0	3
120751	426239	3	0	0	0	0	0
120751	426242	3	0	0	0	1	1
120751	426244	3	1	0	0	0	1
120751	426247	3	1	1	0	0	2
120751	426251	3	2	1	0	0	3
120751	426253	3	1	0	0	0	1
120751	426257	3	0	0	2	0	2
120751	426265	3	2	0	0	0	2
120751	426270	3	0	1	0	1	2
120751	426273	3	0	0	0	0	0
120751	426281	3	1	1	0	0	2
120751	426284	3	1	0	0	0	1
120751	426285	3	1	2	0	0	3
120751	426286	3	1	0	0	0	1
120751	426287	3	2	0	0	0	2
120751	426294	3	0	1	1	2	4
120751	426298	3	0	1	0	0	1
120751	426307	3	0	0	0	0	0
120751	426309	3	0	0	0	0	0
120751	426322	3	0	1	0	0	1
120751	426325	3	1	1	0	0	2
120751	426327	3	0	0	0	0	0
120751	426333	3	1	1	0	0	2
120751	426335	3	0	1	0	1	2
120751	426343	3	0	0	0	0	0
120751	426344	3	1	1	0	0	2
120751	426345	3	0	0	0	0	0
120751	426348	3	0	0	0	0	0
120751	426358	3	0	1	0	0	1
120751	426373	3	1	1	0	0	2
120751	426375	3	0	0	0	0	0
120751	426380	3	1	2	0	0	3
120751	426383	3	2	0	0	0	2
120751	426399	3	1	3	0	0	4
120751	426409	3	1	1	0	0	2
120751	426410	3	0	0	0	0	0
120751	426411	3	1	0	0	0	1
120751	426422	3	0	1	0	0	1
120751	425884	2	1	0	0	0	1
120751	425893	2	0	1	0	0	1
120751	425896	2	1	0	0	1	2
120751	425897	2	0	1	0	0	1
120751	425902	2	0	0	0	0	0
120751	425909	2	2	1	0	0	3
120751	425910	2	2	0	0	0	2
120751	425917	2	1	0	0	1	2
120751	425920	2	0	1	0	0	1
120751	425927	2	0	2	0	0	2
120751	425931	2	0	1	0	0	1
120751	425936	2	0	1	0	2	3
120751	425943	2	0	0	1	0	1
120751	425944	2	1	0	0	0	1
120751	425949	2	2	1	0	0	3
120751	425961	2	0	1	0	0	1
120751	425982	2	0	1	0	0	1
120751	425987	2	1	1	0	0	2
120751	425989	2	2	2	0	0	4
120751	426003	2	1	0	0	0	1
120751	426010	2	1	1	0	0	2
120751	426014	2	0	1	0	0	1
120751	426023	2	2	1	0	0	3
120751	426027	2	1	1	0	2	4
120751	426028	2	0	0	0	0	0
120751	426041	2	1	0	0	0	1
120751	426052	2	1	1	0	0	2
120751	426058	2	0	0	0	0	0
120751	426062	2	2	3	0	0	5
120751	426074	2	0	0	0	0	0
120751	426075	2	1	0	0	0	1
120751	426078	2	1	2	0	1	4
120751	426079	2	0	1	0	0	1
120751	426083	2	0	1	0	0	1
120751	426085	2	2	0	0	0	2
120751	426093	2	0	0	0	0	0
120751	426096	2	0	0	0	0	0
120751	426098	2	0	0	0	0	0
120751	426099	2	1	1	0	0	2
120751	426101	2	1	2	0	0	3
120751	426102	2	2	1	0	0	3
120751	426105	2	0	0	0	0	0
120751	426106	2	2	1	0	0	3
120751	426107	2	1	1	0	0	2
120751	426108	2	1	0	0	0	1
120751	426114	2	1	0	0	0	1
120751	426115	2	1	0	0	0	1
120751	426116	2	0	0	0	1	1
120751	426117	2	0	2	0	0	2
120751	426118	2	2	0	0	0	2
120751	426121	2	1	3	0	1	5
120751	426132	2	0	0	0	1	1
120751	426135	2	0	1	0	0	1
120751	426139	2	0	2	0	0	2
120751	426143	2	0	1	0	0	1
120751	426157	2	0	1	0	0	1
120751	426160	2	0	2	0	0	2
120751	426163	2	0	2	0	0	2
120751	426164	2	0	2	0	0	2
120751	426166	2	1	1	0	1	3
120751	426169	2	0	0	0	0	0
120751	426171	2	0	1	0	0	1
120751	426174	2	0	1	2	0	3
120751	426175	2	3	1	0	0	4
120751	426187	2	1	0	0	0	1
120751	426190	2	1	0	0	0	1
120751	426197	2	0	0	0	1	1
120751	426198	2	0	1	0	0	1
120751	426201	2	0	0	0	0	0
120751	426203	2	0	0	2	0	2
120751	426205	2	0	0	0	0	0
120751	426208	2	1	1	0	0	2
120751	426214	2	0	1	0	0	1
120751	426221	2	1	0	0	0	1
120751	426223	2	0	1	0	0	1
120751	426224	2	0	1	0	0	1
120751	426225	2	0	1	0	0	1
120751	426249	2	0	0	0	0	0
120751	426255	2	0	1	0	1	2
120751	426264	2	0	2	0	0	2
120751	426269	2	0	0	0	0	0
120751	426280	2	0	1	0	0	1
120751	426282	2	0	0	0	1	1
120751	426288	2	0	1	0	0	1
120751	426290	2	2	0	0	0	2
120751	426297	2	0	0	0	0	0
120751	426300	2	1	0	0	0	1
120751	426301	2	0	1	0	0	1
120751	426306	2	1	1	0	0	2
120751	426311	2	0	0	0	0	0
120751	426314	2	0	1	0	0	1
120751	426315	2	1	0	0	0	1
120751	426316	2	0	0	0	0	0
120751	426317	2	2	1	0	0	3
120751	426318	2	1	0	0	0	1
120751	426324	2	0	0	0	0	0
120751	426328	2	1	0	0	0	1
120751	426336	2	1	1	0	0	2
120751	426339	2	1	1	0	0	2
120751	426340	2	0	1	0	0	1
120751	426342	2	1	0	1	0	2
120751	426346	2	0	0	2	1	3
120751	426354	2	0	0	0	0	0
120751	426355	2	0	0	0	1	1
120751	426357	2	1	0	0	0	1
120751	426360	2	1	1	0	0	2
120751	426361	2	1	1	0	0	2
120751	426363	2	0	0	0	0	0
120751	426367	2	0	0	0	0	0
120751	426372	2	0	1	0	0	1
120751	426374	2	0	0	0	0	0
120751	426379	2	2	1	0	0	3
120751	426384	2	2	1	0	0	3
120751	426387	2	1	0	0	1	2
120751	426396	2	2	1	0	0	3
120751	426401	2	2	1	0	0	3
120751	426405	2	2	0	0	0	2
120751	426406	2	0	3	0	0	3
120751	426407	2	3	1	0	0	4
120751	426412	2	0	0	0	0	0
120751	426417	2	1	0	0	0	1
120751	426418	2	0	1	0	0	1
120751	426423	2	1	2	0	0	3
120751	426424	2	0	1	0	0	1
120751	426428	2	0	1	0	0	1
120751	426430	2	0	2	0	0	2
120751	425878	1	0	1	0	0	1
120751	425882	1	0	2	0	0	2
120751	425888	1	0	1	0	0	1
120751	425913	1	1	0	0	0	1
120751	425914	1	0	1	0	0	1
120751	425928	1	0	2	0	0	2
120751	425929	1	0	1	0	0	1
120751	425937	1	2	0	0	0	2
120751	425939	1	0	0	0	0	0
120751	425941	1	0	0	0	1	1
120751	425969	1	0	0	0	0	0
120751	425988	1	0	0	0	0	0
120751	426001	1	0	1	0	0	1
120751	426004	1	1	0	0	2	3
120751	426006	1	0	0	0	0	0
120751	426013	1	0	0	0	0	0
120751	426021	1	0	1	0	0	1
120751	426030	1	0	1	0	0	1
120751	426048	1	0	0	0	0	0
120751	426049	1	0	1	0	0	1
120751	426051	1	0	1	0	0	1
120751	426057	1	0	1	0	1	2
120751	426065	1	2	1	0	0	3
120751	426066	1	0	3	0	1	4
120751	426077	1	0	1	1	1	3
120751	426081	1	2	1	0	0	3
120751	426086	1	0	2	0	0	2
120751	426087	1	0	1	0	0	1
120751	426112	1	0	0	0	1	1
120751	426113	1	0	1	0	0	1
120751	426141	1	1	0	0	0	1
120751	426145	1	0	0	0	1	1
120751	426165	1	0	2	0	1	3
120751	426181	1	1	2	0	0	3
120751	426185	1	0	1	0	0	1
120751	426219	1	0	0	0	0	0
120751	426230	1	0	1	0	0	1
120751	426241	1	0	1	0	0	1
120751	426245	1	0	0	0	0	0
120751	426252	1	2	0	0	0	2
120751	426304	1	0	0	0	0	0
120751	426326	1	0	1	0	1	2
120751	426329	1	0	1	0	0	1
120751	426331	1	0	0	0	0	0
120751	426332	1	1	1	1	0	3
120751	426389	1	0	0	0	0	0
120751	426391	1	2	2	0	0	4
120751	426392	1	0	2	0	0	2
120751	426420	1	0	2	0	0	2
120751	426425	1	0	0	0	0	0
120751	426427	1	0	0	0	0	0
120751	426431	1	0	1	0	0	1
125111	460408	48	3	2	1	2	8
125111	460428	30	2	1	2	7	12
125111	460392	22	0	1	0	2	3
125111	460097	20	0	0	1	0	1
125111	460107	19	1	0	1	0	2
125111	460416	16	2	2	0	0	4
125111	460437	15	0	0	0	0	0
125111	460407	13	2	4	0	0	6
125111	460226	11	1	2	0	0	3
125111	460391	11	0	3	1	0	4
125111	460394	11	0	0	1	0	1
125111	460000	10	2	2	0	0	4
125111	460389	10	3	1	0	0	4
125111	460425	10	1	2	0	0	3
125111	460432	10	0	0	2	0	2
125111	460222	9	1	0	0	1	2
125111	460390	9	3	3	0	0	6
125111	460442	9	0	1	3	0	4
125111	460454	9	1	1	0	0	2
125111	459945	8	2	3	1	1	7
125111	460439	8	0	2	0	0	2
125111	460440	8	0	0	0	0	0
125111	460443	8	0	0	0	0	0
125111	460081	7	2	4	0	0	6
125111	460108	7	1	1	0	1	3
125111	460112	7	2	0	0	0	2
125111	460221	7	2	2	0	0	4
125111	460350	7	0	0	0	1	1
125111	460353	7	1	2	0	0	3
125111	460397	7	3	2	1	0	6
125111	460427	7	1	2	1	2	6
125111	459949	6	1	1	0	1	3
125111	459971	6	0	0	0	0	0
125111	460055	6	1	3	0	0	4
125111	460091	6	3	0	0	0	3
125111	460205	6	1	0	0	0	1
125111	460209	6	0	1	0	1	2
125111	460299	6	0	0	0	0	0
125111	460332	6	0	2	0	0	2
125111	460347	6	0	2	0	1	3
125111	460396	6	1	2	0	1	4
125111	460409	6	0	0	0	1	1
125111	460414	6	0	1	0	0	1
125111	460434	6	3	0	0	0	3
125111	460445	6	1	1	0	0	2
125111	460449	6	0	0	0	0	0
125111	460457	6	0	3	0	0	3
125111	460459	6	1	0	0	0	1
125111	459957	5	0	0	0	0	0
125111	459976	5	1	1	0	0	2
125111	460085	5	0	1	0	0	1
125111	460129	5	1	0	0	0	1
125111	460219	5	1	1	0	0	2
125111	460283	5	0	5	2	1	8
125111	460317	5	1	0	0	0	1
125111	460356	5	0	3	0	0	3
125111	460395	5	0	2	1	0	3
125111	460400	5	1	2	2	1	6
125111	460421	5	1	2	0	0	3
125111	460430	5	1	2	0	1	4
125111	460448	5	0	0	0	0	0
125111	459932	4	0	0	0	0	0
125111	459965	4	0	2	0	1	3
125111	459973	4	0	1	0	0	1
125111	459981	4	0	1	1	0	2
125111	460013	4	2	0	1	1	4
125111	460018	4	1	0	0	0	1
125111	460022	4	0	1	0	0	1
125111	460034	4	1	0	0	0	1
125111	460065	4	0	0	0	0	0
125111	460090	4	1	0	0	0	1
125111	460176	4	0	2	1	1	4
125111	460196	4	0	1	0	0	1
125111	460200	4	0	0	1	0	1
125111	460212	4	1	0	0	0	1
125111	460220	4	2	1	0	1	4
125111	460224	4	1	0	0	0	1
125111	460231	4	1	2	0	0	3
125111	460238	4	1	0	1	0	2
125111	460242	4	0	3	0	1	4
125111	460243	4	1	2	0	0	3
125111	460256	4	0	0	0	1	1
125111	460263	4	2	0	0	0	2
125111	460267	4	0	1	0	0	1
125111	460269	4	0	0	0	1	1
125111	460275	4	1	0	1	1	3
125111	460303	4	0	1	0	0	1
125111	460333	4	0	0	0	0	0
125111	460334	4	1	0	1	0	2
125111	460337	4	1	2	0	1	4
125111	460338	4	1	0	0	1	2
125111	460340	4	0	0	1	0	1
125111	460348	4	0	2	1	0	3
125111	460349	4	0	1	0	0	1
125111	460359	4	0	0	0	0	0
125111	460382	4	0	1	0	0	1
125111	460393	4	1	2	0	0	3
125111	460398	4	1	0	0	0	1
125111	460401	4	0	2	0	0	2
125111	460403	4	0	0	0	0	0
125111	460406	4	0	1	0	0	1
125111	460417	4	0	1	1	1	3
125111	460419	4	1	2	0	0	3
125111	460420	4	0	2	0	0	2
125111	460422	4	0	0	0	1	1
125111	460438	4	0	0	0	1	1
125111	460444	4	0	0	0	1	1
125111	460455	4	0	0	0	1	1
125111	460461	4	0	0	0	0	0
125111	460463	4	2	0	0	0	2
125111	459926	3	0	3	0	0	3
125111	459934	3	2	0	0	0	2
125111	459938	3	2	0	0	2	4
125111	459956	3	0	1	0	1	2
125111	459960	3	1	1	0	0	2
125111	459961	3	0	2	0	0	2
125111	459974	3	0	2	0	0	2
125111	460006	3	0	2	0	0	2
125111	460011	3	0	1	0	1	2
125111	460012	3	0	1	0	0	1
125111	460029	3	0	0	0	0	0
125111	460033	3	1	1	0	0	2
125111	460038	3	0	1	0	0	1
125111	460043	3	1	0	1	0	2
125111	460044	3	1	1	0	0	2
125111	460051	3	0	0	0	0	0
125111	460066	3	1	1	0	0	2
125111	460073	3	0	1	0	0	1
125111	460074	3	0	1	0	0	1
125111	460099	3	0	1	1	2	4
125111	460102	3	0	4	1	0	5
125111	460106	3	0	1	0	0	1
125111	460115	3	0	0	1	0	1
125111	460120	3	1	1	0	1	3
125111	460124	3	0	1	0	0	1
125111	460125	3	0	2	0	0	2
125111	460155	3	0	0	0	0	0
125111	460160	3	0	0	0	0	0
125111	460168	3	0	1	0	0	1
125111	460172	3	0	0	0	0	0
125111	460174	3	0	0	1	0	1
125111	460180	3	0	0	0	1	1
125111	460183	3	0	1	0	0	1
125111	460192	3	0	0	1	0	1
125111	460207	3	0	1	0	1	2
125111	460208	3	1	0	0	0	1
125111	460210	3	1	2	0	0	3
125111	460215	3	1	1	0	0	2
125111	460227	3	0	1	0	0	1
125111	460228	3	1	1	0	0	2
125111	460230	3	0	0	1	0	1
125111	460234	3	0	1	0	0	1
125111	460250	3	0	1	0	0	1
125111	460251	3	0	0	0	0	0
125111	460254	3	0	0	0	0	0
125111	460266	3	1	1	0	1	3
125111	460272	3	0	1	0	1	2
125111	460279	3	0	1	0	0	1
125111	460280	3	0	4	0	0	4
125111	460289	3	1	1	0	0	2
125111	460294	3	0	0	0	0	0
125111	460307	3	0	3	2	0	5
125111	460336	3	0	0	0	0	0
125111	460352	3	1	0	0	0	1
125111	460361	3	0	1	0	1	2
125111	460379	3	0	0	0	1	1
125111	460399	3	0	2	0	0	2
125111	460402	3	0	0	0	0	0
125111	460404	3	2	0	1	1	4
125111	460410	3	0	2	0	0	2
125111	460411	3	0	1	0	0	1
125111	460413	3	2	0	0	0	2
125111	460415	3	1	1	0	1	3
125111	460418	3	0	2	0	0	2
125111	460441	3	0	0	0	0	0
125111	460450	3	1	1	0	0	2
125111	460465	3	1	0	0	0	1
125111	459920	2	0	1	0	0	1
125111	459921	2	1	1	0	0	2
125111	459923	2	0	0	0	0	0
125111	459927	2	1	2	0	0	3
125111	459928	2	0	0	0	1	1
125111	459929	2	0	1	0	0	1
125111	459930	2	0	0	0	0	0
125111	459931	2	0	0	0	0	0
125111	459936	2	0	0	0	0	0
125111	459943	2	1	0	0	0	1
125111	459944	2	0	1	0	3	4
125111	459948	2	0	0	1	0	1
125111	459951	2	0	0	0	1	1
125111	459953	2	1	0	0	0	1
125111	459955	2	0	0	0	0	0
125111	459963	2	0	3	0	0	3
125111	459964	2	0	0	0	0	0
125111	459966	2	0	0	0	2	2
125111	459972	2	0	0	2	0	2
125111	459977	2	0	1	0	0	1
125111	459978	2	1	0	0	1	2
125111	459979	2	0	2	0	0	2
125111	459983	2	1	0	0	0	1
125111	459984	2	1	4	0	0	5
125111	459985	2	0	1	0	0	1
125111	459991	2	1	0	0	0	1
125111	459993	2	1	0	0	0	1
125111	459994	2	1	0	0	0	1
125111	459995	2	0	0	0	0	0
125111	459997	2	0	0	0	0	0
125111	459998	2	0	1	0	0	1
125111	460002	2	0	1	0	0	1
125111	460005	2	0	1	0	0	1
125111	460015	2	1	0	0	0	1
125111	460019	2	0	0	0	0	0
125111	460020	2	1	0	0	0	1
125111	460028	2	1	0	0	1	2
125111	460030	2	0	0	0	0	0
125111	460037	2	0	0	0	0	0
125111	460041	2	0	1	0	0	1
125111	460042	2	1	1	0	0	2
125111	460046	2	0	0	1	0	1
125111	460047	2	0	0	0	0	0
125111	460049	2	0	0	0	0	0
125111	460052	2	0	1	0	1	2
125111	460056	2	0	0	0	0	0
125111	460058	2	1	1	1	0	3
125111	460059	2	1	0	1	0	2
125111	460061	2	0	1	0	0	1
125111	460072	2	0	0	1	0	1
125111	460075	2	1	3	0	0	4
125111	460077	2	1	2	0	0	3
125111	460079	2	0	0	0	1	1
125111	460082	2	0	0	0	0	0
125111	460086	2	1	0	0	0	1
125111	460093	2	1	1	0	0	2
125111	460094	2	1	0	0	0	1
125111	460095	2	1	0	0	0	1
125111	460113	2	0	0	1	0	1
125111	460121	2	0	1	0	0	1
125111	460122	2	1	1	0	1	3
125111	460127	2	1	2	0	1	4
125111	460128	2	1	0	0	0	1
125111	460136	2	1	0	0	0	1
125111	460137	2	0	2	1	0	3
125111	460143	2	0	0	0	0	0
125111	460146	2	0	0	1	0	1
125111	460148	2	0	0	0	0	0
125111	460149	2	0	0	1	1	2
125111	460151	2	0	0	0	0	0
125111	460153	2	1	2	0	0	3
125111	460156	2	0	1	0	1	2
125111	460159	2	0	1	0	0	1
125111	460163	2	0	0	1	0	1
125111	460165	2	1	0	0	0	1
125111	460166	2	1	0	0	0	1
125111	460169	2	0	1	0	0	1
125111	460170	2	0	0	1	0	1
125111	460171	2	0	0	1	1	2
125111	460173	2	0	0	0	0	0
125111	460178	2	0	1	0	0	1
125111	460184	2	0	2	0	0	2
125111	460187	2	0	0	0	0	0
125111	460188	2	0	0	0	0	0
125111	460189	2	0	2	0	2	4
125111	460191	2	0	1	0	0	1
125111	460194	2	0	0	0	0	0
125111	460201	2	1	0	0	1	2
125111	460203	2	0	0	0	0	0
125111	460204	2	0	0	1	0	1
125111	460211	2	1	0	0	0	1
125111	460235	2	0	0	0	1	1
125111	460237	2	0	0	0	2	2
125111	460241	2	1	0	0	0	1
125111	460244	2	0	2	0	0	2
125111	460248	2	0	0	1	0	1
125111	460253	2	0	0	0	0	0
125111	460258	2	0	0	0	0	0
125111	460260	2	1	1	0	0	2
125111	460261	2	1	0	0	1	2
125111	460264	2	0	1	0	1	2
125111	460270	2	0	1	0	0	1
125111	460287	2	0	3	0	0	3
125111	460292	2	0	1	0	0	1
125111	460296	2	0	0	0	0	0
125111	460305	2	1	0	0	0	1
125111	460306	2	0	2	0	0	2
125111	460311	2	0	0	0	0	0
125111	460314	2	0	0	0	2	2
125111	460316	2	1	0	0	1	2
125111	460321	2	1	1	0	0	2
125111	460325	2	0	0	0	0	0
125111	460326	2	0	0	2	1	3
125111	460328	2	0	1	0	0	1
125111	460329	2	1	0	0	0	1
125111	460331	2	0	0	0	0	0
125111	460344	2	0	1	0	1	2
125111	460345	2	0	1	0	0	1
125111	460346	2	0	0	0	0	0
125111	460354	2	0	0	0	0	0
125111	460358	2	0	1	0	0	1
125111	460360	2	0	1	0	0	1
125111	460362	2	0	0	2	0	2
125111	460364	2	0	0	0	1	1
125111	460365	2	0	0	0	0	0
125111	460366	2	1	0	0	0	1
125111	460369	2	0	0	0	0	0
125111	460372	2	0	0	0	0	0
125111	460374	2	0	1	0	0	1
125111	460375	2	0	0	0	2	2
125111	460383	2	0	1	1	1	3
125111	460386	2	0	0	0	0	0
125111	460388	2	0	1	0	1	2
125111	460424	2	0	1	1	0	2
125111	460431	2	1	0	0	0	1
125111	460446	2	1	0	0	0	1
125111	460452	2	2	0	0	0	2
125111	460456	2	0	0	0	0	0
125111	460458	2	0	1	0	0	1
125111	460462	2	0	0	0	1	1
125111	459918	1	0	0	0	0	0
125111	459919	1	0	0	0	0	0
125111	459922	1	0	0	1	0	1
125111	459924	1	0	2	0	0	2
125111	459925	1	1	0	0	0	1
125111	459933	1	1	1	0	1	3
125111	459935	1	0	0	0	0	0
125111	459937	1	0	0	0	0	0
125111	459939	1	0	0	0	0	0
125111	459940	1	0	1	0	0	1
125111	459941	1	0	1	0	0	1
125111	459942	1	1	0	1	0	2
125111	459946	1	0	0	0	1	1
125111	459947	1	0	0	1	1	2
125111	459950	1	0	0	0	0	0
125111	459952	1	0	0	0	0	0
125111	459954	1	0	0	0	1	1
125111	459958	1	0	0	0	0	0
125111	459959	1	0	1	0	0	1
125111	459962	1	0	1	0	0	1
125111	459967	1	1	0	0	0	1
125111	459968	1	0	0	0	0	0
125111	459969	1	0	0	0	1	1
125111	459970	1	0	0	0	0	0
125111	459975	1	0	1	0	0	1
125111	459980	1	0	0	0	0	0
125111	459982	1	0	0	1	0	1
125111	459986	1	0	0	0	0	0
125111	459987	1	0	0	0	0	0
125111	459988	1	2	0	0	0	2
125111	459989	1	0	1	0	0	1
125111	459990	1	0	0	0	0	0
125111	459992	1	0	0	1	0	1
125111	459996	1	0	0	0	0	0
125111	459999	1	0	0	1	0	1
125111	460001	1	0	0	0	0	0
125111	460003	1	1	0	0	0	1
125111	460004	1	1	1	0	1	3
125111	460007	1	0	0	0	1	1
125111	460008	1	0	0	0	1	1
125111	460009	1	0	0	0	0	0
125111	460010	1	0	0	0	0	0
125111	460014	1	1	0	0	0	1
125111	460016	1	0	0	0	0	0
125111	460017	1	0	0	0	0	0
125111	460021	1	0	0	0	0	0
125111	460023	1	1	0	1	0	2
125111	460024	1	0	0	0	0	0
125111	460025	1	0	0	0	0	0
125111	460026	1	0	0	1	1	2
125111	460027	1	0	0	0	0	0
125111	460031	1	0	1	0	0	1
125111	460032	1	0	1	0	1	2
125111	460035	1	0	2	0	0	2
125111	460036	1	0	1	0	0	1
125111	460039	1	1	0	0	0	1
125111	460040	1	0	0	0	1	1
125111	460045	1	0	0	0	0	0
125111	460048	1	0	0	0	1	1
125111	460050	1	0	1	0	0	1
125111	460053	1	0	1	0	0	1
125111	460054	1	0	0	0	0	0
125111	460057	1	0	1	0	0	1
125111	460060	1	0	1	0	0	1
125111	460062	1	0	0	0	1	1
125111	460063	1	0	0	0	1	1
125111	460064	1	0	0	0	0	0
125111	460067	1	0	0	0	0	0
125111	460068	1	0	0	1	0	1
125111	460069	1	0	0	0	0	0
125111	460070	1	0	4	0	0	4
125111	460071	1	0	0	1	0	1
125111	460076	1	2	2	0	0	4
125111	460078	1	0	0	1	0	1
125111	460080	1	0	0	0	0	0
125111	460083	1	0	0	0	0	0
125111	460084	1	0	0	0	0	0
125111	460087	1	1	1	0	0	2
125111	460088	1	0	2	0	0	2
125111	460089	1	0	2	0	0	2
125111	460092	1	0	1	0	1	2
125111	460096	1	1	1	0	0	2
125111	460098	1	0	0	0	0	0
125111	460100	1	0	0	0	0	0
125111	460101	1	0	0	0	0	0
125111	460103	1	0	0	0	0	0
125111	460104	1	1	0	0	0	1
125111	460105	1	0	0	0	0	0
125111	460109	1	0	0	0	1	1
125111	460110	1	0	0	0	1	1
125111	460111	1	0	3	0	0	3
125111	460114	1	1	0	0	0	1
125111	460116	1	0	0	0	1	1
125111	460117	1	0	0	0	0	0
125111	460118	1	0	0	0	0	0
125111	460119	1	0	0	1	0	1
125111	460123	1	0	0	0	0	0
125111	460126	1	0	0	0	0	0
125111	460130	1	0	1	0	0	1
125111	460131	1	0	0	0	1	1
125111	460132	1	0	0	0	0	0
125111	460133	1	0	0	0	0	0
125111	460134	1	1	0	1	1	3
125111	460135	1	0	0	1	0	1
125111	460138	1	0	0	0	0	0
125111	460139	1	0	2	0	0	2
125111	460140	1	0	0	0	0	0
125111	460141	1	0	1	0	0	1
125111	460142	1	0	0	0	1	1
125111	460144	1	0	0	0	0	0
125111	460145	1	0	0	0	0	0
125111	460147	1	1	1	0	0	2
125111	460150	1	1	0	0	0	1
125111	460152	1	0	0	0	0	0
125111	460154	1	1	0	0	0	1
125111	460157	1	1	0	0	0	1
125111	460158	1	0	0	0	0	0
125111	460161	1	0	1	0	0	1
125111	460162	1	0	1	1	0	2
125111	460164	1	0	0	0	0	0
125111	460167	1	0	0	0	1	1
125111	460175	1	0	0	0	0	0
125111	460177	1	0	1	0	0	1
125111	460179	1	0	1	0	0	1
125111	460181	1	0	0	0	0	0
125111	460182	1	0	0	0	0	0
125111	460185	1	0	0	0	0	0
125111	460186	1	0	0	0	1	1
125111	460190	1	0	1	0	0	1
125111	460193	1	1	0	0	0	1
125111	460195	1	1	0	0	1	2
125111	460197	1	0	0	0	0	0
125111	460198	1	0	0	0	0	0
125111	460199	1	0	0	0	1	1
125111	460202	1	1	0	0	0	1
125111	460206	1	0	0	0	1	1
125111	460213	1	1	1	0	0	2
125111	460214	1	0	0	0	0	0
125111	460216	1	0	0	0	0	0
125111	460217	1	0	2	0	0	2
125111	460218	1	0	0	0	1	1
125111	460223	1	0	0	0	0	0
125111	460225	1	0	1	0	0	1
125111	460229	1	0	0	0	0	0
125111	460232	1	0	0	1	1	2
125111	460233	1	0	0	0	0	0
125111	460236	1	0	0	0	0	0
125111	460239	1	0	0	0	0	0
125111	460240	1	0	0	0	0	0
125111	460245	1	0	0	0	0	0
125111	460246	1	0	0	0	0	0
125111	460247	1	0	0	0	0	0
125111	460249	1	0	1	0	0	1
125111	460252	1	0	1	0	0	1
125111	460255	1	0	0	0	0	0
125111	460257	1	0	0	0	1	1
125111	460259	1	0	0	0	0	0
125111	460262	1	0	0	0	1	1
125111	460265	1	0	0	0	0	0
125111	460268	1	0	0	0	0	0
125111	460271	1	0	1	0	0	1
125111	460273	1	0	0	0	0	0
125111	460274	1	0	0	0	0	0
125111	460276	1	0	0	0	0	0
125111	460277	1	0	1	0	0	1
125111	460278	1	0	0	1	0	1
125111	460281	1	0	0	0	0	0
125111	460282	1	0	0	0	0	0
125111	460284	1	0	0	0	0	0
125111	460285	1	0	1	0	1	2
125111	460286	1	0	1	0	0	1
125111	460288	1	0	2	0	0	2
125111	460290	1	0	1	0	0	1
125111	460291	1	0	0	0	0	0
125111	460293	1	0	1	0	0	1
125111	460295	1	0	0	0	0	0
125111	460297	1	0	0	0	1	1
125111	460298	1	1	0	0	0	1
125111	460300	1	0	2	0	1	3
125111	460301	1	0	0	0	0	0
125111	460302	1	2	1	0	0	3
125111	460304	1	0	1	0	0	1
125111	460308	1	0	0	0	1	1
125111	460309	1	0	0	1	0	1
125111	460310	1	0	0	0	0	0
125111	460312	1	1	1	0	0	2
125111	460313	1	0	0	0	0	0
125111	460315	1	0	1	0	1	2
125111	460318	1	0	0	0	0	0
125111	460319	1	0	0	0	0	0
125111	460320	1	0	0	0	2	2
125111	460322	1	0	0	1	0	1
125111	460323	1	0	0	0	1	1
125111	460324	1	0	2	0	0	2
125111	460327	1	0	0	0	0	0
125111	460330	1	0	0	1	0	1
125111	460335	1	0	1	0	0	1
125111	460339	1	0	0	2	0	2
125111	460341	1	0	1	0	0	1
125111	460342	1	0	0	0	1	1
125111	460343	1	1	1	0	0	2
125111	460351	1	0	0	0	0	0
125111	460355	1	0	0	0	0	0
125111	460357	1	0	0	0	1	1
125111	460363	1	0	2	0	1	3
125111	460367	1	0	0	0	0	0
125111	460368	1	0	0	0	0	0
125111	460370	1	0	1	0	1	2
125111	460371	1	0	0	0	0	0
125111	460373	1	0	1	0	0	1
125111	460376	1	0	0	0	0	0
125111	460377	1	0	0	0	0	0
125111	460378	1	0	0	0	0	0
125111	460380	1	0	2	0	0	2
125111	460381	1	0	1	0	0	1
125111	460384	1	0	0	0	0	0
125111	460385	1	0	0	0	0	0
125111	460387	1	0	0	0	0	0
125111	460405	1	0	0	0	0	0
125111	460412	1	0	0	0	0	0
125111	460423	1	0	0	0	0	0
125111	460426	1	1	0	0	0	1
125111	460429	1	0	2	0	1	3
125111	460433	1	1	0	0	1	2
125111	460435	1	1	0	0	0	1
125111	460436	1	0	0	0	0	0
125111	460447	1	1	0	0	0	1
125111	460451	1	0	0	0	1	1
125111	460453	1	0	0	0	0	0
125111	460460	1	0	0	0	0	0
125111	460464	1	0	0	0	0	0
22666	495043	37	0	2	0	3	5
22666	495042	36	10	3	1	12	26
22666	210641	30	5	4	3	3	15
22666	495062	30	2	4	0	3	9
22666	495077	30	5	4	3	3	15
22666	495041	27	2	3	1	5	11
22666	495309	21	1	2	0	1	4
22666	495044	20	4	3	1	7	15
22666	495063	17	0	3	0	3	6
22666	277519	15	2	2	0	3	7
22666	495040	14	1	2	2	2	7
22666	495230	14	2	3	0	1	6
22666	495415	14	1	2	0	1	4
22666	495328	13	0	2	2	2	6
22666	201644	12	0	1	2	3	6
22666	204918	12	3	3	1	5	12
22666	495039	12	1	5	0	2	8
22666	495306	12	2	2	0	0	4
22666	495061	11	2	2	0	2	6
22666	495198	11	2	0	0	2	4
22666	495317	11	2	1	0	1	4
22666	205257	10	0	0	1	1	2
22666	214569	10	1	3	2	0	6
22666	495080	10	2	1	0	1	4
22666	495168	10	2	1	0	0	3
22666	495311	10	2	1	0	0	3
22666	495383	10	4	1	0	0	5
22666	495163	9	2	1	0	2	5
22666	495197	9	0	0	0	2	2
22666	495199	9	1	2	0	1	4
22666	495212	9	2	2	1	3	8
22666	495298	9	1	1	0	2	4
22666	495326	9	1	2	0	0	3
22666	495338	9	1	4	0	1	6
22666	495341	9	1	1	0	0	2
22666	495370	9	6	2	1	0	9
22666	495052	8	1	1	0	2	4
22666	495075	8	1	2	0	2	5
22666	495083	8	1	2	0	0	3
22666	495109	8	2	2	0	3	7
22666	495246	8	1	1	1	3	6
22666	495265	8	4	2	0	2	8
22666	495395	8	1	2	0	2	5
22666	495401	8	0	1	1	0	2
22666	189008	7	0	0	0	1	1
22666	203029	7	5	2	0	3	10
22666	203704	7	2	2	0	0	4
22666	219040	7	0	0	0	2	2
22666	277525	7	1	0	0	4	5
22666	277529	7	1	2	0	0	3
22666	495045	7	0	1	0	2	3
22666	495068	7	0	2	0	2	4
22666	495069	7	1	0	1	0	2
22666	495070	7	0	1	0	1	2
22666	495084	7	2	0	0	0	2
22666	495095	7	0	1	0	0	1
22666	495100	7	1	0	0	1	2
22666	495110	7	1	1	0	3	5
22666	495231	7	0	2	0	0	2
22666	495248	7	1	1	1	2	5
22666	495261	7	0	2	0	3	5
22666	495318	7	0	2	0	1	3
22666	495335	7	1	0	0	1	2
22666	495343	7	2	2	0	0	4
22666	495346	7	0	0	0	1	1
22666	495347	7	0	1	0	0	1
22666	495363	7	2	2	0	1	5
22666	495389	7	2	1	1	4	8
22666	495406	7	1	1	0	2	4
22666	495409	7	0	1	0	1	2
22666	495419	7	2	1	0	1	4
22666	495422	7	2	1	0	1	4
22666	495426	7	3	3	0	0	6
22666	182479	6	0	1	0	0	1
22666	207706	6	1	1	0	0	2
22666	207996	6	2	2	1	1	6
22666	210606	6	0	1	1	0	2
22666	212269	6	2	1	0	0	3
22666	277518	6	0	2	0	0	2
22666	277526	6	0	2	0	4	6
22666	495078	6	2	1	0	0	3
22666	495086	6	0	3	0	0	3
22666	495089	6	2	2	0	4	8
22666	495096	6	0	1	0	2	3
22666	495102	6	2	2	0	1	5
22666	495103	6	2	0	0	0	2
22666	495104	6	0	1	0	0	1
22666	495111	6	3	1	0	2	6
22666	495128	6	1	2	0	2	5
22666	495167	6	2	3	0	1	6
22666	495180	6	0	0	0	4	4
22666	495200	6	0	3	0	1	4
22666	495203	6	0	1	1	1	3
22666	495208	6	2	3	0	0	5
22666	495211	6	1	2	0	0	3
22666	495214	6	0	1	2	0	3
22666	495216	6	0	3	1	1	5
22666	495221	6	3	0	0	0	3
22666	495233	6	2	0	0	1	3
22666	495241	6	3	1	0	2	6
22666	495243	6	0	2	0	2	4
22666	495244	6	1	5	0	0	6
22666	495266	6	2	1	0	1	4
22666	495352	6	0	3	0	2	5
22666	495356	6	0	2	0	1	3
22666	495361	6	1	1	0	1	3
22666	495371	6	0	0	0	1	1
22666	495379	6	0	2	0	1	3
22666	495385	6	2	1	0	0	3
22666	495391	6	0	1	0	0	1
22666	495398	6	1	2	0	2	5
22666	495400	6	1	0	0	0	1
22666	495402	6	3	1	0	3	7
22666	495404	6	1	0	0	0	1
22666	495408	6	3	1	0	0	4
22666	495410	6	0	0	1	4	5
22666	495414	6	1	1	0	0	2
22666	495432	6	0	0	0	1	1
22666	186049	5	0	2	0	0	2
22666	193571	5	1	2	0	1	4
22666	202554	5	3	0	0	1	4
22666	206012	5	2	0	0	1	3
22666	210537	5	2	0	0	1	3
22666	214030	5	3	0	0	0	3
22666	214477	5	0	0	0	2	2
22666	217090	5	0	0	0	3	3
22666	219846	5	0	3	0	1	4
22666	220497	5	1	2	0	2	5
22666	277517	5	3	1	0	1	5
22666	277521	5	0	0	0	0	0
22666	495047	5	2	0	2	1	5
22666	495048	5	1	0	0	1	2
22666	495049	5	0	1	0	1	2
22666	495059	5	0	4	0	0	4
22666	495072	5	1	2	0	2	5
22666	495076	5	1	1	0	0	2
22666	495081	5	1	1	2	0	4
22666	495091	5	1	0	1	4	6
22666	495107	5	1	0	0	3	4
22666	495134	5	2	1	1	1	5
22666	495148	5	1	0	0	3	4
22666	495153	5	0	1	1	0	2
22666	495155	5	1	1	0	0	2
22666	495169	5	1	1	0	1	3
22666	495185	5	2	1	0	1	4
22666	495187	5	0	0	0	2	2
22666	495188	5	2	2	0	2	6
22666	495196	5	1	0	1	0	2
22666	495207	5	2	1	1	1	5
22666	495219	5	1	0	0	0	1
22666	495223	5	2	1	0	3	6
22666	495232	5	1	0	0	1	2
22666	495239	5	0	0	0	1	1
22666	495242	5	1	0	0	3	4
22666	495245	5	0	2	0	0	2
22666	495250	5	1	2	1	1	5
22666	495251	5	0	0	0	0	0
22666	495255	5	1	1	0	0	2
22666	495263	5	1	2	0	0	3
22666	495264	5	1	0	0	2	3
22666	495272	5	0	4	0	3	7
22666	495276	5	1	1	1	1	4
22666	495284	5	1	1	0	0	2
22666	495300	5	1	2	0	0	3
22666	495302	5	0	0	0	0	0
22666	495323	5	0	0	0	1	1
22666	495329	5	1	3	1	0	5
22666	495331	5	0	0	0	1	1
22666	495336	5	0	0	0	1	1
22666	495360	5	3	2	0	0	5
22666	495364	5	1	1	0	1	3
22666	495366	5	0	1	0	1	2
22666	495367	5	1	1	0	0	2
22666	495375	5	2	0	0	0	2
22666	495381	5	0	1	0	0	1
22666	495388	5	1	0	0	0	1
22666	495393	5	0	1	0	1	2
22666	495413	5	1	0	0	0	1
22666	495416	5	1	1	0	0	2
22666	495430	5	1	1	0	2	4
22666	495439	5	1	1	0	0	2
22666	184661	4	2	0	0	2	4
22666	185906	4	0	1	0	1	2
22666	186661	4	0	1	0	0	1
22666	186955	4	1	1	1	2	5
22666	189642	4	1	0	0	1	2
22666	195740	4	1	0	0	1	2
22666	202937	4	1	1	0	1	3
22666	203105	4	1	0	0	0	1
22666	203149	4	0	1	0	1	2
22666	206629	4	1	3	0	1	5
22666	207264	4	0	0	0	2	2
22666	207727	4	0	1	0	2	3
22666	207904	4	1	1	1	2	5
22666	208347	4	0	0	0	0	0
22666	211408	4	1	0	0	3	4
22666	212499	4	0	0	0	1	1
22666	213904	4	1	1	2	3	7
22666	214103	4	1	1	0	1	3
22666	217089	4	0	0	1	2	3
22666	217417	4	0	2	0	0	2
22666	220018	4	0	1	0	1	2
22666	277510	4	3	0	2	1	6
22666	277516	4	1	0	0	0	1
22666	277528	4	1	2	0	2	5
22666	370521	4	1	2	0	1	4
22666	495038	4	0	2	0	3	5
22666	495046	4	0	1	0	1	2
22666	495066	4	0	1	0	0	1
22666	495082	4	1	1	0	2	4
22666	495085	4	0	0	0	3	3
22666	495087	4	0	2	0	2	4
22666	495088	4	1	3	0	4	8
22666	495093	4	0	0	0	2	2
22666	495097	4	3	4	0	1	8
22666	495098	4	0	4	0	0	4
22666	495105	4	1	3	0	1	5
22666	495106	4	1	0	0	0	1
22666	495108	4	0	1	0	3	4
22666	495119	4	0	3	0	1	4
22666	495139	4	0	1	2	1	4
22666	495140	4	0	0	0	0	0
22666	495149	4	0	0	0	3	3
22666	495162	4	0	3	1	2	6
22666	495171	4	0	0	0	3	3
22666	495172	4	0	0	1	0	1
22666	495174	4	1	2	0	1	4
22666	495177	4	2	0	0	1	3
22666	495181	4	2	0	0	2	4
22666	495183	4	0	0	0	1	1
22666	495210	4	1	0	0	1	2
22666	495215	4	0	0	0	0	0
22666	495228	4	0	0	0	0	0
22666	495234	4	1	0	0	0	1
22666	495235	4	1	0	0	1	2
22666	495240	4	2	1	1	2	6
22666	495249	4	0	1	0	1	2
22666	495262	4	1	1	0	0	2
22666	495267	4	1	0	0	1	2
22666	495271	4	1	0	0	2	3
22666	495275	4	0	0	0	0	0
22666	495277	4	2	1	0	2	5
22666	495280	4	2	0	0	2	4
22666	495291	4	1	1	0	0	2
22666	495297	4	0	0	0	2	2
22666	495305	4	0	1	0	0	1
22666	495307	4	1	0	0	2	3
22666	495310	4	1	2	0	2	5
22666	495313	4	2	1	0	0	3
22666	495316	4	1	0	0	2	3
22666	495322	4	1	0	0	2	3
22666	495324	4	1	0	0	1	2
22666	495330	4	1	1	0	0	2
22666	495342	4	2	0	0	0	2
22666	495349	4	1	1	0	2	4
22666	495359	4	0	0	0	0	0
22666	495362	4	1	0	0	1	2
22666	495382	4	1	1	0	0	2
22666	495386	4	1	2	0	0	3
22666	495392	4	1	1	0	2	4
22666	495396	4	1	3	1	1	6
22666	495399	4	3	2	0	0	5
22666	495411	4	1	1	0	0	2
22666	495412	4	1	3	0	1	5
22666	495427	4	1	0	0	2	3
22666	495428	4	1	1	1	1	4
22666	495433	4	0	0	0	0	0
22666	495435	4	2	0	0	1	3
22666	495437	4	1	2	0	0	3
22666	495438	4	1	0	0	1	2
22666	187081	3	0	0	0	1	1
22666	190319	3	1	0	0	2	3
22666	192226	3	1	0	0	2	3
22666	192596	3	0	0	0	1	1
22666	194923	3	0	0	1	1	2
22666	196828	3	1	2	0	1	4
22666	198503	3	0	0	0	1	1
22666	199066	3	0	0	0	0	0
22666	203180	3	0	0	0	2	2
22666	205998	3	1	0	0	0	1
22666	206331	3	1	0	0	1	2
22666	206460	3	0	1	0	0	1
22666	206481	3	0	0	0	1	1
22666	207354	3	0	1	0	2	3
22666	207693	3	0	1	0	0	1
22666	212474	3	0	0	0	3	3
22666	212498	3	0	0	0	2	2
22666	214399	3	0	1	0	1	2
22666	214416	3	0	2	0	1	3
22666	214970	3	1	1	0	1	3
22666	216838	3	2	1	0	1	4
22666	218998	3	1	3	0	1	5
22666	277511	3	1	0	0	0	1
22666	277512	3	1	0	0	1	2
22666	277514	3	0	0	0	0	0
22666	277515	3	1	0	0	0	1
22666	277523	3	0	0	0	0	0
22666	277524	3	0	0	0	3	3
22666	277532	3	1	2	2	2	7
22666	495051	3	0	2	0	1	3
22666	495055	3	0	1	0	1	2
22666	495058	3	1	0	0	0	1
22666	495060	3	0	0	0	0	0
22666	495065	3	1	1	0	2	4
22666	495067	3	0	1	0	0	1
22666	495071	3	1	1	2	2	6
22666	495079	3	1	2	0	0	3
22666	495092	3	1	0	0	1	2
22666	495112	3	1	0	0	0	1
22666	495115	3	0	1	0	0	1
22666	495116	3	1	3	0	0	4
22666	495121	3	0	1	0	0	1
22666	495122	3	0	0	0	1	1
22666	495124	3	2	0	0	0	2
22666	495127	3	0	1	0	1	2
22666	495129	3	1	2	0	0	3
22666	495130	3	1	0	0	0	1
22666	495135	3	2	0	1	0	3
22666	495137	3	0	2	0	0	2
22666	495138	3	0	0	0	0	0
22666	495141	3	1	0	0	1	2
22666	495142	3	1	1	0	0	2
22666	495144	3	1	1	0	2	4
22666	495146	3	0	1	0	1	2
22666	495152	3	1	0	0	3	4
22666	495156	3	0	1	0	1	2
22666	495157	3	1	1	0	0	2
22666	495159	3	1	0	0	2	3
22666	495160	3	0	0	0	1	1
22666	495164	3	1	2	0	0	3
22666	495166	3	1	1	0	0	2
22666	495175	3	1	0	0	0	1
22666	495176	3	2	0	0	2	4
22666	495179	3	1	1	0	0	2
22666	495190	3	0	0	1	1	2
22666	495191	3	0	1	0	1	2
22666	495192	3	0	1	0	0	1
22666	495209	3	1	2	0	1	4
22666	495213	3	0	1	1	3	5
22666	495218	3	0	1	0	1	2
22666	495220	3	0	0	0	1	1
22666	495224	3	1	1	0	0	2
22666	495238	3	0	1	0	0	1
22666	495247	3	0	1	0	0	1
22666	495254	3	0	0	0	1	1
22666	495257	3	0	1	0	2	3
22666	495268	3	0	0	0	2	2
22666	495269	3	0	2	0	1	3
22666	495274	3	0	1	0	0	1
22666	495278	3	1	0	0	0	1
22666	495282	3	1	0	0	0	1
22666	495295	3	0	0	0	1	1
22666	495303	3	0	0	0	0	0
22666	495308	3	3	1	0	0	4
22666	495314	3	2	2	1	2	7
22666	495320	3	0	0	0	1	1
22666	495321	3	0	1	0	1	2
22666	495327	3	0	3	0	1	4
22666	495334	3	0	0	0	0	0
22666	495337	3	0	0	0	1	1
22666	495340	3	0	0	0	2	2
22666	495345	3	0	0	0	1	1
22666	495348	3	0	2	0	1	3
22666	495351	3	3	0	0	1	4
22666	495365	3	2	1	0	1	4
22666	495372	3	1	1	0	1	3
22666	495380	3	1	0	0	0	1
22666	495384	3	2	0	0	2	4
22666	495387	3	1	2	0	0	3
22666	495390	3	0	0	0	0	0
22666	495397	3	2	1	0	3	6
22666	495407	3	2	2	0	2	6
22666	495418	3	1	1	0	1	3
22666	495423	3	0	0	0	1	1
22666	495431	3	1	0	0	2	3
22666	495436	3	0	1	0	0	1
22666	182348	2	0	1	0	0	1
22666	183739	2	0	1	0	0	1
22666	185482	2	0	0	0	1	1
22666	186807	2	1	0	0	1	2
22666	190053	2	0	1	0	3	4
22666	191593	2	0	0	0	2	2
22666	193304	2	0	1	0	2	3
22666	201385	2	1	0	0	1	2
22666	203639	2	0	0	0	0	0
22666	203813	2	1	0	0	0	1
22666	204893	2	0	0	0	1	1
22666	206224	2	0	1	0	2	3
22666	207281	2	1	1	0	1	3
22666	207475	2	0	0	0	0	0
22666	211118	2	0	0	0	2	2
22666	211167	2	0	0	0	2	2
22666	212676	2	0	0	0	1	1
22666	214057	2	1	0	0	0	1
22666	215266	2	1	1	0	0	2
22666	215354	2	0	0	0	0	0
22666	217071	2	0	0	0	1	1
22666	218615	2	0	2	0	1	3
22666	219992	2	0	0	0	1	1
22666	221923	2	1	1	1	1	4
22666	277513	2	2	1	0	1	4
22666	277527	2	0	1	0	0	1
22666	277530	2	0	0	0	0	0
22666	277531	2	1	0	0	0	1
22666	495054	2	1	0	0	0	1
22666	495074	2	0	0	0	0	0
22666	495094	2	1	0	0	0	1
22666	495099	2	0	1	0	2	3
22666	495101	2	0	1	1	0	2
22666	495113	2	0	0	0	1	1
22666	495114	2	0	0	0	0	0
22666	495117	2	1	0	0	0	1
22666	495118	2	1	1	0	2	4
22666	495120	2	0	0	0	0	0
22666	495125	2	0	0	1	0	1
22666	495131	2	0	0	0	0	0
22666	495132	2	0	0	0	0	0
22666	495133	2	0	1	0	0	1
22666	495136	2	1	0	0	0	1
22666	495143	2	0	1	0	0	1
22666	495145	2	0	1	0	1	2
22666	495147	2	0	1	0	0	1
22666	495150	2	1	0	1	1	3
22666	495154	2	0	0	0	0	0
22666	495158	2	1	1	0	1	3
22666	495161	2	0	0	0	0	0
22666	495165	2	0	0	0	1	1
22666	495170	2	1	0	0	1	2
22666	495178	2	1	1	0	1	3
22666	495182	2	1	0	0	3	4
22666	495184	2	0	0	0	1	1
22666	495186	2	0	1	0	0	1
22666	495189	2	1	0	0	0	1
22666	495193	2	1	0	0	2	3
22666	495195	2	0	0	0	1	1
22666	495201	2	2	0	0	0	2
22666	495204	2	1	1	0	1	3
22666	495205	2	0	0	0	0	0
22666	495206	2	1	0	0	2	3
22666	495217	2	0	0	0	2	2
22666	495226	2	0	1	0	2	3
22666	495227	2	0	0	0	0	0
22666	495229	2	0	2	0	0	2
22666	495237	2	0	2	0	1	3
22666	495252	2	1	0	0	0	1
22666	495253	2	0	2	0	1	3
22666	495258	2	0	1	0	0	1
22666	495260	2	1	1	0	0	2
22666	495273	2	1	0	0	0	1
22666	495279	2	0	1	0	0	1
22666	495285	2	0	2	0	0	2
22666	495287	2	1	0	0	0	1
22666	495289	2	0	1	0	1	2
22666	495290	2	0	1	0	0	1
22666	495292	2	0	0	0	0	0
22666	495294	2	0	1	0	0	1
22666	495296	2	0	1	0	1	2
22666	495301	2	1	0	0	0	1
22666	495304	2	0	0	0	1	1
22666	495312	2	1	0	0	0	1
22666	495319	2	0	0	0	0	0
22666	495325	2	0	3	0	2	5
22666	495333	2	1	2	0	0	3
22666	495344	2	1	1	0	1	3
22666	495353	2	0	1	0	1	2
22666	495355	2	1	2	0	0	3
22666	495357	2	3	1	0	1	5
22666	495358	2	3	0	0	0	3
22666	495369	2	0	0	0	0	0
22666	495374	2	0	0	0	3	3
22666	495376	2	0	1	0	1	2
22666	495377	2	0	1	0	1	2
22666	495378	2	0	0	0	2	2
22666	495394	2	0	0	0	0	0
22666	495403	2	2	0	0	0	2
22666	495405	2	0	0	0	1	1
22666	495417	2	0	0	0	0	0
22666	495420	2	1	1	0	0	2
22666	495421	2	2	0	0	3	5
22666	495424	2	0	1	0	0	1
22666	495429	2	0	0	0	0	0
22666	495434	2	1	0	0	1	2
22666	495440	2	1	0	0	1	2
22666	183991	1	0	0	0	0	0
22666	188477	1	0	1	0	0	1
22666	190085	1	0	1	0	1	2
22666	191240	1	0	0	0	1	1
22666	191396	1	0	1	0	1	2
22666	192476	1	1	0	0	1	2
22666	196407	1	0	0	0	1	1
22666	200052	1	0	0	0	2	2
22666	201239	1	0	0	0	2	2
22666	202111	1	0	0	0	0	0
22666	203037	1	0	0	0	1	1
22666	204611	1	0	0	0	0	0
22666	205985	1	0	0	0	0	0
22666	213561	1	0	0	0	1	1
22666	214681	1	0	2	0	2	4
22666	216882	1	0	2	0	0	2
22666	217686	1	0	0	0	1	1
22666	217702	1	1	1	0	0	2
22666	277520	1	0	0	0	1	1
22666	277522	1	0	0	0	2	2
22666	495037	1	0	0	0	1	1
22666	495050	1	2	1	0	0	3
22666	495053	1	1	0	0	1	2
22666	495056	1	0	1	0	0	1
22666	495057	1	2	1	0	0	3
22666	495064	1	0	0	0	1	1
22666	495073	1	0	1	0	1	2
22666	495090	1	0	1	0	2	3
22666	495123	1	0	0	0	5	5
22666	495126	1	0	1	0	1	2
22666	495151	1	0	2	0	0	2
22666	495173	1	0	0	0	0	0
22666	495194	1	0	0	0	0	0
22666	495202	1	1	3	0	1	5
22666	495222	1	2	2	0	2	6
22666	495225	1	1	0	0	0	1
22666	495236	1	0	0	0	1	1
22666	495256	1	0	0	0	2	2
22666	495259	1	1	1	0	0	2
22666	495270	1	0	1	0	1	2
22666	495281	1	0	0	0	2	2
22666	495283	1	0	0	0	1	1
22666	495286	1	0	1	0	1	2
22666	495293	1	1	2	0	1	4
22666	495299	1	0	0	0	2	2
22666	495315	1	0	0	0	0	0
22666	495332	1	0	1	0	0	1
22666	495339	1	0	0	0	0	0
22666	495350	1	0	1	0	0	1
22666	495354	1	1	0	0	1	2
22666	495373	1	1	0	0	0	1
22666	495425	1	1	0	0	1	2
33440	66704	92	4	5	7	3	19
33440	104090	79	5	4	5	4	18
33440	90015	67	4	3	3	0	10
33440	67031	65	7	4	1	1	13
33440	81876	65	3	8	1	2	14
33440	101282	64	7	4	3	2	16
33440	96016	56	4	2	0	1	7
33440	76294	51	0	7	2	2	11
33440	91785	50	2	7	1	3	13
33440	75879	40	2	5	0	0	7
33440	202297	38	3	5	0	1	9
33440	292078	37	4	3	1	0	8
33440	292083	37	3	5	0	1	9
33440	382287	37	3	5	0	1	9
33440	51870	37	1	5	2	0	8
33440	66541	37	4	3	1	0	8
33440	82780	37	3	5	0	1	9
33440	68224	32	4	5	7	3	19
33440	79896	29	2	5	1	3	11
33440	187234	28	6	4	4	0	14
33440	292084	28	3	0	0	1	4
33440	292096	28	2	6	1	3	12
33440	69103	28	6	4	4	0	14
33440	80252	28	3	0	0	1	4
33440	88640	28	4	8	1	2	15
33440	210091	27	4	3	1	1	9
33440	292081	27	4	8	1	2	15
33440	382304	27	2	4	0	3	9
33440	382315	27	4	3	1	1	9
33440	93105	27	4	3	1	1	9
33440	103475	26	1	4	0	0	5
33440	107093	23	1	4	1	1	7
33440	107236	23	1	4	1	1	7
33440	292079	23	1	4	1	1	7
33440	382285	23	1	4	1	1	7
33440	189102	22	2	5	0	1	8
33440	68978	22	0	1	0	0	1
33440	292095	21	2	5	0	1	8
33440	52808	21	0	1	2	0	3
33440	58156	21	2	5	2	1	10
33440	61045	21	2	5	0	1	8
33440	107356	20	1	3	0	0	4
33440	292085	20	1	3	0	0	4
33440	292093	20	1	3	1	1	6
33440	382314	20	2	2	1	2	7
33440	57187	20	1	3	1	1	6
33440	292074	19	2	7	0	5	14
33440	382289	19	0	2	1	1	4
33440	72648	19	2	7	0	5	14
33440	102075	18	1	3	0	0	4
33440	292088	18	1	4	0	1	6
33440	292092	18	3	4	0	0	7
33440	382114	18	1	0	1	0	2
33440	382206	18	5	4	0	2	11
33440	50152	18	1	4	0	1	6
33440	55268	18	3	4	0	0	7
33440	292080	17	0	2	0	1	3
33440	382293	17	3	3	0	0	6
33440	56939	17	0	2	0	1	3
33440	80761	17	3	3	0	0	6
33440	97158	17	1	0	1	0	2
33440	292086	16	5	3	0	3	11
33440	61267	16	1	3	1	1	6
33440	71375	16	5	3	0	3	11
33440	292059	15	4	2	0	1	7
33440	292087	15	3	3	0	1	7
33440	61525	15	1	3	0	0	4
33440	63304	15	4	2	0	1	7
33440	68351	15	3	3	0	1	7
33440	106824	14	2	3	0	0	5
33440	292069	14	2	7	1	0	10
33440	51602	14	2	7	1	0	10
33440	51652	14	3	5	1	0	9
33440	57467	14	2	3	0	0	5
33440	87327	14	2	2	1	1	6
33440	99952	13	0	3	0	0	3
33440	105994	12	1	0	2	0	3
33440	219270	12	1	0	2	0	3
33440	292091	12	1	2	0	0	3
33440	382227	12	1	2	1	0	4
33440	382299	12	2	4	0	1	7
33440	84209	12	0	3	0	0	3
33440	92801	12	1	2	0	0	3
33440	188268	11	1	2	0	0	3
33440	188920	11	0	3	0	1	4
33440	382317	11	0	2	0	0	2
33440	60024	11	0	3	0	1	4
33440	94352	11	2	0	0	3	5
33440	292061	10	0	4	1	1	6
33440	382175	10	0	3	0	0	3
33440	49572	10	3	2	1	1	7
33440	50455	10	1	1	0	2	4
33440	82965	10	0	4	1	1	6
33440	95323	10	0	3	0	0	3
33440	292057	9	1	1	0	3	5
33440	382225	9	0	1	0	0	1
33440	382226	9	0	4	1	1	6
33440	49446	9	1	1	0	0	2
33440	50355	9	2	1	0	0	3
33440	86582	9	2	3	1	0	6
33440	97937	9	1	1	0	3	5
33440	100862	8	2	3	0	0	5
33440	108366	8	3	5	0	2	10
33440	195210	8	2	0	0	0	2
33440	221947	8	2	4	0	0	6
33440	382119	8	2	3	0	0	5
33440	382132	8	0	2	0	0	2
33440	382238	8	0	0	0	0	0
33440	382268	8	2	2	1	0	5
33440	382318	8	2	3	0	0	5
33440	66615	8	0	0	0	0	0
33440	78002	8	0	1	2	0	3
33440	84011	8	4	1	2	0	7
33440	95508	8	1	1	0	0	2
33440	98130	8	2	1	0	2	5
33440	188398	7	3	0	0	1	4
33440	292082	7	1	1	0	1	3
33440	382117	7	0	0	0	0	0
33440	382151	7	0	1	0	0	1
33440	74711	7	2	3	1	0	6
33440	86268	7	1	1	0	1	3
33440	97471	7	0	0	0	1	1
33440	102377	6	1	1	0	1	3
33440	292075	6	1	2	0	1	4
33440	382001	6	0	1	0	0	1
33440	382084	6	2	4	0	1	7
33440	382102	6	0	0	0	0	0
33440	382105	6	1	0	0	1	2
33440	382111	6	0	1	0	0	1
33440	382113	6	1	1	0	0	2
33440	382129	6	3	0	0	0	3
33440	382130	6	1	3	0	1	5
33440	382131	6	0	0	0	0	0
33440	382207	6	1	0	0	0	1
33440	382237	6	0	0	0	0	0
33440	382297	6	1	2	0	1	4
33440	382312	6	1	1	0	1	3
33440	59319	6	1	1	0	1	3
33440	69511	6	1	1	0	1	3
33440	71512	6	1	2	0	1	4
33440	72223	6	1	1	0	1	3
33440	81827	6	1	3	0	0	4
33440	86305	6	1	1	0	0	2
33440	86377	6	0	3	0	0	3
33440	88368	6	0	0	0	0	0
33440	184527	5	2	1	0	0	3
33440	189536	5	0	1	0	0	1
33440	191725	5	0	1	2	0	3
33440	193624	5	1	1	0	1	3
33440	194942	5	0	1	0	0	1
33440	211752	5	1	1	1	0	3
33440	292065	5	0	5	0	0	5
33440	382027	5	1	0	0	0	1
33440	382065	5	1	0	0	0	1
33440	382073	5	0	1	0	0	1
33440	382079	5	0	1	0	0	1
33440	382089	5	1	1	0	1	3
33440	382109	5	0	0	0	0	0
33440	382112	5	0	2	0	0	2
33440	382120	5	2	2	0	0	4
33440	382123	5	1	1	0	0	2
33440	382124	5	2	2	0	0	4
33440	382133	5	3	0	0	0	3
33440	382138	5	1	2	0	0	3
33440	382158	5	2	2	0	0	4
33440	382174	5	1	2	0	0	3
33440	382208	5	1	2	0	0	3
33440	382211	5	1	0	0	0	1
33440	382213	5	0	1	0	0	1
33440	382231	5	3	0	0	0	3
33440	382233	5	0	0	0	0	0
33440	382234	5	1	2	0	0	3
33440	382245	5	0	1	0	0	1
33440	382257	5	2	2	0	0	4
33440	382262	5	1	0	0	0	1
33440	382266	5	1	1	0	0	2
33440	382281	5	0	1	0	0	1
33440	382284	5	1	1	0	0	2
33440	382286	5	0	0	0	0	0
33440	382300	5	1	0	0	0	1
33440	382303	5	0	1	0	0	1
33440	55719	5	0	1	0	0	1
33440	56317	5	0	0	0	1	1
33440	68776	5	1	1	0	1	3
33440	73991	5	0	8	0	0	8
33440	81040	5	0	2	0	0	2
33440	82242	5	0	2	0	0	2
33440	92264	5	2	2	0	0	4
33440	94608	5	0	0	0	1	1
33440	105391	4	0	0	0	0	0
33440	183172	4	2	0	0	0	2
33440	187921	4	1	2	1	0	4
33440	215276	4	1	1	0	0	2
33440	292055	4	1	0	0	0	1
33440	292056	4	0	1	0	0	1
33440	292063	4	0	1	0	2	3
33440	292071	4	0	4	0	0	4
33440	292072	4	1	1	0	1	3
33440	292073	4	0	1	2	0	3
33440	292076	4	2	1	0	0	3
33440	292077	4	0	0	1	0	1
33440	292090	4	0	0	0	0	0
33440	382019	4	0	2	0	0	2
33440	382023	4	1	0	0	0	1
33440	382043	4	0	1	0	0	1
33440	382049	4	1	1	0	0	2
33440	382053	4	1	1	0	0	2
33440	382062	4	2	1	1	0	4
33440	382067	4	0	3	0	0	3
33440	382068	4	2	2	0	1	5
33440	382071	4	2	1	0	0	3
33440	382081	4	0	0	0	0	0
33440	382083	4	0	1	0	0	1
33440	382086	4	1	2	0	0	3
33440	382090	4	1	0	0	0	1
33440	382091	4	1	3	1	1	6
33440	382096	4	1	2	0	1	4
33440	382101	4	1	0	0	0	1
33440	382125	4	1	3	0	0	4
33440	382126	4	0	2	0	0	2
33440	382139	4	1	3	0	0	4
33440	382140	4	2	1	0	0	3
33440	382141	4	0	0	0	0	0
33440	382150	4	1	1	0	0	2
33440	382155	4	2	1	0	0	3
33440	382160	4	1	0	0	0	1
33440	382161	4	0	0	0	0	0
33440	382168	4	1	1	0	0	2
33440	382185	4	0	1	0	0	1
33440	382188	4	1	2	0	1	4
33440	382189	4	0	0	0	0	0
33440	382195	4	1	0	0	0	1
33440	382201	4	0	1	0	0	1
33440	382209	4	1	2	0	1	4
33440	382217	4	1	2	0	1	4
33440	382218	4	0	1	0	0	1
33440	382220	4	2	0	0	0	2
33440	382222	4	1	0	0	0	1
33440	382224	4	0	1	0	1	2
33440	382244	4	1	1	0	0	2
33440	382249	4	0	1	0	0	1
33440	382250	4	0	2	0	2	4
33440	382264	4	4	3	0	0	7
33440	382296	4	0	1	0	0	1
33440	382301	4	1	1	0	0	2
33440	382302	4	2	1	0	0	3
33440	382305	4	1	0	0	0	1
33440	382306	4	0	1	0	0	1
33440	382309	4	0	0	0	0	0
33440	382313	4	1	1	0	0	2
33440	51603	4	0	0	0	0	0
33440	64170	4	2	3	0	0	5
33440	64444	4	0	1	2	0	3
33440	67237	4	0	4	0	0	4
33440	67752	4	1	1	0	0	2
33440	71443	4	1	1	0	1	3
33440	71695	4	0	1	0	0	1
33440	74261	4	1	1	0	0	2
33440	85739	4	0	1	0	2	3
33440	86914	4	1	0	1	0	2
33440	89187	4	2	2	0	0	4
33440	92620	4	0	3	0	0	3
33440	97200	4	0	3	0	0	3
33440	100878	3	0	0	0	2	2
33440	104306	3	0	0	1	0	1
33440	186569	3	0	0	0	0	0
33440	211124	3	0	1	0	0	1
33440	220710	3	1	0	1	0	2
33440	292062	3	1	0	0	0	1
33440	292068	3	0	0	0	2	2
33440	292070	3	0	2	0	0	2
33440	382008	3	1	2	0	0	3
33440	382013	3	0	2	0	1	3
33440	382031	3	0	2	0	2	4
33440	382035	3	0	0	0	0	0
33440	382044	3	1	1	0	0	2
33440	382045	3	1	4	0	0	5
33440	382052	3	2	2	0	1	5
33440	382059	3	1	1	0	0	2
33440	382061	3	1	1	0	0	2
33440	382064	3	0	2	0	0	2
33440	382069	3	1	3	0	0	4
33440	382072	3	3	1	0	0	4
33440	382104	3	1	2	0	0	3
33440	382115	3	1	1	0	1	3
33440	382116	3	1	0	0	0	1
33440	382121	3	1	2	0	0	3
33440	382128	3	0	0	1	2	3
33440	382135	3	0	2	0	0	2
33440	382143	3	1	0	0	0	1
33440	382147	3	0	1	0	0	1
33440	382148	3	0	1	0	0	1
33440	382149	3	0	0	0	0	0
33440	382153	3	0	1	0	1	2
33440	382156	3	0	0	0	0	0
33440	382157	3	2	1	0	0	3
33440	382163	3	1	0	0	0	1
33440	382166	3	0	1	1	0	2
33440	382167	3	1	2	1	0	4
33440	382170	3	0	3	0	0	3
33440	382172	3	0	2	0	1	3
33440	382173	3	0	2	0	0	2
33440	382177	3	1	0	0	0	1
33440	382180	3	0	1	0	0	1
33440	382194	3	1	2	0	0	3
33440	382202	3	1	1	0	0	2
33440	382203	3	0	0	0	0	0
33440	382210	3	1	2	0	0	3
33440	382212	3	0	2	1	0	3
33440	382214	3	0	0	0	0	0
33440	382215	3	0	1	0	1	2
33440	382219	3	1	1	0	0	2
33440	382223	3	1	0	0	0	1
33440	382235	3	0	4	0	0	4
33440	382236	3	1	1	0	0	2
33440	382240	3	0	1	0	0	1
33440	382241	3	1	1	0	0	2
33440	382242	3	1	1	0	0	2
33440	382248	3	1	1	0	0	2
33440	382251	3	0	0	0	0	0
33440	382252	3	2	0	0	0	2
33440	382253	3	1	1	0	1	3
33440	382256	3	0	1	0	1	2
33440	382265	3	2	0	0	0	2
33440	382270	3	1	2	0	0	3
33440	382272	3	1	0	0	1	2
33440	382273	3	0	1	0	0	1
33440	382278	3	1	1	0	0	2
33440	382280	3	0	3	0	1	4
33440	382283	3	0	2	0	0	2
33440	382290	3	1	0	0	0	1
33440	382291	3	1	1	0	1	3
33440	382292	3	1	1	0	1	3
33440	382298	3	0	2	0	0	2
33440	382308	3	1	1	0	0	2
33440	382316	3	0	0	0	1	1
33440	65145	3	0	1	0	1	2
33440	67456	3	0	1	0	0	1
33440	73849	3	1	1	0	0	2
33440	83254	3	1	0	0	0	1
33440	89592	3	0	0	0	0	0
33440	91699	3	1	0	0	0	1
33440	92297	3	2	1	0	0	3
33440	92822	3	1	0	0	0	1
33440	181992	2	0	1	0	0	1
33440	195762	2	1	0	0	0	1
33440	292094	2	3	0	0	1	4
33440	382004	2	0	0	0	0	0
33440	382007	2	1	0	0	0	1
33440	382010	2	0	1	0	0	1
33440	382012	2	0	0	0	0	0
33440	382016	2	0	0	1	0	1
33440	382018	2	0	1	0	0	1
33440	382021	2	0	0	0	0	0
33440	382022	2	1	2	0	0	3
33440	382026	2	3	0	0	0	3
33440	382029	2	2	3	0	0	5
33440	382032	2	2	2	0	0	4
33440	382036	2	0	3	0	0	3
33440	382041	2	1	1	0	0	2
33440	382042	2	1	1	0	1	3
33440	382047	2	0	2	0	0	2
33440	382051	2	0	1	0	1	2
33440	382055	2	1	2	0	1	4
33440	382057	2	0	0	0	0	0
33440	382070	2	0	0	0	0	0
33440	382075	2	0	1	0	0	1
33440	382080	2	1	1	0	0	2
33440	382085	2	0	1	0	0	1
33440	382087	2	0	2	0	0	2
33440	382088	2	0	1	0	0	1
33440	382094	2	0	2	0	0	2
33440	382095	2	1	2	0	0	3
33440	382098	2	0	2	1	0	3
33440	382100	2	0	3	0	0	3
33440	382107	2	1	0	0	0	1
33440	382110	2	1	3	2	0	6
33440	382127	2	0	0	0	0	0
33440	382136	2	0	1	0	0	1
33440	382137	2	2	2	0	0	4
33440	382142	2	0	1	0	0	1
33440	382144	2	0	1	0	0	1
33440	382145	2	1	3	0	0	4
33440	382152	2	1	0	0	0	1
33440	382159	2	1	0	0	0	1
33440	382162	2	0	1	0	0	1
33440	382165	2	0	1	0	0	1
33440	382169	2	1	1	0	0	2
33440	382171	2	0	1	0	0	1
33440	382176	2	0	0	0	0	0
33440	382179	2	0	1	0	0	1
33440	382181	2	1	1	0	0	2
33440	382183	2	0	1	0	0	1
33440	382184	2	1	0	0	0	1
33440	382186	2	0	1	0	0	1
33440	382190	2	0	1	0	0	1
33440	382192	2	0	0	0	0	0
33440	382197	2	2	1	0	0	3
33440	382198	2	0	0	0	0	0
33440	382199	2	1	0	0	0	1
33440	382200	2	0	0	0	0	0
33440	382204	2	0	1	0	0	1
33440	382216	2	0	1	0	0	1
33440	382221	2	1	0	0	0	1
33440	382228	2	0	4	0	1	5
33440	382229	2	1	1	0	0	2
33440	382232	2	1	1	0	0	2
33440	382239	2	3	0	0	0	3
33440	382243	2	0	4	0	0	4
33440	382247	2	0	1	0	1	2
33440	382254	2	1	2	0	0	3
33440	382255	2	0	2	0	0	2
33440	382258	2	2	1	0	0	3
33440	382259	2	0	1	0	0	1
33440	382261	2	1	2	0	0	3
33440	382269	2	2	2	0	0	4
33440	382274	2	0	0	0	0	0
33440	382275	2	0	2	0	0	2
33440	382276	2	0	2	0	0	2
33440	382277	2	0	1	0	0	1
33440	382279	2	3	0	1	1	5
33440	382288	2	1	2	0	0	3
33440	382295	2	2	1	0	0	3
33440	382310	2	0	2	0	1	3
33440	382311	2	1	2	0	0	3
33440	49914	2	0	1	0	0	1
33440	57628	2	1	1	0	1	3
33440	87330	2	0	0	0	0	0
33440	96364	2	3	0	0	1	4
33440	99442	2	0	0	0	1	1
33440	191110	1	0	0	0	0	0
33440	205949	1	0	0	0	0	0
33440	220156	1	0	1	0	1	2
33440	292058	1	0	1	0	0	1
33440	292060	1	0	0	0	0	0
33440	292066	1	1	0	0	0	1
33440	292089	1	0	0	0	0	0
33440	382002	1	0	0	0	0	0
33440	382003	1	0	1	0	0	1
33440	382005	1	1	1	0	1	3
33440	382006	1	1	2	0	1	4
33440	382009	1	0	0	0	0	0
33440	382011	1	1	0	0	0	1
33440	382014	1	0	0	0	0	0
33440	382015	1	0	1	0	0	1
33440	382017	1	0	1	0	0	1
33440	382020	1	1	0	0	0	1
33440	382024	1	0	0	0	0	0
33440	382025	1	0	0	0	1	1
33440	382028	1	0	0	0	0	0
33440	382030	1	0	0	0	0	0
33440	382033	1	0	1	0	0	1
33440	382034	1	0	0	0	0	0
33440	382037	1	0	0	0	0	0
33440	382038	1	1	1	0	0	2
33440	382039	1	0	0	0	0	0
33440	382040	1	0	0	0	0	0
33440	382046	1	0	1	0	0	1
33440	382048	1	2	0	0	0	2
33440	382050	1	0	0	0	0	0
33440	382054	1	0	1	0	0	1
33440	382056	1	0	1	0	0	1
33440	382058	1	0	1	0	0	1
33440	382060	1	0	1	1	0	2
33440	382063	1	0	1	0	0	1
33440	382066	1	0	1	0	0	1
33440	382074	1	0	0	1	0	1
33440	382076	1	0	1	0	0	1
33440	382077	1	1	1	0	1	3
33440	382078	1	0	1	0	0	1
33440	382082	1	0	1	0	0	1
33440	382092	1	0	2	0	1	3
33440	382093	1	0	1	0	0	1
33440	382097	1	0	2	0	0	2
33440	382099	1	0	0	0	0	0
33440	382103	1	1	1	0	0	2
33440	382106	1	0	1	0	0	1
33440	382108	1	0	0	0	0	0
33440	382118	1	1	0	0	0	1
33440	382122	1	0	1	0	0	1
33440	382134	1	0	3	0	0	3
33440	382146	1	1	1	0	0	2
33440	382154	1	1	0	0	0	1
33440	382164	1	0	1	0	1	2
33440	382178	1	0	0	0	0	0
33440	382182	1	1	1	0	1	3
33440	382187	1	1	1	0	2	4
33440	382191	1	1	0	0	0	1
33440	382193	1	0	0	0	0	0
33440	382196	1	0	0	0	0	0
33440	382205	1	0	1	0	0	1
33440	382230	1	1	1	1	0	3
33440	382246	1	0	3	1	3	7
33440	382260	1	0	0	0	0	0
33440	382263	1	0	3	0	1	4
33440	382267	1	0	0	0	0	0
33440	382271	1	0	0	0	0	0
33440	382282	1	2	1	0	0	3
33440	382294	1	1	0	0	2	3
33440	382307	1	0	0	0	0	0
33440	61762	1	0	0	0	0	0
33440	71009	1	1	0	0	0	1
33440	71491	1	0	1	0	0	1
33440	90111	1	0	0	0	0	0
22877	608249	28	1	3	0	2	6
22877	608155	24	1	0	2	0	3
22877	608185	19	2	1	1	0	4
22877	608239	19	3	0	1	0	4
22877	289373	18	3	0	1	0	4
22877	607989	17	1	0	0	0	1
22877	607921	16	2	1	1	0	4
22877	607942	16	3	1	1	1	6
22877	289370	14	4	1	1	1	7
22877	607952	14	1	0	0	0	1
22877	607981	14	1	0	0	0	1
22877	289375	13	4	3	1	0	8
22877	607954	13	3	1	0	0	4
22877	289368	12	1	0	0	1	2
22877	607971	12	0	2	0	2	4
22877	608015	12	1	0	0	0	1
22877	71109	12	1	0	0	1	2
22877	183416	11	0	1	0	1	2
22877	607928	11	2	1	2	0	5
22877	607943	11	0	0	0	1	1
22877	608094	11	1	0	0	1	2
22877	608115	11	1	0	0	0	1
22877	608142	11	2	0	0	0	2
22877	608145	11	4	3	1	0	8
22877	608223	11	2	3	0	0	5
22877	607944	10	1	0	0	0	1
22877	607973	10	0	0	0	0	0
22877	608043	10	3	0	3	0	6
22877	608107	10	0	0	0	0	0
22877	608119	10	1	2	0	0	3
22877	608127	10	1	0	2	0	3
22877	214019	9	0	0	1	1	2
22877	289358	9	1	1	1	1	4
22877	289371	9	1	1	1	0	3
22877	607931	9	1	1	1	1	4
22877	607957	9	1	0	0	1	2
22877	608008	9	4	1	1	0	6
22877	608071	9	0	0	0	0	0
22877	608117	9	4	0	0	1	5
22877	608152	9	4	0	2	0	6
22877	608158	9	0	0	1	1	2
22877	608178	9	0	1	0	1	2
22877	608231	9	1	2	0	0	3
22877	608244	9	0	0	0	0	0
22877	608250	9	2	2	0	0	4
22877	608267	9	1	2	0	0	3
22877	73975	9	2	1	1	1	5
22877	202271	8	1	1	1	3	6
22877	289369	8	0	2	4	0	6
22877	607922	8	2	2	1	0	5
22877	607939	8	1	0	1	1	3
22877	607947	8	0	0	0	0	0
22877	607951	8	1	1	0	0	2
22877	607958	8	1	1	0	0	2
22877	607965	8	0	2	1	0	3
22877	607974	8	1	2	2	0	5
22877	607987	8	2	2	0	0	4
22877	607990	8	0	0	0	0	0
22877	608012	8	0	2	0	0	2
22877	608017	8	2	1	2	1	6
22877	608018	8	0	0	2	0	2
22877	608080	8	3	0	0	0	3
22877	608104	8	1	1	0	1	3
22877	608125	8	1	0	0	1	2
22877	608153	8	2	3	2	0	7
22877	608181	8	0	2	0	1	3
22877	608198	8	0	2	0	0	2
22877	608199	8	0	0	1	1	2
22877	608258	8	1	1	1	0	3
22877	608285	8	2	1	0	0	3
22877	187949	7	0	2	1	1	4
22877	198242	7	3	1	0	1	5
22877	206885	7	1	3	1	0	5
22877	216775	7	0	1	0	0	1
22877	607935	7	2	1	0	0	3
22877	607946	7	1	0	0	0	1
22877	607950	7	2	1	0	0	3
22877	607986	7	1	0	0	0	1
22877	607993	7	0	3	0	0	3
22877	608000	7	1	0	0	1	2
22877	608004	7	1	1	1	1	4
22877	608010	7	0	1	1	2	4
22877	608013	7	0	0	0	0	0
22877	608014	7	3	2	0	0	5
22877	608020	7	0	1	0	2	3
22877	608024	7	3	4	0	0	7
22877	608052	7	3	0	0	1	4
22877	608092	7	1	0	0	0	1
22877	608099	7	3	1	1	1	6
22877	608101	7	0	5	0	0	5
22877	608129	7	2	0	1	1	4
22877	608163	7	0	0	0	0	0
22877	608168	7	1	0	0	0	1
22877	608172	7	1	0	1	0	2
22877	608252	7	1	0	0	0	1
22877	608275	7	3	0	0	0	3
22877	206614	6	0	0	0	0	0
22877	213340	6	2	2	0	2	6
22877	216808	6	0	1	0	0	1
22877	289374	6	0	0	0	0	0
22877	607955	6	0	0	0	1	1
22877	607962	6	0	0	2	0	2
22877	607967	6	1	0	1	1	3
22877	607969	6	3	1	0	0	4
22877	607977	6	1	1	0	0	2
22877	607982	6	0	0	0	0	0
22877	607995	6	0	1	0	0	1
22877	607996	6	0	1	0	0	1
22877	607998	6	5	0	0	1	6
22877	608007	6	1	2	0	0	3
22877	608038	6	0	1	0	0	1
22877	608049	6	3	0	0	0	3
22877	608057	6	2	0	0	0	2
22877	608067	6	0	1	0	1	2
22877	608087	6	2	4	2	0	8
22877	608089	6	2	2	1	1	6
22877	608091	6	1	1	0	0	2
22877	608097	6	0	1	0	0	1
22877	608116	6	3	1	2	1	7
22877	608118	6	2	2	0	2	6
22877	608136	6	2	2	0	0	4
22877	608146	6	1	1	0	2	4
22877	608160	6	2	0	0	0	2
22877	608161	6	0	0	1	2	3
22877	608164	6	1	2	0	1	4
22877	608167	6	0	1	0	1	2
22877	608174	6	0	1	0	1	2
22877	608180	6	0	0	0	0	0
22877	608188	6	1	0	0	0	1
22877	608189	6	0	2	1	0	3
22877	608200	6	1	0	0	0	1
22877	608201	6	4	2	0	1	7
22877	608204	6	2	0	0	1	3
22877	608205	6	2	0	0	0	2
22877	608207	6	0	0	0	0	0
22877	608209	6	0	2	1	2	5
22877	608243	6	0	1	0	0	1
22877	608253	6	0	1	0	0	1
22877	608255	6	1	0	0	0	1
22877	608262	6	1	0	1	0	2
22877	608264	6	2	0	1	0	3
22877	608266	6	1	0	2	0	3
22877	608290	6	1	0	0	0	1
22877	608296	6	0	1	1	1	3
22877	608298	6	1	0	0	1	2
22877	65952	6	0	0	0	0	0
22877	101025	5	1	0	1	0	2
22877	183475	5	1	1	0	0	2
22877	186160	5	1	0	1	0	2
22877	196524	5	0	2	0	0	2
22877	198601	5	2	0	0	0	2
22877	202846	5	0	1	0	0	1
22877	203698	5	0	1	0	0	1
22877	203808	5	1	3	0	0	4
22877	204889	5	1	0	0	0	1
22877	205353	5	0	0	0	0	0
22877	207627	5	0	1	0	1	2
22877	218027	5	0	1	1	0	2
22877	289357	5	2	1	0	0	3
22877	289367	5	1	0	0	0	1
22877	289378	5	1	0	1	0	2
22877	57303	5	2	1	0	0	3
22877	607941	5	0	0	0	0	0
22877	607959	5	0	0	0	2	2
22877	607961	5	0	1	0	0	1
22877	607972	5	2	2	0	0	4
22877	607988	5	0	0	1	0	1
22877	608009	5	1	0	1	0	2
22877	608021	5	3	0	0	0	3
22877	608022	5	1	1	0	1	3
22877	608028	5	0	1	0	0	1
22877	608046	5	0	0	0	0	0
22877	608048	5	2	0	0	0	2
22877	608053	5	3	2	0	0	5
22877	608070	5	2	1	0	1	4
22877	608073	5	1	0	0	1	2
22877	608082	5	0	0	1	1	2
22877	608102	5	1	1	0	0	2
22877	608124	5	0	0	1	0	1
22877	608126	5	1	5	0	1	7
22877	608133	5	1	0	2	0	3
22877	608140	5	1	3	0	0	4
22877	608141	5	1	2	1	3	7
22877	608143	5	2	0	0	0	2
22877	608165	5	3	2	1	1	7
22877	608193	5	3	0	0	4	7
22877	608194	5	4	0	0	0	4
22877	608226	5	0	2	0	1	3
22877	608227	5	2	1	0	0	3
22877	608234	5	2	1	0	0	3
22877	608235	5	2	0	1	0	3
22877	608237	5	1	2	0	2	5
22877	608247	5	1	0	0	0	1
22877	608288	5	0	2	1	0	3
22877	608294	5	2	0	0	1	3
22877	182649	4	0	0	0	0	0
22877	185533	4	0	1	0	0	1
22877	194910	4	0	1	0	0	1
22877	203224	4	1	0	0	0	1
22877	207183	4	1	1	0	2	4
22877	207963	4	0	0	1	0	1
22877	208937	4	1	0	0	0	1
22877	216383	4	0	2	0	0	2
22877	217226	4	0	1	1	1	3
22877	217379	4	0	0	1	0	1
22877	218624	4	0	1	0	0	1
22877	219001	4	1	1	0	1	3
22877	289365	4	1	1	0	0	2
22877	289366	4	1	0	1	0	2
22877	607914	4	2	0	0	0	2
22877	607920	4	1	1	1	0	3
22877	607926	4	1	0	0	0	1
22877	607927	4	0	0	0	0	0
22877	607948	4	2	0	0	0	2
22877	607949	4	3	1	2	0	6
22877	607956	4	2	0	0	1	3
22877	607960	4	0	2	0	2	4
22877	607976	4	0	2	0	0	2
22877	607978	4	0	1	0	1	2
22877	607983	4	1	1	1	0	3
22877	607984	4	0	1	0	1	2
22877	607997	4	1	1	0	0	2
22877	607999	4	0	1	0	0	1
22877	608003	4	0	1	2	0	3
22877	608005	4	2	1	0	1	4
22877	608025	4	1	0	0	1	2
22877	608026	4	2	1	0	0	3
22877	608030	4	2	0	0	1	3
22877	608041	4	0	0	0	2	2
22877	608047	4	0	2	0	0	2
22877	608056	4	1	1	0	0	2
22877	608058	4	1	0	0	0	1
22877	608060	4	1	1	0	1	3
22877	608063	4	1	2	0	1	4
22877	608072	4	3	0	0	0	3
22877	608074	4	0	0	0	0	0
22877	608086	4	1	0	0	0	1
22877	608088	4	2	0	0	1	3
22877	608095	4	1	2	0	0	3
22877	608096	4	1	0	0	0	1
22877	608098	4	1	1	0	0	2
22877	608105	4	0	3	0	1	4
22877	608128	4	0	0	2	1	3
22877	608130	4	2	2	0	1	5
22877	608131	4	1	0	0	1	2
22877	608132	4	1	0	1	0	2
22877	608147	4	1	0	0	0	1
22877	608149	4	0	1	0	0	1
22877	608150	4	0	1	0	0	1
22877	608151	4	4	1	0	1	6
22877	608162	4	2	1	0	0	3
22877	608166	4	0	0	0	1	1
22877	608170	4	0	0	0	0	0
22877	608179	4	0	1	0	2	3
22877	608182	4	0	1	0	1	2
22877	608186	4	1	0	0	0	1
22877	608202	4	1	0	0	0	1
22877	608203	4	0	1	0	0	1
22877	608210	4	0	0	0	0	0
22877	608212	4	1	1	1	1	4
22877	608213	4	0	2	0	0	2
22877	608215	4	0	0	0	0	0
22877	608216	4	0	1	0	0	1
22877	608218	4	0	2	0	0	2
22877	608219	4	0	0	0	0	0
22877	608221	4	1	0	0	0	1
22877	608241	4	1	0	0	1	2
22877	608245	4	0	0	0	0	0
22877	608256	4	1	1	0	0	2
22877	608257	4	0	0	0	0	0
22877	608260	4	0	0	0	0	0
22877	608268	4	2	1	0	1	4
22877	608277	4	2	1	0	0	3
22877	608279	4	1	1	0	0	2
22877	608280	4	2	0	0	0	2
22877	608281	4	0	0	0	0	0
22877	608284	4	0	2	3	1	6
22877	608289	4	1	0	0	1	2
22877	608293	4	1	0	0	1	2
22877	608305	4	0	1	0	0	1
22877	70919	4	1	1	0	0	2
22877	184559	3	0	1	0	0	1
22877	184877	3	2	0	0	0	2
22877	189927	3	1	0	0	0	1
22877	192589	3	0	0	1	0	1
22877	198496	3	0	0	0	0	0
22877	199798	3	1	4	0	0	5
22877	200423	3	2	0	0	0	2
22877	204599	3	0	1	1	0	2
22877	204815	3	0	0	0	2	2
22877	208125	3	0	0	0	1	1
22877	208905	3	0	4	0	0	4
22877	211698	3	0	0	0	0	0
22877	211902	3	0	2	0	1	3
22877	215386	3	0	0	0	0	0
22877	216549	3	1	0	0	0	1
22877	289362	3	0	0	0	0	0
22877	289376	3	2	0	0	0	2
22877	289379	3	0	1	1	0	2
22877	54174	3	2	0	0	0	2
22877	607924	3	0	1	0	0	1
22877	607925	3	0	0	0	0	0
22877	607930	3	1	2	1	0	4
22877	607933	3	0	0	0	0	0
22877	607937	3	0	0	0	0	0
22877	607938	3	0	0	0	0	0
22877	607953	3	1	1	0	2	4
22877	607963	3	1	0	0	0	1
22877	607970	3	0	2	0	1	3
22877	607975	3	0	1	0	1	2
22877	607980	3	0	1	0	1	2
22877	607985	3	1	1	0	3	5
22877	607991	3	2	0	0	0	2
22877	607992	3	3	1	1	0	5
22877	607994	3	0	1	0	0	1
22877	608001	3	0	2	0	0	2
22877	608002	3	0	3	0	0	3
22877	608016	3	1	2	0	0	3
22877	608023	3	2	0	0	0	2
22877	608035	3	2	0	0	0	2
22877	608037	3	0	1	0	0	1
22877	608042	3	0	1	0	0	1
22877	608044	3	0	1	0	0	1
22877	608059	3	0	1	1	0	2
22877	608069	3	0	0	0	0	0
22877	608081	3	1	0	0	0	1
22877	608083	3	0	1	0	1	2
22877	608084	3	0	0	0	1	1
22877	608085	3	0	1	0	0	1
22877	608100	3	1	0	0	0	1
22877	608111	3	0	0	0	0	0
22877	608112	3	3	0	0	0	3
22877	608113	3	0	3	1	0	4
22877	608120	3	0	0	1	0	1
22877	608134	3	0	0	0	0	0
22877	608138	3	1	1	0	0	2
22877	608154	3	0	0	0	0	0
22877	608156	3	0	1	1	0	2
22877	608159	3	1	1	0	0	2
22877	608169	3	1	1	0	0	2
22877	608171	3	0	1	0	1	2
22877	608175	3	0	1	0	0	1
22877	608187	3	1	1	0	0	2
22877	608190	3	0	1	0	1	2
22877	608191	3	0	1	0	0	1
22877	608192	3	1	1	0	0	2
22877	608206	3	1	0	1	3	5
22877	608211	3	0	4	0	0	4
22877	608214	3	0	0	3	0	3
22877	608217	3	1	2	1	0	4
22877	608220	3	0	0	0	2	2
22877	608222	3	1	1	0	1	3
22877	608229	3	1	0	1	0	2
22877	608233	3	0	2	0	0	2
22877	608242	3	0	0	0	1	1
22877	608246	3	1	0	0	0	1
22877	608254	3	0	0	0	1	1
22877	608265	3	0	1	1	0	2
22877	608269	3	0	1	0	0	1
22877	608272	3	0	0	0	0	0
22877	608274	3	2	0	0	0	2
22877	608278	3	1	1	0	0	2
22877	608282	3	2	0	3	0	5
22877	608286	3	1	2	0	0	3
22877	608291	3	1	2	0	0	3
22877	608295	3	1	1	0	0	2
22877	608297	3	0	1	0	0	1
22877	608300	3	0	0	0	1	1
22877	608301	3	0	1	0	0	1
22877	82096	3	0	1	1	0	2
22877	186615	2	0	2	0	0	2
22877	193031	2	0	0	0	0	0
22877	193737	2	0	0	0	0	0
22877	195806	2	3	0	1	0	4
22877	198256	2	0	2	0	0	2
22877	206285	2	0	0	0	0	0
22877	208822	2	0	2	0	1	3
22877	211174	2	0	2	0	0	2
22877	215747	2	1	1	0	1	3
22877	217418	2	1	0	0	0	1
22877	289359	2	1	0	0	0	1
22877	289360	2	1	0	0	0	1
22877	289361	2	0	0	0	0	0
22877	289363	2	1	1	0	1	3
22877	289364	2	0	1	0	0	1
22877	289377	2	1	0	1	0	2
22877	607912	2	0	0	0	0	0
22877	607913	2	0	0	0	0	0
22877	607915	2	0	0	0	0	0
22877	607918	2	0	0	0	0	0
22877	607923	2	0	0	0	0	0
22877	607929	2	0	2	0	0	2
22877	607932	2	1	0	0	0	1
22877	607934	2	1	0	0	3	4
22877	607940	2	2	0	0	0	2
22877	607964	2	0	2	0	0	2
22877	607966	2	0	1	0	0	1
22877	607979	2	1	0	0	0	1
22877	608027	2	0	0	0	1	1
22877	608029	2	1	0	0	0	1
22877	608032	2	0	0	0	0	0
22877	608033	2	0	1	0	1	2
22877	608036	2	0	0	0	1	1
22877	608039	2	0	1	0	0	1
22877	608040	2	1	0	0	1	2
22877	608045	2	0	0	0	1	1
22877	608050	2	0	1	0	0	1
22877	608054	2	0	0	2	3	5
22877	608061	2	2	0	1	0	3
22877	608062	2	1	1	2	0	4
22877	608065	2	0	1	0	0	1
22877	608075	2	1	0	0	0	1
22877	608076	2	1	1	0	1	3
22877	608077	2	0	1	0	0	1
22877	608079	2	1	1	0	0	2
22877	608093	2	0	0	0	1	1
22877	608103	2	0	1	0	0	1
22877	608106	2	0	0	0	0	0
22877	608108	2	0	0	1	0	1
22877	608110	2	0	1	0	0	1
22877	608114	2	0	0	0	1	1
22877	608121	2	0	0	0	0	0
22877	608122	2	0	0	0	1	1
22877	608123	2	0	0	0	0	0
22877	608135	2	0	0	0	0	0
22877	608137	2	1	1	0	0	2
22877	608139	2	1	1	0	0	2
22877	608144	2	1	0	0	0	1
22877	608148	2	0	2	0	0	2
22877	608157	2	0	1	0	0	1
22877	608173	2	0	2	1	0	3
22877	608176	2	0	0	0	0	0
22877	608177	2	1	0	0	0	1
22877	608183	2	0	0	0	1	1
22877	608184	2	0	1	0	1	2
22877	608195	2	1	1	0	0	2
22877	608196	2	3	0	0	0	3
22877	608224	2	0	0	0	2	2
22877	608225	2	3	0	1	0	4
22877	608228	2	0	2	0	0	2
22877	608230	2	1	1	0	0	2
22877	608232	2	0	1	0	0	1
22877	608236	2	1	1	0	0	2
22877	608261	2	2	0	0	0	2
22877	608263	2	0	1	0	0	1
22877	608270	2	1	0	0	0	1
22877	608271	2	1	1	0	1	3
22877	608273	2	0	2	3	0	5
22877	608276	2	0	0	0	0	0
22877	608283	2	2	2	0	0	4
22877	608287	2	0	0	0	1	1
22877	608302	2	2	1	0	0	3
22877	608304	2	0	0	0	0	0
22877	79118	2	1	0	0	0	1
22877	84402	2	0	0	0	0	0
22877	206332	1	1	0	0	0	1
22877	206905	1	1	0	0	0	1
22877	210151	1	0	1	0	0	1
22877	289372	1	0	1	0	0	1
22877	607916	1	0	1	0	0	1
22877	607917	1	0	0	0	0	0
22877	607919	1	0	0	0	0	0
22877	607936	1	0	0	0	0	0
22877	607945	1	0	0	0	0	0
22877	607968	1	0	0	0	0	0
22877	608006	1	0	0	0	0	0
22877	608011	1	1	0	0	0	1
22877	608019	1	0	0	0	0	0
22877	608031	1	0	1	0	0	1
22877	608034	1	3	0	0	2	5
22877	608051	1	2	0	0	0	2
22877	608055	1	0	0	0	0	0
22877	608064	1	0	2	2	0	4
22877	608066	1	0	1	0	1	2
22877	608068	1	0	1	0	0	1
22877	608078	1	0	0	0	1	1
22877	608090	1	0	0	1	1	2
22877	608109	1	0	0	1	0	1
22877	608197	1	1	0	0	0	1
22877	608208	1	0	0	1	0	1
22877	608238	1	0	0	0	0	0
22877	608240	1	0	0	0	1	1
22877	608248	1	0	0	1	0	1
22877	608251	1	1	0	0	0	1
22877	608259	1	0	0	0	0	0
22877	608292	1	0	0	0	1	1
22877	608299	1	1	0	0	0	1
22877	608303	1	1	1	0	1	3
54138	88208	41	3	10	2	2	17
54138	198942	31	1	2	0	3	6
54138	297375	30	1	2	0	3	6
54138	74485	30	1	2	0	3	6
54138	297385	24	2	2	0	3	7
54138	75109	24	1	0	0	0	1
54138	97776	24	2	2	0	3	7
54138	66261	21	2	5	0	1	8
54138	297371	18	0	3	1	4	8
54138	92108	18	0	3	1	4	8
54138	83150	17	1	2	0	1	4
54138	55200	16	1	9	0	2	12
54138	221845	15	1	3	0	0	4
54138	50404	12	3	0	0	0	3
54138	214421	11	1	2	0	2	5
54138	440353	11	2	6	0	0	8
54138	212994	10	1	3	0	2	6
54138	440374	10	2	5	2	0	9
54138	440410	10	0	2	0	1	3
54138	440438	10	3	1	0	4	8
54138	440452	10	3	1	0	1	5
54138	440560	10	3	3	0	1	7
54138	76134	10	2	2	0	1	5
54138	100334	9	0	0	0	0	0
54138	440342	9	1	2	0	1	4
54138	53590	9	0	0	0	0	0
54138	104263	8	0	2	0	2	4
54138	183375	8	1	3	2	1	7
54138	195257	8	0	2	0	0	2
54138	297382	8	1	2	0	0	3
54138	440355	8	0	2	0	0	2
54138	440383	8	1	3	2	1	7
54138	440412	8	1	1	0	0	2
54138	440429	8	4	1	0	0	5
54138	440574	8	0	2	0	1	3
54138	440586	8	3	1	0	2	6
54138	440598	8	1	1	0	0	2
54138	440621	8	3	4	1	1	9
54138	51979	8	2	1	0	0	3
54138	108369	7	1	2	0	2	5
54138	440345	7	0	1	0	0	1
54138	440347	7	0	0	0	1	1
54138	440360	7	2	0	0	1	3
54138	440378	7	0	4	0	0	4
54138	440392	7	2	0	0	2	4
54138	440422	7	3	2	0	1	6
54138	440459	7	1	2	1	0	4
54138	440466	7	0	5	0	2	7
54138	440508	7	1	6	0	2	9
54138	440556	7	0	1	0	0	1
54138	440575	7	1	0	0	0	1
54138	440577	7	1	4	2	0	7
54138	440601	7	1	0	1	1	3
54138	440620	7	1	7	0	1	9
54138	440624	7	1	2	0	0	3
54138	440628	7	1	1	0	0	2
54138	440639	7	2	4	0	3	9
54138	102790	6	0	1	0	1	2
54138	205237	6	1	1	0	3	5
54138	208179	6	2	2	0	0	4
54138	297373	6	1	3	0	1	5
54138	440384	6	2	1	0	0	3
54138	440388	6	4	1	0	0	5
54138	440395	6	4	1	0	1	6
54138	440400	6	1	2	0	0	3
54138	440433	6	1	3	0	1	5
54138	440484	6	2	0	0	2	4
54138	440540	6	1	3	0	1	5
54138	440541	6	2	1	0	0	3
54138	440544	6	2	2	0	0	4
54138	440548	6	4	3	0	2	9
54138	440550	6	1	1	0	0	2
54138	440559	6	0	1	0	0	1
54138	440584	6	1	1	0	0	2
54138	440591	6	0	0	0	1	1
54138	440597	6	2	1	0	0	3
54138	440662	6	0	3	0	0	3
54138	66000	6	1	3	0	1	5
54138	67599	6	2	0	1	0	3
54138	69255	6	1	1	0	0	2
54138	85964	6	0	1	0	2	3
54138	104734	5	1	0	0	3	4
54138	193577	5	0	2	0	0	2
54138	209229	5	1	1	0	0	2
54138	210844	5	2	1	0	0	3
54138	297377	5	1	0	0	2	3
54138	297378	5	2	3	0	2	7
54138	297381	5	0	0	0	0	0
54138	440359	5	2	0	0	0	2
54138	440364	5	0	0	0	4	4
54138	440370	5	3	1	0	1	5
54138	440371	5	0	0	0	0	0
54138	440387	5	0	3	0	0	3
54138	440389	5	1	1	0	0	2
54138	440394	5	1	1	0	0	2
54138	440396	5	0	0	0	2	2
54138	440398	5	0	2	0	0	2
54138	440399	5	0	2	0	0	2
54138	440408	5	2	2	0	0	4
54138	440426	5	0	0	0	0	0
54138	440427	5	0	0	0	0	0
54138	440430	5	1	1	0	0	2
54138	440432	5	0	2	0	0	2
54138	440435	5	0	0	0	0	0
54138	440443	5	1	2	0	0	3
54138	440456	5	0	1	0	0	1
54138	440474	5	1	0	0	1	2
54138	440476	5	0	2	0	0	2
54138	440480	5	0	1	0	2	3
54138	440485	5	1	2	0	0	3
54138	440487	5	0	1	0	1	2
54138	440492	5	2	0	0	0	2
54138	440497	5	4	0	0	1	5
54138	440500	5	2	0	0	0	2
54138	440503	5	0	1	0	0	1
54138	440506	5	2	3	0	0	5
54138	440509	5	3	0	1	2	6
54138	440513	5	1	2	0	0	3
54138	440528	5	2	0	0	1	3
54138	440529	5	1	2	0	0	3
54138	440534	5	2	1	0	0	3
54138	440536	5	0	2	0	0	2
54138	440537	5	0	3	0	0	3
54138	440558	5	1	2	0	0	3
54138	440561	5	0	0	0	1	1
54138	440562	5	1	1	0	2	4
54138	440609	5	0	2	0	1	3
54138	440626	5	2	1	0	0	3
54138	52538	5	0	0	0	0	0
54138	55502	5	2	1	0	0	3
54138	58609	5	1	1	0	0	2
54138	198085	4	2	0	0	0	2
54138	207228	4	0	1	0	2	3
54138	211418	4	1	1	0	1	3
54138	215208	4	0	1	0	0	1
54138	216677	4	1	2	0	1	4
54138	297372	4	0	1	0	0	1
54138	297379	4	2	2	0	0	4
54138	440344	4	1	0	0	0	1
54138	440348	4	0	0	0	0	0
54138	440349	4	0	2	0	2	4
54138	440363	4	2	1	0	4	7
54138	440372	4	1	0	0	0	1
54138	440375	4	0	1	0	0	1
54138	440376	4	0	3	0	0	3
54138	440377	4	1	1	0	1	3
54138	440379	4	0	1	0	0	1
54138	440397	4	2	0	0	0	2
54138	440401	4	1	1	0	0	2
54138	440405	4	1	1	0	0	2
54138	440413	4	2	1	0	3	6
54138	440414	4	2	1	0	1	4
54138	440415	4	2	0	0	1	3
54138	440416	4	0	0	0	0	0
54138	440418	4	1	1	0	1	3
54138	440419	4	1	0	0	0	1
54138	440436	4	0	0	0	0	0
54138	440469	4	0	0	0	0	0
54138	440471	4	0	1	0	1	2
54138	440479	4	0	0	0	1	1
54138	440482	4	2	2	0	0	4
54138	440490	4	0	1	0	1	2
54138	440502	4	2	1	0	1	4
54138	440504	4	1	0	0	0	1
54138	440505	4	0	3	0	0	3
54138	440510	4	0	3	0	3	6
54138	440514	4	0	2	0	0	2
54138	440515	4	0	2	0	1	3
54138	440518	4	1	1	0	1	3
54138	440522	4	1	1	0	0	2
54138	440525	4	1	1	0	0	2
54138	440527	4	2	2	0	0	4
54138	440530	4	1	0	1	1	3
54138	440533	4	1	1	0	0	2
54138	440546	4	2	4	0	0	6
54138	440549	4	2	0	0	0	2
54138	440551	4	1	4	0	1	6
54138	440555	4	1	1	0	0	2
54138	440565	4	0	1	0	0	1
54138	440566	4	2	1	0	2	5
54138	440570	4	1	0	0	0	1
54138	440573	4	1	1	0	0	2
54138	440585	4	2	0	0	0	2
54138	440590	4	1	0	0	1	2
54138	440595	4	0	1	0	2	3
54138	440599	4	0	1	1	1	3
54138	440600	4	0	0	0	0	0
54138	440603	4	1	1	0	0	2
54138	440606	4	0	1	0	0	1
54138	440607	4	1	5	0	0	6
54138	440608	4	1	0	0	0	1
54138	440611	4	0	2	0	1	3
54138	440612	4	2	0	0	0	2
54138	440616	4	1	0	0	0	1
54138	440618	4	0	2	0	0	2
54138	440623	4	0	0	0	0	0
54138	440627	4	1	1	0	0	2
54138	440629	4	1	1	0	0	2
54138	440631	4	3	0	0	1	4
54138	440643	4	1	1	1	1	4
54138	440650	4	0	4	0	0	4
54138	440657	4	0	2	0	0	2
54138	440658	4	2	3	0	0	5
54138	51541	4	1	3	0	1	5
54138	56053	4	0	1	0	0	1
54138	63151	4	0	2	0	1	3
54138	71519	4	0	1	0	0	1
54138	79198	4	2	2	0	0	4
54138	84112	4	1	0	0	0	1
54138	98308	4	1	0	0	0	1
54138	101819	3	0	1	0	1	2
54138	104114	3	1	0	0	0	1
54138	200641	3	1	0	0	0	1
54138	203841	3	0	3	0	0	3
54138	204977	3	1	2	0	0	3
54138	206201	3	0	2	0	0	2
54138	212981	3	0	2	0	0	2
54138	214301	3	0	1	0	1	2
54138	218626	3	4	1	0	0	5
54138	221070	3	1	1	0	1	3
54138	221603	3	0	0	0	0	0
54138	297376	3	0	1	0	1	2
54138	297380	3	1	0	0	0	1
54138	297384	3	0	2	0	0	2
54138	297388	3	0	2	0	0	2
54138	297389	3	0	2	0	2	4
54138	440356	3	2	0	0	0	2
54138	440361	3	2	0	0	0	2
54138	440362	3	0	0	0	2	2
54138	440365	3	0	1	0	1	2
54138	440368	3	0	1	0	1	2
54138	440369	3	0	1	0	1	2
54138	440381	3	1	2	0	0	3
54138	440382	3	1	2	0	0	3
54138	440385	3	1	0	0	0	1
54138	440390	3	0	1	0	0	1
54138	440391	3	0	0	0	0	0
54138	440402	3	0	1	0	1	2
54138	440404	3	1	1	0	0	2
54138	440406	3	1	1	0	1	3
54138	440407	3	1	1	0	0	2
54138	440417	3	2	0	0	0	2
54138	440420	3	1	0	0	0	1
54138	440421	3	0	1	0	2	3
54138	440423	3	1	0	0	0	1
54138	440424	3	2	1	0	1	4
54138	440437	3	1	1	0	0	2
54138	440445	3	0	1	0	0	1
54138	440446	3	0	1	0	1	2
54138	440451	3	1	0	0	0	1
54138	440453	3	3	2	0	1	6
54138	440454	3	1	0	0	0	1
54138	440455	3	0	1	0	0	1
54138	440457	3	1	1	0	0	2
54138	440461	3	0	1	0	0	1
54138	440470	3	2	0	0	0	2
54138	440473	3	1	1	0	0	2
54138	440477	3	0	1	0	0	1
54138	440481	3	0	2	0	1	3
54138	440483	3	0	2	0	0	2
54138	440489	3	0	2	0	0	2
54138	440491	3	0	1	1	2	4
54138	440493	3	0	0	0	1	1
54138	440494	3	0	1	0	1	2
54138	440495	3	0	1	0	0	1
54138	440498	3	2	0	0	0	2
54138	440511	3	0	1	0	0	1
54138	440516	3	0	0	0	0	0
54138	440519	3	0	1	0	0	1
54138	440520	3	0	0	0	2	2
54138	440523	3	1	1	0	0	2
54138	440543	3	0	3	0	1	4
54138	440547	3	0	2	0	3	5
54138	440553	3	0	1	0	0	1
54138	440557	3	0	1	0	2	3
54138	440563	3	3	2	0	1	6
54138	440567	3	2	0	0	0	2
54138	440569	3	2	0	0	0	2
54138	440571	3	1	2	0	1	4
54138	440572	3	0	3	0	0	3
54138	440576	3	1	0	0	1	2
54138	440578	3	0	3	0	0	3
54138	440587	3	0	1	0	0	1
54138	440589	3	0	2	0	0	2
54138	440593	3	1	0	0	0	1
54138	440594	3	2	0	1	0	3
54138	440613	3	1	0	0	0	1
54138	440614	3	0	1	0	0	1
54138	440615	3	1	0	0	0	1
54138	440619	3	0	1	0	1	2
54138	440622	3	0	2	0	0	2
54138	440625	3	0	2	0	1	3
54138	440633	3	1	0	0	0	1
54138	440634	3	2	3	0	0	5
54138	440636	3	1	6	0	0	7
54138	440640	3	1	0	0	0	1
54138	440645	3	1	0	0	2	3
54138	440646	3	1	1	0	0	2
54138	440647	3	1	1	0	0	2
54138	440649	3	0	2	0	1	3
54138	440652	3	1	3	0	0	4
54138	440653	3	0	1	0	0	1
54138	440655	3	1	1	0	0	2
54138	440656	3	1	2	0	0	3
54138	440659	3	0	1	1	1	3
54138	440661	3	1	4	0	0	5
54138	91010	3	1	0	0	0	1
54138	93338	3	0	0	0	0	0
54138	185771	2	0	0	0	0	0
54138	186229	2	0	0	0	0	0
54138	190409	2	0	1	0	0	1
54138	193200	2	1	1	0	1	3
54138	200067	2	1	1	0	0	2
54138	203166	2	0	1	0	0	1
54138	204897	2	1	1	0	0	2
54138	206217	2	0	0	0	0	0
54138	207669	2	0	0	0	0	0
54138	210757	2	1	1	0	0	2
54138	212337	2	0	0	0	0	0
54138	213861	2	0	0	0	1	1
54138	214014	2	0	0	0	0	0
54138	217221	2	0	1	0	0	1
54138	219896	2	1	2	0	0	3
54138	219985	2	0	2	0	0	2
54138	297383	2	1	2	0	0	3
54138	297386	2	0	3	0	1	4
54138	440346	2	0	0	1	0	1
54138	440350	2	0	1	0	0	1
54138	440351	2	0	0	0	1	1
54138	440352	2	2	1	0	1	4
54138	440357	2	1	1	0	1	3
54138	440373	2	2	1	0	0	3
54138	440386	2	0	1	0	0	1
54138	440403	2	0	1	0	0	1
54138	440409	2	0	1	0	0	1
54138	440411	2	0	1	0	0	1
54138	440425	2	0	1	0	0	1
54138	440428	2	0	0	0	1	1
54138	440431	2	0	3	0	0	3
54138	440434	2	0	0	0	0	0
54138	440440	2	0	3	0	0	3
54138	440441	2	0	0	0	1	1
54138	440442	2	0	2	0	2	4
54138	440447	2	0	1	0	1	2
54138	440449	2	0	0	2	2	4
54138	440450	2	1	2	0	0	3
54138	440458	2	0	2	0	0	2
54138	440460	2	0	2	0	0	2
54138	440462	2	0	2	1	0	3
54138	440464	2	1	0	0	0	1
54138	440465	2	2	1	0	0	3
54138	440467	2	0	0	0	0	0
54138	440472	2	0	1	0	0	1
54138	440475	2	0	2	0	0	2
54138	440478	2	0	1	0	0	1
54138	440486	2	0	0	0	0	0
54138	440496	2	0	1	0	0	1
54138	440501	2	0	0	0	0	0
54138	440507	2	0	1	0	0	1
54138	440517	2	0	1	0	2	3
54138	440526	2	0	1	0	0	1
54138	440531	2	0	3	0	0	3
54138	440532	2	0	1	0	2	3
54138	440535	2	1	3	0	2	6
54138	440538	2	2	1	0	0	3
54138	440539	2	1	1	0	1	3
54138	440542	2	0	0	0	1	1
54138	440545	2	2	0	0	0	2
54138	440564	2	0	0	0	0	0
54138	440568	2	1	0	0	1	2
54138	440580	2	1	1	0	0	2
54138	440581	2	1	0	0	0	1
54138	440582	2	0	0	0	0	0
54138	440588	2	1	1	0	0	2
54138	440596	2	2	0	0	0	2
54138	440604	2	0	2	0	2	4
54138	440617	2	0	1	0	0	1
54138	440637	2	0	2	1	1	4
54138	440641	2	2	1	0	0	3
54138	440644	2	0	0	0	0	0
54138	440648	2	1	0	0	0	1
54138	440651	2	1	1	0	0	2
54138	440654	2	0	1	0	0	1
54138	440660	2	1	0	0	0	1
54138	70833	2	0	3	0	1	4
54138	72225	2	0	2	0	0	2
54138	103002	1	0	2	0	0	2
54138	202965	1	0	0	0	0	0
54138	212025	1	0	0	0	0	0
54138	216876	1	0	0	0	1	1
54138	297374	1	0	2	0	0	2
54138	297387	1	0	0	0	0	0
54138	440341	1	0	1	0	0	1
54138	440343	1	0	1	0	0	1
54138	440354	1	0	4	0	0	4
54138	440358	1	1	2	0	2	5
54138	440380	1	0	0	0	0	0
54138	440393	1	2	2	0	1	5
54138	440439	1	0	0	1	0	1
54138	440444	1	0	0	0	0	0
54138	440448	1	0	2	0	0	2
54138	440463	1	2	0	0	1	3
54138	440468	1	2	1	0	0	3
54138	440499	1	0	1	0	0	1
54138	440512	1	0	0	0	1	1
54138	440521	1	0	1	0	0	1
54138	440524	1	1	0	0	0	1
54138	440552	1	1	0	0	0	1
54138	440554	1	0	3	0	0	3
54138	440579	1	1	0	0	0	1
54138	440583	1	0	1	0	0	1
54138	440592	1	1	0	0	0	1
54138	440602	1	0	1	0	0	1
54138	440605	1	0	0	0	1	1
54138	440610	1	2	1	0	2	5
54138	440630	1	1	1	0	1	3
54138	440632	1	1	1	0	0	2
54138	440635	1	1	2	0	0	3
54138	440638	1	0	1	0	1	2
54138	440642	1	0	0	0	0	0
19078	479982	47	5	0	1	0	6
19078	480029	21	2	0	0	1	3
19078	480089	16	1	0	0	2	3
19078	480084	14	2	3	0	2	7
19078	479872	13	2	1	0	1	4
19078	480068	13	2	0	0	1	3
19078	480080	13	3	0	1	3	7
19078	288290	12	0	0	0	0	0
19078	210997	11	0	0	0	0	0
19078	479779	11	1	0	2	1	4
19078	479794	11	0	0	0	0	0
19078	479912	11	1	0	0	2	3
19078	480057	11	1	1	0	3	5
19078	479846	10	1	1	0	5	7
19078	479950	10	1	0	0	0	1
19078	479980	10	1	1	0	5	7
19078	479815	9	2	0	0	0	2
19078	479926	9	2	2	3	0	7
19078	480004	9	1	0	0	0	1
19078	480042	9	3	2	0	2	7
19078	480049	9	3	0	0	0	3
19078	480085	9	1	1	0	1	3
19078	479863	8	1	0	0	0	1
19078	479922	8	0	0	0	0	0
19078	479987	8	2	1	1	4	8
19078	200626	7	1	3	0	1	5
19078	209184	7	3	2	0	1	6
19078	212274	7	2	0	0	1	3
19078	479778	7	2	0	0	1	3
19078	479791	7	0	0	0	4	4
19078	479809	7	1	2	0	3	6
19078	479856	7	2	1	0	0	3
19078	479945	7	0	1	0	1	2
19078	479953	7	2	1	0	2	5
19078	479983	7	2	1	0	2	5
19078	480040	7	2	2	0	2	6
19078	480048	7	2	0	0	1	3
19078	480055	7	0	0	0	0	0
19078	480109	7	3	0	0	1	4
19078	480124	7	1	1	0	1	3
19078	288295	6	1	2	0	1	4
19078	479789	6	1	2	0	1	4
19078	479797	6	0	1	0	1	2
19078	479820	6	1	1	1	0	3
19078	479829	6	1	0	0	3	4
19078	479842	6	2	2	0	0	4
19078	479850	6	1	1	0	0	2
19078	479864	6	1	0	2	1	4
19078	479869	6	0	0	0	0	0
19078	479875	6	1	0	0	1	2
19078	479878	6	0	2	0	0	2
19078	479919	6	4	1	0	2	7
19078	479924	6	0	2	0	3	5
19078	479935	6	2	0	0	0	2
19078	479944	6	1	2	0	0	3
19078	479954	6	1	0	0	0	1
19078	479963	6	1	0	0	1	2
19078	479969	6	6	0	0	1	7
19078	479976	6	0	1	1	1	3
19078	479995	6	0	0	1	1	2
19078	480015	6	1	1	0	0	2
19078	480018	6	2	2	0	0	4
19078	480021	6	2	0	0	0	2
19078	480026	6	0	0	0	1	1
19078	480054	6	2	1	0	0	3
19078	480073	6	1	1	0	0	2
19078	480083	6	2	0	0	0	2
19078	480088	6	1	6	0	1	8
19078	206237	5	3	0	0	0	3
19078	219848	5	0	1	0	0	1
19078	288294	5	0	1	1	1	3
19078	479785	5	2	1	0	0	3
19078	479792	5	2	1	0	0	3
19078	479800	5	1	0	0	2	3
19078	479814	5	2	0	0	0	2
19078	479816	5	1	1	0	0	2
19078	479830	5	1	2	0	3	6
19078	479833	5	0	1	0	0	1
19078	479835	5	3	0	0	2	5
19078	479839	5	3	1	0	1	5
19078	479840	5	4	0	0	3	7
19078	479845	5	1	1	1	0	3
19078	479853	5	1	0	0	0	1
19078	479860	5	0	1	0	0	1
19078	479873	5	1	1	0	0	2
19078	479883	5	0	1	0	1	2
19078	479886	5	0	2	0	0	2
19078	479896	5	0	0	0	0	0
19078	479899	5	1	1	1	0	3
19078	479905	5	1	1	0	1	3
19078	479925	5	0	0	0	0	0
19078	479929	5	0	1	0	0	1
19078	479946	5	0	1	0	1	2
19078	479948	5	0	2	0	0	2
19078	479951	5	2	2	1	1	6
19078	479960	5	0	0	0	1	1
19078	479961	5	0	0	0	1	1
19078	479981	5	1	1	0	0	2
19078	479992	5	1	3	0	1	5
19078	479993	5	0	0	0	0	0
19078	479994	5	1	1	0	0	2
19078	479996	5	0	0	0	0	0
19078	480001	5	1	1	0	0	2
19078	480002	5	0	0	0	0	0
19078	480007	5	1	1	0	1	3
19078	480008	5	1	1	0	1	3
19078	480019	5	0	2	0	1	3
19078	480022	5	0	2	1	3	6
19078	480031	5	1	1	0	3	5
19078	480050	5	0	2	0	2	4
19078	480052	5	2	0	0	1	3
19078	480058	5	1	0	0	0	1
19078	480059	5	0	0	0	1	1
19078	480074	5	1	1	0	1	3
19078	480077	5	1	1	0	0	2
19078	480081	5	3	1	0	0	4
19078	480082	5	0	0	0	0	0
19078	480086	5	1	0	0	0	1
19078	480090	5	0	0	0	0	0
19078	480093	5	0	0	0	0	0
19078	480108	5	0	1	0	0	1
19078	184292	4	3	1	0	0	4
19078	185060	4	0	0	0	0	0
19078	189861	4	1	0	0	0	1
19078	198592	4	0	0	0	0	0
19078	206662	4	0	0	0	2	2
19078	207330	4	0	0	0	0	0
19078	207641	4	2	0	0	0	2
19078	208123	4	0	0	0	0	0
19078	479774	4	2	1	0	2	5
19078	479782	4	1	0	0	1	2
19078	479793	4	1	0	0	1	2
19078	479796	4	1	1	0	0	2
19078	479798	4	0	1	0	0	1
19078	479802	4	0	2	0	0	2
19078	479811	4	2	0	0	0	2
19078	479824	4	2	1	0	0	3
19078	479837	4	1	1	0	0	2
19078	479844	4	2	0	0	0	2
19078	479851	4	0	0	0	0	0
19078	479859	4	0	1	0	0	1
19078	479866	4	2	1	0	1	4
19078	479867	4	1	1	0	0	2
19078	479870	4	1	1	0	0	2
19078	479890	4	1	0	1	0	2
19078	479895	4	0	2	0	0	2
19078	479904	4	0	1	0	0	1
19078	479908	4	1	0	0	2	3
19078	479913	4	0	1	0	0	1
19078	479915	4	1	0	0	0	1
19078	479917	4	0	0	0	2	2
19078	479918	4	0	0	0	0	0
19078	479920	4	0	0	0	0	0
19078	479921	4	0	0	0	0	0
19078	479927	4	0	1	0	1	2
19078	479941	4	2	1	0	0	3
19078	479952	4	2	0	1	0	3
19078	479955	4	0	1	0	3	4
19078	479962	4	1	1	0	0	2
19078	479966	4	2	0	0	1	3
19078	479970	4	0	1	0	2	3
19078	479974	4	1	1	0	0	2
19078	479975	4	1	0	0	0	1
19078	479986	4	1	2	0	1	4
19078	479988	4	0	2	0	0	2
19078	479989	4	1	0	0	2	3
19078	479998	4	0	0	0	0	0
19078	480003	4	0	1	0	0	1
19078	480020	4	0	2	0	0	2
19078	480025	4	3	0	0	0	3
19078	480027	4	1	0	0	1	2
19078	480028	4	1	0	0	0	1
19078	480033	4	0	0	0	1	1
19078	480038	4	1	1	0	0	2
19078	480039	4	0	1	0	0	1
19078	480047	4	1	0	0	0	1
19078	480053	4	0	2	0	0	2
19078	480066	4	0	0	0	0	0
19078	480075	4	0	1	1	1	3
19078	480076	4	2	1	0	0	3
19078	480087	4	2	1	0	0	3
19078	480091	4	2	1	0	0	3
19078	480092	4	0	0	0	0	0
19078	480094	4	1	1	0	0	2
19078	480096	4	1	1	0	0	2
19078	480099	4	0	0	0	0	0
19078	480100	4	1	2	0	0	3
19078	480103	4	0	1	0	1	2
19078	480105	4	0	1	0	1	2
19078	480114	4	0	0	0	0	0
19078	480116	4	1	3	0	1	5
19078	480123	4	2	1	0	0	3
19078	183219	3	3	0	0	1	4
19078	187907	3	1	2	0	0	3
19078	188498	3	0	0	0	1	1
19078	192389	3	0	0	0	1	1
19078	195654	3	0	0	0	0	0
19078	198082	3	1	0	0	2	3
19078	200110	3	0	0	0	1	1
19078	204596	3	2	0	0	0	2
19078	205341	3	0	1	0	1	2
19078	205542	3	0	1	1	0	2
19078	206981	3	0	0	0	0	0
19078	211903	3	0	0	0	0	0
19078	215376	3	0	0	0	0	0
19078	217222	3	1	1	0	0	2
19078	288296	3	1	1	0	0	2
19078	479775	3	0	2	0	0	2
19078	479776	3	0	1	0	3	4
19078	479781	3	2	1	0	0	3
19078	479783	3	2	1	0	0	3
19078	479790	3	1	1	2	1	5
19078	479795	3	0	0	0	0	0
19078	479801	3	0	1	0	1	2
19078	479810	3	1	1	0	2	4
19078	479819	3	0	2	0	0	2
19078	479822	3	0	1	0	0	1
19078	479827	3	2	0	0	1	3
19078	479828	3	0	0	0	2	2
19078	479831	3	0	1	0	2	3
19078	479832	3	0	3	2	0	5
19078	479834	3	2	0	0	1	3
19078	479838	3	0	2	0	1	3
19078	479857	3	1	1	0	0	2
19078	479858	3	0	0	0	0	0
19078	479862	3	1	0	0	0	1
19078	479868	3	0	1	0	3	4
19078	479876	3	0	0	0	1	1
19078	479879	3	1	2	0	0	3
19078	479881	3	1	0	0	0	1
19078	479882	3	0	0	0	1	1
19078	479884	3	0	0	0	0	0
19078	479885	3	1	0	0	0	1
19078	479893	3	2	2	0	0	4
19078	479903	3	1	1	0	0	2
19078	479914	3	0	0	0	0	0
19078	479928	3	0	0	0	0	0
19078	479931	3	0	1	0	0	1
19078	479933	3	2	2	0	0	4
19078	479934	3	1	2	0	1	4
19078	479937	3	2	0	0	1	3
19078	479939	3	0	0	0	0	0
19078	479943	3	0	0	0	0	0
19078	479949	3	1	0	0	0	1
19078	479959	3	1	1	0	0	2
19078	479964	3	0	1	0	2	3
19078	479965	3	2	1	0	1	4
19078	479967	3	0	0	0	0	0
19078	479973	3	0	0	1	0	1
19078	479984	3	0	0	0	0	0
19078	479985	3	0	0	0	1	1
19078	479990	3	1	0	0	0	1
19078	479997	3	0	0	0	0	0
19078	480000	3	1	0	0	0	1
19078	480009	3	0	0	0	0	0
19078	480010	3	1	1	0	0	2
19078	480011	3	1	0	0	3	4
19078	480016	3	0	1	0	1	2
19078	480024	3	0	1	0	0	1
19078	480035	3	2	1	0	1	4
19078	480037	3	1	0	0	1	2
19078	480045	3	0	0	0	0	0
19078	480046	3	0	0	0	1	1
19078	480051	3	2	0	0	0	2
19078	480060	3	1	0	0	0	1
19078	480061	3	0	0	0	0	0
19078	480062	3	1	1	0	1	3
19078	480063	3	0	0	0	0	0
19078	480064	3	2	0	0	0	2
19078	480071	3	0	1	0	0	1
19078	480072	3	0	1	0	0	1
19078	480098	3	1	2	0	1	4
19078	480101	3	0	1	0	0	1
19078	480102	3	1	2	0	0	3
19078	480106	3	1	2	0	1	4
19078	480110	3	0	1	0	0	1
19078	480122	3	0	2	0	0	2
19078	186974	2	0	0	0	0	0
19078	189799	2	0	1	0	2	3
19078	190057	2	0	0	0	0	0
19078	200429	2	1	0	0	0	1
19078	206006	2	0	0	0	0	0
19078	207662	2	0	1	0	0	1
19078	211699	2	0	0	0	0	0
19078	212768	2	1	0	0	0	1
19078	215766	2	0	2	0	0	2
19078	218267	2	1	1	0	2	4
19078	218614	2	0	1	0	0	1
19078	220874	2	0	0	0	0	0
19078	288291	2	0	0	0	0	0
19078	288292	2	0	0	0	1	1
19078	288297	2	0	1	0	0	1
19078	479777	2	0	1	0	0	1
19078	479784	2	2	1	0	2	5
19078	479786	2	0	0	0	1	1
19078	479788	2	1	2	0	0	3
19078	479799	2	0	0	0	2	2
19078	479805	2	0	0	0	0	0
19078	479806	2	0	0	0	1	1
19078	479808	2	0	1	0	0	1
19078	479812	2	1	0	0	2	3
19078	479818	2	3	0	0	0	3
19078	479821	2	1	0	0	0	1
19078	479823	2	1	0	0	1	2
19078	479825	2	1	0	0	0	1
19078	479836	2	1	1	0	0	2
19078	479841	2	0	0	0	0	0
19078	479843	2	0	0	0	0	0
19078	479847	2	1	1	0	2	4
19078	479855	2	0	4	0	0	4
19078	479861	2	1	0	0	0	1
19078	479865	2	1	0	0	1	2
19078	479871	2	0	1	0	0	1
19078	479874	2	0	0	0	0	0
19078	479877	2	0	2	0	0	2
19078	479880	2	1	1	0	1	3
19078	479887	2	0	1	0	0	1
19078	479888	2	1	0	0	1	2
19078	479889	2	0	0	0	0	0
19078	479891	2	1	1	0	0	2
19078	479892	2	1	2	0	0	3
19078	479898	2	0	1	0	1	2
19078	479900	2	1	1	0	0	2
19078	479902	2	0	0	0	1	1
19078	479907	2	1	0	0	1	2
19078	479911	2	0	0	0	0	0
19078	479930	2	0	1	0	0	1
19078	479932	2	1	0	0	0	1
19078	479938	2	2	1	0	0	3
19078	479940	2	0	1	0	0	1
19078	479958	2	0	0	0	0	0
19078	479968	2	0	0	0	0	0
19078	479971	2	1	1	0	0	2
19078	479972	2	0	2	0	0	2
19078	479977	2	1	0	0	1	2
19078	479978	2	1	0	0	0	1
19078	479979	2	0	1	0	0	1
19078	479991	2	1	0	0	0	1
19078	480005	2	0	0	0	1	1
19078	480006	2	1	0	0	0	1
19078	480012	2	0	0	0	1	1
19078	480014	2	2	0	0	1	3
19078	480017	2	0	0	0	1	1
19078	480032	2	0	1	0	0	1
19078	480034	2	0	0	0	1	1
19078	480044	2	1	0	0	0	1
19078	480067	2	1	1	0	2	4
19078	480070	2	2	0	0	1	3
19078	480079	2	0	1	0	0	1
19078	480097	2	0	0	0	0	0
19078	480111	2	0	0	0	0	0
19078	480113	2	1	1	0	1	3
19078	480115	2	0	0	0	0	0
19078	480119	2	1	0	0	0	1
19078	480120	2	0	0	0	0	0
19078	480121	2	0	0	0	2	2
19078	186600	1	0	1	0	0	1
19078	193726	1	0	0	0	1	1
19078	203776	1	0	0	0	0	0
19078	207100	1	0	0	0	0	0
19078	207471	1	0	0	0	0	0
19078	209544	1	0	1	0	1	2
19078	210783	1	1	0	0	0	1
19078	214390	1	0	0	0	1	1
19078	216867	1	0	0	0	1	1
19078	288293	1	0	0	0	1	1
19078	479773	1	0	1	0	0	1
19078	479780	1	1	0	0	1	2
19078	479787	1	1	0	0	2	3
19078	479803	1	0	0	0	0	0
19078	479804	1	0	0	0	0	0
19078	479807	1	0	1	0	1	2
19078	479813	1	2	2	0	2	6
19078	479817	1	0	0	0	0	0
19078	479826	1	1	0	0	1	2
19078	479848	1	1	0	0	0	1
19078	479849	1	2	0	0	0	2
19078	479852	1	0	1	0	1	2
19078	479894	1	3	0	1	0	4
19078	479897	1	0	0	0	0	0
19078	479901	1	0	1	0	1	2
19078	479906	1	1	0	1	0	2
19078	479909	1	2	0	0	0	2
19078	479910	1	0	1	0	0	1
19078	479916	1	0	0	0	0	0
19078	479923	1	1	0	0	1	2
19078	479936	1	2	0	0	0	2
19078	479942	1	0	0	0	0	0
19078	479947	1	1	0	0	0	1
19078	479956	1	0	0	0	0	0
19078	479957	1	1	0	0	0	1
19078	479999	1	0	0	0	0	0
19078	480013	1	0	0	0	0	0
19078	480023	1	1	1	0	1	3
19078	480030	1	0	0	0	0	0
19078	480036	1	0	0	0	1	1
19078	480041	1	2	0	0	0	2
19078	480043	1	1	0	0	0	1
19078	480056	1	0	0	0	3	3
19078	480065	1	0	0	0	0	0
19078	480069	1	0	0	0	1	1
19078	480078	1	0	0	0	0	0
19078	480095	1	0	1	0	0	1
19078	480104	1	1	0	0	2	3
19078	480107	1	0	0	0	0	0
19078	480112	1	0	0	0	0	0
19078	480117	1	0	0	0	1	1
19078	480118	1	1	0	0	0	1
19078	480125	1	0	0	0	0	0
12416	63767	32	1	3	0	1	5
12416	517543	31	2	6	2	2	12
12416	64720	30	4	4	1	1	10
12416	517398	29	0	5	3	1	9
12416	184172	28	2	4	1	1	8
12416	517416	28	2	4	1	1	8
12416	53024	28	2	4	1	1	8
12416	517395	26	3	1	0	2	6
12416	517396	25	1	2	0	3	6
12416	78491	25	9	5	4	3	21
12416	517462	20	4	4	1	1	10
12416	276301	19	1	2	0	1	4
12416	517508	18	4	4	1	1	10
12416	517512	17	0	2	1	2	5
12416	186130	16	2	2	0	2	6
12416	276321	16	2	2	0	2	6
12416	201716	15	0	1	1	1	3
12416	517448	14	0	1	0	1	2
12416	517511	14	6	3	0	8	17
12416	517527	13	2	2	1	1	6
12416	276302	12	1	2	1	1	5
12416	517411	12	1	5	3	1	10
12416	517450	12	2	3	0	1	6
12416	517458	12	0	1	0	1	2
12416	517535	12	3	0	0	1	4
12416	190301	11	1	1	0	1	3
12416	276313	11	0	2	0	0	2
12416	517433	11	3	3	0	1	7
12416	517451	11	1	1	0	1	3
12416	517556	11	0	1	0	0	1
12416	185894	10	0	1	0	2	3
12416	193551	10	0	0	1	1	2
12416	200789	10	0	2	1	1	4
12416	208309	10	0	2	0	1	3
12416	212837	10	0	0	0	1	1
12416	214471	10	1	2	1	5	9
12416	276331	10	0	2	1	1	4
12416	517460	10	1	2	0	3	6
12416	517516	10	0	2	1	1	4
12416	517518	10	0	0	0	3	3
12416	517521	10	0	3	0	3	6
12416	517526	10	2	2	2	3	9
12416	517529	10	4	3	0	0	7
12416	517530	10	2	0	0	4	6
12416	76464	10	0	2	1	1	4
12416	208163	9	2	1	0	2	5
12416	220017	9	2	2	0	3	7
12416	276330	9	1	1	2	1	5
12416	517461	9	1	1	0	3	5
12416	517469	9	2	1	2	1	6
12416	517481	9	1	1	2	1	5
12416	517502	9	0	3	1	1	5
12416	517541	9	3	1	1	3	8
12416	52393	9	1	1	2	1	5
12416	183371	8	1	0	0	3	4
12416	186991	8	0	1	1	0	2
12416	192361	8	2	1	1	0	4
12416	212289	8	2	2	0	0	4
12416	212869	8	2	0	0	0	2
12416	276306	8	0	0	0	1	1
12416	517425	8	0	1	2	0	3
12416	517432	8	2	2	0	0	4
12416	517438	8	1	0	0	3	4
12416	517510	8	1	1	0	2	4
12416	517519	8	1	1	0	1	3
12416	517548	8	1	1	0	2	4
12416	517550	8	1	1	1	2	5
12416	517553	8	0	0	0	2	2
12416	517554	8	1	1	0	1	3
12416	100030	7	3	0	0	2	5
12416	188050	7	1	2	0	0	3
12416	191641	7	0	0	0	2	2
12416	194883	7	1	1	0	2	4
12416	197369	7	2	4	0	1	7
12416	210947	7	0	2	2	0	4
12416	217156	7	1	1	0	0	2
12416	276304	7	0	1	0	1	2
12416	276307	7	2	4	0	1	7
12416	276319	7	1	0	0	0	1
12416	276325	7	3	0	0	2	5
12416	276337	7	1	0	0	1	2
12416	517431	7	1	2	0	0	3
12416	517443	7	0	2	2	0	4
12416	517452	7	3	1	1	0	5
12416	517485	7	3	2	0	0	5
12416	517490	7	2	0	1	0	3
12416	517491	7	4	0	1	0	5
12416	517505	7	1	0	0	0	1
12416	517517	7	1	1	0	3	5
12416	517531	7	3	1	0	0	4
12416	517558	7	2	1	0	2	5
12416	517560	7	0	2	0	0	2
12416	65930	7	1	0	0	1	2
12416	72725	7	2	4	0	1	7
12416	73956	7	0	3	0	1	4
12416	181893	6	0	2	0	0	2
12416	185201	6	0	0	0	2	2
12416	192129	6	1	2	0	3	6
12416	203421	6	1	1	0	0	2
12416	205287	6	0	2	0	0	2
12416	206241	6	0	1	2	0	3
12416	209554	6	0	0	0	3	3
12416	209641	6	1	0	0	3	4
12416	217265	6	0	0	0	2	2
12416	219039	6	2	1	0	1	4
12416	219851	6	2	1	0	1	4
12416	276308	6	1	2	0	0	3
12416	276323	6	0	2	1	2	5
12416	276336	6	0	0	0	2	2
12416	276338	6	1	1	1	0	3
12416	517393	6	1	1	0	1	3
12416	517402	6	1	1	0	2	4
12416	517407	6	1	0	1	1	3
12416	517410	6	0	0	0	1	1
12416	517420	6	1	0	0	0	1
12416	517422	6	0	1	0	0	1
12416	517440	6	1	1	0	1	3
12416	517455	6	2	1	1	2	6
12416	517456	6	0	0	0	2	2
12416	517471	6	1	1	0	3	5
12416	517476	6	2	2	0	2	6
12416	517478	6	1	5	0	2	8
12416	517507	6	0	2	1	0	3
12416	517525	6	0	1	0	2	3
12416	517532	6	0	0	0	1	1
12416	62160	6	0	2	1	2	5
12416	191139	5	0	1	0	1	2
12416	192378	5	2	2	0	0	4
12416	192646	5	0	0	0	1	1
12416	193924	5	0	2	0	2	4
12416	195235	5	2	2	0	0	4
12416	196366	5	1	2	0	0	3
12416	200041	5	2	0	0	1	3
12416	200625	5	2	0	0	0	2
12416	202007	5	0	1	0	2	3
12416	203028	5	0	1	0	0	1
12416	203805	5	0	1	0	0	1
12416	204835	5	0	0	1	0	1
12416	206479	5	0	0	0	0	0
12416	207717	5	0	2	0	3	5
12416	207964	5	1	0	0	0	1
12416	211558	5	2	0	2	2	6
12416	212354	5	0	1	0	1	2
12416	215317	5	0	1	1	0	2
12416	276315	5	0	2	0	2	4
12416	276324	5	0	3	0	2	5
12416	276329	5	0	0	0	0	0
12416	517390	5	0	2	0	0	2
12416	517397	5	1	2	0	0	3
12416	517401	5	1	0	0	0	1
12416	517405	5	0	0	0	1	1
12416	517415	5	1	2	0	0	3
12416	517418	5	0	1	1	0	2
12416	517421	5	1	2	0	1	4
12416	517428	5	0	2	0	0	2
12416	517436	5	0	0	0	1	1
12416	517457	5	0	0	0	0	0
12416	517466	5	1	0	0	1	2
12416	517482	5	1	1	0	1	3
12416	517487	5	1	1	0	1	3
12416	517496	5	0	0	0	1	1
12416	517497	5	1	2	0	0	3
12416	517506	5	0	2	0	0	2
12416	517514	5	2	2	0	1	5
12416	517540	5	3	0	1	2	6
12416	517547	5	0	2	0	2	4
12416	517552	5	2	1	0	0	3
12416	517557	5	2	0	0	0	2
12416	517564	5	2	3	0	0	5
12416	54901	5	2	2	0	1	5
12416	65796	5	1	0	1	0	2
12416	88933	5	0	2	0	2	4
12416	90605	5	0	3	0	2	5
12416	100985	4	0	1	0	0	1
12416	103362	4	0	1	0	0	1
12416	185524	4	0	2	1	0	3
12416	186972	4	0	1	0	2	3
12416	193766	4	0	2	0	1	3
12416	194296	4	2	0	0	0	2
12416	196465	4	1	0	0	3	4
12416	197286	4	0	0	1	0	1
12416	198441	4	0	2	0	0	2
12416	200438	4	0	3	0	0	3
12416	201599	4	0	1	0	0	1
12416	202053	4	1	0	0	1	2
12416	202927	4	0	0	2	0	2
12416	203075	4	0	1	1	0	2
12416	204766	4	0	0	0	0	0
12416	204983	4	1	1	0	0	2
12416	205342	4	0	1	0	1	2
12416	207119	4	1	0	0	1	2
12416	212466	4	1	0	1	2	4
12416	215224	4	0	0	1	1	2
12416	216462	4	0	0	0	1	1
12416	221919	4	0	0	1	4	5
12416	276303	4	0	0	0	0	0
12416	276311	4	0	1	0	0	1
12416	276326	4	0	0	1	1	2
12416	276327	4	3	1	0	2	6
12416	276328	4	0	0	1	1	2
12416	276332	4	0	1	0	1	2
12416	276334	4	1	0	1	3	5
12416	517399	4	0	1	0	0	1
12416	517403	4	1	1	0	1	3
12416	517408	4	0	2	0	0	2
12416	517409	4	1	0	0	1	2
12416	517430	4	1	1	0	1	3
12416	517434	4	0	1	1	0	2
12416	517441	4	1	1	1	0	3
12416	517442	4	3	0	0	0	3
12416	517447	4	3	1	0	1	5
12416	517453	4	0	1	0	0	1
12416	517464	4	0	0	0	2	2
12416	517467	4	0	2	0	0	2
12416	517472	4	1	1	0	0	2
12416	517477	4	3	1	0	2	6
12416	517483	4	2	0	0	0	2
12416	517486	4	0	0	0	0	0
12416	517504	4	0	0	1	4	5
12416	517509	4	1	1	0	2	4
12416	517522	4	1	1	1	2	5
12416	517537	4	0	0	1	2	3
12416	517559	4	0	1	0	0	1
12416	517561	4	2	0	0	1	3
12416	517562	4	1	1	1	1	4
12416	517567	4	1	1	0	2	4
12416	517569	4	4	1	0	1	6
12416	55131	4	0	0	0	2	2
12416	71092	4	0	0	1	1	2
12416	78572	4	0	2	0	1	3
12416	79301	4	0	0	0	0	0
12416	91934	4	3	1	0	2	6
12416	97861	4	1	0	1	3	5
12416	108116	3	0	1	0	0	1
12416	184483	3	0	0	0	1	1
12416	185443	3	0	1	0	2	3
12416	187526	3	0	1	0	1	2
12416	187950	3	0	0	0	2	2
12416	190020	3	3	1	1	0	5
12416	192787	3	0	2	0	2	4
12416	196498	3	1	1	1	0	3
12416	199219	3	1	1	0	4	6
12416	200017	3	0	1	2	2	5
12416	200063	3	1	2	0	1	4
12416	200422	3	1	1	0	2	4
12416	201913	3	1	2	0	0	3
12416	202109	3	0	1	0	0	1
12416	203329	3	1	0	0	0	1
12416	203342	3	2	3	0	0	5
12416	203780	3	0	0	0	1	1
12416	204998	3	1	2	0	0	3
12416	206143	3	0	0	0	0	0
12416	206879	3	1	0	0	1	2
12416	206890	3	1	1	0	2	4
12416	209575	3	2	0	0	1	3
12416	212379	3	1	0	0	1	2
12416	215755	3	0	1	0	0	1
12416	216794	3	1	0	0	2	3
12416	217224	3	0	1	0	2	3
12416	217411	3	0	1	0	0	1
12416	217848	3	1	0	1	1	3
12416	218700	3	0	0	0	2	2
12416	218809	3	0	0	0	1	1
12416	220108	3	0	0	0	1	1
12416	276305	3	0	0	0	1	1
12416	276309	3	0	3	0	1	4
12416	276316	3	0	0	0	1	1
12416	276318	3	1	0	0	1	2
12416	276320	3	0	0	0	0	0
12416	276322	3	1	1	0	1	3
12416	276339	3	0	1	0	0	1
12416	517406	3	2	1	0	2	5
12416	517412	3	0	2	0	0	2
12416	517413	3	0	0	0	0	0
12416	517417	3	1	2	0	0	3
12416	517424	3	0	1	0	0	1
12416	517427	3	0	1	0	0	1
12416	517435	3	1	1	0	0	2
12416	517437	3	1	1	0	2	4
12416	517444	3	1	0	0	2	3
12416	517445	3	0	1	0	2	3
12416	517459	3	0	1	0	1	2
12416	517463	3	1	2	0	0	3
12416	517468	3	0	2	1	1	4
12416	517473	3	0	2	0	0	2
12416	517480	3	2	2	0	0	4
12416	517484	3	1	0	0	0	1
12416	517489	3	0	0	0	0	0
12416	517492	3	0	2	0	0	2
12416	517493	3	1	1	0	0	2
12416	517495	3	0	0	0	0	0
12416	517499	3	0	1	1	1	3
12416	517503	3	0	1	0	0	1
12416	517513	3	0	1	0	1	2
12416	517528	3	0	2	0	1	3
12416	517534	3	0	1	0	0	1
12416	517542	3	0	1	0	0	1
12416	517545	3	1	1	0	0	2
12416	517546	3	3	1	0	0	4
12416	517549	3	0	2	0	1	3
12416	517551	3	0	1	0	1	2
12416	517565	3	0	0	0	2	2
12416	54718	3	1	1	0	1	3
12416	59743	3	0	1	0	0	1
12416	74873	3	1	0	0	0	1
12416	95567	3	0	0	0	1	1
12416	99611	3	0	0	0	0	0
12416	185653	2	0	1	0	0	1
12416	186995	2	0	0	0	1	1
12416	188944	2	0	0	0	0	0
12416	193975	2	0	1	0	1	2
12416	194408	2	0	1	0	0	1
12416	201608	2	2	2	0	2	6
12416	203141	2	0	0	0	3	3
12416	205448	2	0	1	0	1	2
12416	206004	2	0	1	0	1	2
12416	206984	2	0	0	0	0	0
12416	206999	2	0	1	0	1	2
12416	207207	2	0	1	0	2	3
12416	207908	2	0	0	0	0	0
12416	208003	2	0	0	0	0	0
12416	213896	2	0	0	0	0	0
12416	213912	2	0	1	0	1	2
12416	214963	2	1	2	1	1	5
12416	217420	2	0	0	0	0	0
12416	218272	2	0	0	0	1	1
12416	221925	2	0	1	0	3	4
12416	276310	2	0	0	0	2	2
12416	276312	2	0	0	0	0	0
12416	276317	2	0	0	0	0	0
12416	276335	2	0	1	0	0	1
12416	276340	2	0	0	1	1	2
12416	517389	2	0	0	0	0	0
12416	517414	2	0	0	0	0	0
12416	517419	2	0	1	0	1	2
12416	517423	2	1	0	0	0	1
12416	517426	2	0	1	0	1	2
12416	517429	2	1	0	0	0	1
12416	517439	2	0	2	0	0	2
12416	517454	2	0	0	0	0	0
12416	517470	2	0	0	0	0	0
12416	517494	2	0	0	0	1	1
12416	517498	2	0	2	0	1	3
12416	517501	2	0	1	0	1	2
12416	517515	2	0	1	0	0	1
12416	517520	2	0	0	0	2	2
12416	517523	2	0	1	0	0	1
12416	517533	2	0	0	0	2	2
12416	517536	2	0	2	1	0	3
12416	517538	2	0	0	1	0	1
12416	517563	2	0	2	1	1	4
12416	517566	2	0	0	0	0	0
12416	517568	2	1	0	0	0	1
12416	59653	2	0	0	0	0	0
12416	63616	2	0	0	0	0	0
12416	79078	2	0	0	1	1	2
12416	182736	1	0	0	0	0	0
12416	185470	1	0	0	0	0	0
12416	185487	1	0	0	0	0	0
12416	185578	1	0	0	0	0	0
12416	186949	1	0	0	0	1	1
12416	187124	1	0	2	0	1	3
12416	189505	1	0	0	1	0	1
12416	190650	1	0	0	0	0	0
12416	192856	1	0	2	0	0	2
12416	202156	1	0	1	0	0	1
12416	203727	1	0	0	0	0	0
12416	203733	1	0	3	0	0	3
12416	208849	1	0	3	0	0	3
12416	210751	1	0	0	0	0	0
12416	213004	1	0	0	0	1	1
12416	214673	1	0	2	1	0	3
12416	215160	1	0	1	0	1	2
12416	218086	1	1	0	0	1	2
12416	219668	1	0	0	0	0	0
12416	220577	1	0	0	0	0	0
12416	276314	1	1	0	0	1	2
12416	276333	1	0	1	0	0	1
12416	517391	1	0	1	0	1	2
12416	517392	1	0	1	0	0	1
12416	517394	1	0	1	0	2	3
12416	517400	1	1	0	0	0	1
12416	517404	1	1	0	0	1	2
12416	517446	1	1	0	0	1	2
12416	517449	1	0	0	0	1	1
12416	517465	1	2	0	0	1	3
12416	517474	1	0	0	0	2	2
12416	517475	1	0	1	0	1	2
12416	517488	1	2	2	0	2	6
12416	517500	1	0	0	0	0	0
12416	517524	1	0	0	0	0	0
12416	517544	1	0	0	0	0	0
12416	517555	1	0	0	0	0	0
12416	71991	1	1	0	0	1	2
7857	595580	40	11	5	0	4	20
7857	65455	32	3	1	2	0	6
7857	595558	31	3	1	2	0	6
7857	68390	26	4	0	0	2	6
7857	191529	25	2	0	0	2	4
7857	595566	24	1	1	0	5	7
7857	83183	24	1	1	0	5	7
7857	89744	24	2	2	2	0	6
7857	595526	23	5	0	3	2	10
7857	595539	23	6	3	2	2	13
7857	595540	23	5	1	1	8	15
7857	595736	23	2	0	0	1	3
7857	595527	22	4	0	2	2	8
7857	595553	21	2	1	1	4	8
7857	217558	19	0	5	0	5	10
7857	595657	18	0	5	0	5	10
7857	202504	17	0	1	2	1	4
7857	284995	17	0	1	2	1	4
7857	82630	17	0	1	2	1	4
7857	595716	16	7	4	0	0	11
7857	595718	16	0	2	0	1	3
7857	181936	15	1	3	0	3	7
7857	595668	15	1	3	1	2	7
7857	595724	15	3	0	0	2	5
7857	595734	15	3	2	0	1	6
7857	54039	14	3	1	1	1	6
7857	59314	14	1	1	1	0	3
7857	595574	14	3	1	0	2	6
7857	71801	14	4	0	2	2	8
7857	188764	12	2	2	0	5	9
7857	212203	12	0	4	1	0	5
7857	284975	12	2	2	2	3	9
7857	285013	12	2	2	0	5	9
7857	595672	12	0	4	1	0	5
7857	595728	12	1	0	0	0	1
7857	595733	12	0	0	0	2	2
7857	595738	12	3	2	0	3	8
7857	59726	12	2	2	0	5	9
7857	67617	12	2	2	2	3	9
7857	73653	12	3	2	2	3	10
7857	81945	12	4	2	2	5	13
7857	209065	11	1	0	0	0	1
7857	285003	11	2	0	0	2	4
7857	285008	11	1	0	1	1	3
7857	55122	11	5	0	1	1	7
7857	595583	11	4	0	2	7	13
7857	595687	11	7	1	1	2	11
7857	595720	11	2	2	1	6	11
7857	63181	11	1	0	1	1	3
7857	70740	11	2	0	0	2	4
7857	87380	11	4	1	1	1	7
7857	186031	10	4	0	0	2	6
7857	187430	10	2	0	0	2	4
7857	188066	10	3	0	1	1	5
7857	190602	10	5	6	0	3	14
7857	284970	10	3	0	0	0	3
7857	595544	10	3	0	0	0	3
7857	595585	10	1	0	1	1	3
7857	595622	10	1	1	0	1	3
7857	595675	10	3	3	1	3	10
7857	595725	10	0	1	0	1	2
7857	595727	10	6	0	0	1	7
7857	92785	10	3	0	0	0	3
7857	202747	9	2	1	0	2	5
7857	284999	9	3	0	0	1	4
7857	285007	9	3	4	0	1	8
7857	595555	9	3	3	2	4	12
7857	595556	9	1	0	0	4	5
7857	595729	9	5	2	2	0	9
7857	595732	9	1	1	0	2	4
7857	84150	9	2	0	0	2	4
7857	210487	8	1	1	0	2	4
7857	221328	8	1	0	0	1	2
7857	284982	8	1	1	0	1	3
7857	595582	8	4	2	1	3	10
7857	595600	8	1	0	0	2	3
7857	595635	8	1	1	2	0	4
7857	595645	8	2	1	1	3	7
7857	595663	8	0	3	1	2	6
7857	595681	8	1	3	3	0	7
7857	595717	8	4	0	3	1	8
7857	80463	8	1	1	0	1	3
7857	94256	8	2	0	0	1	3
7857	107727	7	1	0	1	1	3
7857	108209	7	2	0	0	0	2
7857	194342	7	1	0	0	1	2
7857	284969	7	2	2	0	2	6
7857	284972	7	4	1	0	1	6
7857	285006	7	1	0	0	1	2
7857	595547	7	3	1	0	0	4
7857	595561	7	3	3	1	0	7
7857	595581	7	1	0	0	1	2
7857	595591	7	1	2	0	0	3
7857	595603	7	4	0	1	4	9
7857	595610	7	3	0	0	0	3
7857	595656	7	2	1	0	2	5
7857	595664	7	3	0	1	1	5
7857	595677	7	1	0	3	0	4
7857	595697	7	3	0	1	0	4
7857	595731	7	3	0	3	4	10
7857	71211	7	1	0	0	1	2
7857	71347	7	2	2	0	2	6
7857	105720	6	3	0	0	0	3
7857	106782	6	2	0	0	2	4
7857	197365	6	1	0	1	4	6
7857	200542	6	3	1	0	0	4
7857	204873	6	2	0	0	1	3
7857	205427	6	3	1	0	1	5
7857	205710	6	3	1	0	1	5
7857	219579	6	3	0	0	0	3
7857	284973	6	3	0	0	3	6
7857	284981	6	2	0	0	1	3
7857	284987	6	2	0	0	0	2
7857	284996	6	1	0	1	4	6
7857	285000	6	1	2	0	0	3
7857	50772	6	2	0	0	1	3
7857	577284	6	0	1	0	1	2
7857	595569	6	1	1	1	1	4
7857	595577	6	5	1	0	0	6
7857	595597	6	1	0	0	0	1
7857	595604	6	0	6	1	1	8
7857	595627	6	4	1	0	1	6
7857	595638	6	4	2	0	1	7
7857	595644	6	3	0	0	1	4
7857	595651	6	5	2	0	2	9
7857	595655	6	3	2	0	0	5
7857	595674	6	2	2	0	1	5
7857	595682	6	0	0	1	2	3
7857	595692	6	2	0	0	1	3
7857	595695	6	4	2	0	0	6
7857	595699	6	1	1	0	1	3
7857	595700	6	2	0	1	0	3
7857	595701	6	2	3	2	0	7
7857	595704	6	2	2	1	0	5
7857	595710	6	1	0	1	0	2
7857	595726	6	1	2	0	1	4
7857	595737	6	2	6	1	3	12
7857	67636	6	2	0	0	0	2
7857	72719	6	1	0	1	4	6
7857	183117	5	0	0	0	0	0
7857	184737	5	2	0	0	1	3
7857	185575	5	1	0	1	1	3
7857	190739	5	0	0	0	2	2
7857	191879	5	1	0	1	0	2
7857	194759	5	0	0	1	1	2
7857	196118	5	2	0	0	0	2
7857	196877	5	1	0	1	0	2
7857	199775	5	4	2	0	1	7
7857	210706	5	2	0	0	0	2
7857	218689	5	1	0	0	0	1
7857	284974	5	2	2	0	2	6
7857	285001	5	2	0	0	1	3
7857	285005	5	1	0	0	1	2
7857	54114	5	2	0	0	1	3
7857	595529	5	1	0	1	0	2
7857	595559	5	1	1	0	1	3
7857	595560	5	1	1	0	0	2
7857	595562	5	1	0	0	0	1
7857	595573	5	0	1	0	3	4
7857	595598	5	2	0	3	0	5
7857	595609	5	0	0	1	1	2
7857	595611	5	2	1	0	0	3
7857	595619	5	2	0	0	0	2
7857	595621	5	1	1	0	0	2
7857	595624	5	2	0	0	1	3
7857	595625	5	0	0	0	1	1
7857	595660	5	2	0	0	1	3
7857	595685	5	3	0	0	0	3
7857	595691	5	5	0	0	1	6
7857	595703	5	1	0	1	0	2
7857	595706	5	3	1	0	0	4
7857	595709	5	1	0	1	0	2
7857	595723	5	1	0	1	1	3
7857	80617	5	1	0	1	0	2
7857	100023	4	1	2	1	0	4
7857	100967	4	2	0	2	0	4
7857	105559	4	1	2	0	0	3
7857	108011	4	0	0	0	0	0
7857	182780	4	0	0	0	1	1
7857	185678	4	1	4	0	0	5
7857	187828	4	1	0	0	2	3
7857	189992	4	0	4	2	1	7
7857	190912	4	1	1	0	1	3
7857	204235	4	3	1	0	0	4
7857	206000	4	2	2	1	0	5
7857	206823	4	1	1	1	0	3
7857	210078	4	1	0	0	2	3
7857	212327	4	2	1	0	1	4
7857	217107	4	2	1	0	0	3
7857	220506	4	2	0	0	0	2
7857	284976	4	0	0	0	0	0
7857	284986	4	1	0	0	0	1
7857	284988	4	2	2	1	0	5
7857	284989	4	0	3	0	0	3
7857	284990	4	1	0	1	0	2
7857	284991	4	0	0	0	1	1
7857	284992	4	0	0	0	0	0
7857	284993	4	2	0	2	0	4
7857	284994	4	1	2	1	0	4
7857	284997	4	1	2	0	0	3
7857	285002	4	1	0	1	2	4
7857	285004	4	2	0	0	0	2
7857	285010	4	2	0	0	1	3
7857	51172	4	2	1	0	1	4
7857	595533	4	0	0	0	0	0
7857	595563	4	4	1	0	0	5
7857	595565	4	2	0	0	0	2
7857	595575	4	1	0	0	2	3
7857	595576	4	1	0	0	0	1
7857	595578	4	1	1	0	0	2
7857	595584	4	0	0	0	4	4
7857	595590	4	3	0	0	0	3
7857	595596	4	1	0	0	3	4
7857	595606	4	0	0	0	0	0
7857	595614	4	1	3	1	0	5
7857	595615	4	0	1	0	2	3
7857	595617	4	2	1	0	1	4
7857	595623	4	0	1	1	1	3
7857	595628	4	4	0	0	0	4
7857	595631	4	4	1	1	1	7
7857	595632	4	2	1	1	0	4
7857	595634	4	2	1	0	1	4
7857	595636	4	1	2	0	0	3
7857	595649	4	0	0	0	0	0
7857	595654	4	3	2	0	0	5
7857	595679	4	2	1	0	0	3
7857	595684	4	1	0	0	1	2
7857	595689	4	2	0	0	0	2
7857	595696	4	3	1	0	0	4
7857	595705	4	1	0	0	1	2
7857	595714	4	2	0	0	0	2
7857	595719	4	3	0	0	1	4
7857	62143	4	1	0	1	2	4
7857	64249	4	1	0	1	0	2
7857	79059	4	0	0	0	0	0
7857	80653	4	2	0	0	2	4
7857	84630	4	2	0	0	0	2
7857	86617	4	2	1	2	0	5
7857	183185	3	1	0	0	0	1
7857	184330	3	1	0	0	0	1
7857	187162	3	1	1	1	1	4
7857	190009	3	1	0	0	2	3
7857	190411	3	1	1	0	1	3
7857	190527	3	0	0	0	1	1
7857	195851	3	0	0	0	0	0
7857	201248	3	1	0	0	0	1
7857	201448	3	3	2	0	2	7
7857	210545	3	3	0	1	0	4
7857	213371	3	0	1	0	2	3
7857	213577	3	5	1	0	1	7
7857	213964	3	1	0	2	0	3
7857	216331	3	2	0	0	0	2
7857	284977	3	0	0	0	0	0
7857	284979	3	2	0	0	0	2
7857	284980	3	0	0	0	2	2
7857	284983	3	0	0	0	0	0
7857	284998	3	0	0	0	0	0
7857	285012	3	0	1	0	0	1
7857	54038	3	0	0	0	0	0
7857	595531	3	2	1	0	1	4
7857	595532	3	3	0	1	0	4
7857	595534	3	1	0	0	1	2
7857	595536	3	0	0	0	0	0
7857	595537	3	0	0	0	0	0
7857	595541	3	1	0	0	1	2
7857	595554	3	1	0	1	1	3
7857	595564	3	0	0	0	0	0
7857	595568	3	0	0	0	1	1
7857	595570	3	0	0	0	2	2
7857	595595	3	2	1	0	1	4
7857	595599	3	2	1	0	0	3
7857	595601	3	3	0	0	0	3
7857	595602	3	0	0	0	0	0
7857	595607	3	2	1	0	0	3
7857	595612	3	2	0	1	0	3
7857	595613	3	1	0	1	1	3
7857	595633	3	1	0	2	0	3
7857	595637	3	2	3	0	1	6
7857	595646	3	1	0	0	1	2
7857	595648	3	2	0	0	0	2
7857	595650	3	2	1	0	0	3
7857	595652	3	0	1	0	1	2
7857	595658	3	1	0	1	1	3
7857	595659	3	2	0	0	0	2
7857	595662	3	1	0	0	1	2
7857	595676	3	3	0	0	0	3
7857	595680	3	1	0	0	0	1
7857	595686	3	5	1	0	0	6
7857	595690	3	1	1	0	2	4
7857	595694	3	3	1	0	0	4
7857	595698	3	3	2	1	0	6
7857	595702	3	1	0	0	1	2
7857	595707	3	1	0	1	0	2
7857	595711	3	2	0	0	1	3
7857	595713	3	1	1	0	1	3
7857	595722	3	4	0	0	0	4
7857	595735	3	2	1	0	3	6
7857	65791	3	0	2	0	0	2
7857	70810	3	0	0	0	0	0
7857	72402	3	2	0	0	0	2
7857	73246	3	0	2	0	1	3
7857	79297	3	0	0	0	2	2
7857	92255	3	1	1	0	0	2
7857	105267	2	0	0	0	1	1
7857	197222	2	1	0	0	1	2
7857	197277	2	1	0	0	3	4
7857	199953	2	1	0	0	0	1
7857	209820	2	1	0	0	0	1
7857	211989	2	0	0	0	0	0
7857	285011	2	1	0	0	0	1
7857	595528	2	0	0	0	0	0
7857	595530	2	2	0	0	2	4
7857	595538	2	0	0	1	4	5
7857	595542	2	1	0	0	0	1
7857	595546	2	0	0	0	1	1
7857	595548	2	1	1	0	0	2
7857	595552	2	1	0	0	0	1
7857	595557	2	1	1	1	0	3
7857	595571	2	1	0	0	0	1
7857	595572	2	2	0	0	0	2
7857	595579	2	1	2	0	0	3
7857	595586	2	2	2	0	2	6
7857	595587	2	0	0	0	0	0
7857	595588	2	0	0	0	0	0
7857	595589	2	0	0	0	0	0
7857	595592	2	1	2	1	0	4
7857	595594	2	1	0	1	1	3
7857	595605	2	0	0	0	0	0
7857	595608	2	1	1	1	0	3
7857	595616	2	0	0	1	1	2
7857	595618	2	2	0	1	0	3
7857	595620	2	0	2	2	2	6
7857	595629	2	1	0	0	0	1
7857	595630	2	3	2	0	0	5
7857	595640	2	1	0	1	1	3
7857	595641	2	0	0	1	0	1
7857	595642	2	0	2	0	0	2
7857	595643	2	0	0	0	1	1
7857	595661	2	1	2	0	1	4
7857	595665	2	0	1	0	1	2
7857	595666	2	0	2	0	0	2
7857	595667	2	1	1	0	0	2
7857	595669	2	0	1	0	0	1
7857	595670	2	1	0	0	0	1
7857	595673	2	0	2	0	0	2
7857	595683	2	1	1	1	3	6
7857	595688	2	0	0	0	0	0
7857	595712	2	1	2	1	2	6
7857	595715	2	0	1	0	0	1
7857	595721	2	1	0	0	0	1
7857	67218	2	1	1	1	0	3
7857	195521	1	0	0	0	0	0
7857	201989	1	1	0	0	0	1
7857	208079	1	0	0	0	0	0
7857	220328	1	2	0	0	0	2
7857	284971	1	0	0	0	1	1
7857	285009	1	1	1	0	1	3
7857	285014	1	0	1	0	0	1
7857	595535	1	5	1	1	0	7
7857	595543	1	1	1	0	1	3
7857	595545	1	1	1	0	0	2
7857	595549	1	0	0	0	0	0
7857	595550	1	1	0	0	1	2
7857	595551	1	2	1	0	1	4
7857	595567	1	0	1	1	0	2
7857	595593	1	2	0	0	1	3
7857	595626	1	5	0	0	0	5
7857	595639	1	0	1	1	1	3
7857	595647	1	0	0	0	0	0
7857	595653	1	0	1	0	0	1
7857	595678	1	5	0	0	0	5
7857	595693	1	0	0	0	0	0
7857	595708	1	1	1	0	0	2
7857	595730	1	1	0	0	0	1
7857	91930	1	0	1	0	0	1
17887	185372	41	0	5	0	0	5
17887	210654	40	11	6	3	2	22
17887	550019	40	11	6	3	2	22
17887	550158	34	5	1	0	2	8
17887	287892	26	3	2	0	1	6
17887	217480	20	1	8	3	1	13
17887	550217	15	1	2	0	0	3
17887	208314	12	3	2	0	0	5
17887	550003	11	1	2	0	1	4
17887	205275	10	0	1	0	1	2
17887	550150	10	2	0	0	0	2
17887	287903	9	2	1	0	2	5
17887	287905	9	1	0	1	0	2
17887	550038	9	1	2	0	1	4
17887	550118	9	1	0	1	1	3
17887	550129	9	2	0	0	0	2
17887	550174	9	2	3	0	1	6
17887	550243	9	1	0	0	0	1
17887	195180	8	0	2	0	0	2
17887	550027	8	2	1	0	0	3
17887	550092	8	2	3	0	0	5
17887	550145	8	1	1	0	0	2
17887	550222	8	0	0	1	0	1
17887	550230	8	1	2	0	0	3
17887	186163	7	0	0	0	0	0
17887	198235	7	1	1	0	0	2
17887	200760	7	0	4	0	0	4
17887	207650	7	1	0	2	0	3
17887	208177	7	1	1	0	0	2
17887	211824	7	0	2	0	0	2
17887	214020	7	0	1	0	0	1
17887	287875	7	2	0	1	1	4
17887	287881	7	0	0	0	0	0
17887	550049	7	1	1	0	0	2
17887	550093	7	1	1	0	0	2
17887	550099	7	3	2	1	0	6
17887	550121	7	3	3	0	1	7
17887	550130	7	4	1	2	0	7
17887	550162	7	3	1	0	0	4
17887	550173	7	2	0	0	0	2
17887	550197	7	3	1	0	1	5
17887	550228	7	3	1	1	0	5
17887	550251	7	0	2	0	0	2
17887	186959	6	1	1	0	1	3
17887	194899	6	1	1	0	0	2
17887	211420	6	2	2	0	0	4
17887	214703	6	1	3	0	1	5
17887	214840	6	1	0	0	0	1
17887	287901	6	1	0	0	0	1
17887	550004	6	0	2	0	0	2
17887	550011	6	1	2	0	0	3
17887	550014	6	1	3	0	0	4
17887	550042	6	0	0	0	1	1
17887	550043	6	1	4	0	0	5
17887	550053	6	1	0	2	0	3
17887	550055	6	3	0	0	0	3
17887	550063	6	4	1	0	0	5
17887	550071	6	2	2	0	2	6
17887	550081	6	0	0	2	1	3
17887	550098	6	0	3	0	0	3
17887	550115	6	0	1	0	0	1
17887	550169	6	2	3	0	0	5
17887	550180	6	1	0	0	0	1
17887	550219	6	1	0	1	0	2
17887	550246	6	1	1	0	0	2
17887	185525	5	1	2	0	0	3
17887	199176	5	0	0	0	2	2
17887	213894	5	0	0	1	0	1
17887	216005	5	0	3	1	0	4
17887	216650	5	0	1	0	0	1
17887	287877	5	0	2	0	0	2
17887	287878	5	0	4	0	0	4
17887	287883	5	1	1	0	0	2
17887	287894	5	2	2	0	0	4
17887	287902	5	1	0	0	0	1
17887	550002	5	2	0	0	0	2
17887	550010	5	1	2	0	0	3
17887	550017	5	0	3	0	0	3
17887	550030	5	3	2	0	0	5
17887	550034	5	1	1	0	0	2
17887	550040	5	2	2	0	0	4
17887	550050	5	1	0	0	0	1
17887	550068	5	0	0	0	0	0
17887	550090	5	0	1	0	0	1
17887	550103	5	0	0	0	1	1
17887	550104	5	0	3	0	0	3
17887	550116	5	1	3	0	0	4
17887	550126	5	0	0	0	0	0
17887	550134	5	0	6	2	0	8
17887	550146	5	0	1	0	0	1
17887	550148	5	2	1	0	0	3
17887	550153	5	0	2	0	2	4
17887	550159	5	0	1	0	0	1
17887	550163	5	0	1	0	0	1
17887	550170	5	1	4	0	1	6
17887	550192	5	1	3	0	1	5
17887	550193	5	2	0	0	1	3
17887	550195	5	1	1	0	0	2
17887	550210	5	0	1	0	0	1
17887	550232	5	1	0	0	0	1
17887	550236	5	0	1	0	0	1
17887	550237	5	2	2	0	0	4
17887	550241	5	0	1	0	0	1
17887	550249	5	0	0	0	2	2
17887	550250	5	2	2	0	0	4
17887	181901	4	0	0	0	0	0
17887	192617	4	0	2	0	0	2
17887	193208	4	1	1	0	0	2
17887	193520	4	2	2	0	0	4
17887	205536	4	1	0	0	0	1
17887	206581	4	3	0	1	0	4
17887	208359	4	0	1	0	1	2
17887	210068	4	0	1	0	0	1
17887	210334	4	1	1	0	1	3
17887	212472	4	0	1	0	0	1
17887	215275	4	0	1	0	0	1
17887	217275	4	0	2	0	0	2
17887	287873	4	1	1	0	0	2
17887	287886	4	0	0	0	0	0
17887	287887	4	1	1	0	0	2
17887	549995	4	1	2	0	1	4
17887	550009	4	3	0	1	0	4
17887	550020	4	0	1	0	1	2
17887	550023	4	0	0	0	0	0
17887	550025	4	2	3	0	1	6
17887	550044	4	1	0	0	0	1
17887	550048	4	3	1	0	0	4
17887	550051	4	0	2	0	0	2
17887	550059	4	0	0	0	0	0
17887	550060	4	1	2	0	0	3
17887	550064	4	1	0	0	0	1
17887	550065	4	0	2	0	0	2
17887	550070	4	1	0	0	1	2
17887	550074	4	1	0	0	0	1
17887	550080	4	0	1	0	0	1
17887	550100	4	1	0	0	0	1
17887	550101	4	0	2	0	1	3
17887	550108	4	0	0	0	1	1
17887	550109	4	2	0	0	0	2
17887	550112	4	0	3	0	0	3
17887	550123	4	1	1	0	0	2
17887	550127	4	2	1	0	0	3
17887	550136	4	2	1	0	0	3
17887	550138	4	1	3	0	0	4
17887	550139	4	2	2	0	0	4
17887	550144	4	1	0	0	0	1
17887	550151	4	2	1	0	0	3
17887	550161	4	0	1	0	1	2
17887	550166	4	2	1	0	0	3
17887	550168	4	2	1	0	1	4
17887	550182	4	0	1	0	0	1
17887	550183	4	0	1	0	0	1
17887	550190	4	1	0	0	0	1
17887	550191	4	1	0	0	0	1
17887	550198	4	0	1	0	1	2
17887	550202	4	1	0	1	0	2
17887	550205	4	1	3	0	0	4
17887	550211	4	1	5	0	0	6
17887	550213	4	1	4	0	0	5
17887	550215	4	2	1	0	0	3
17887	550224	4	1	4	0	0	5
17887	550225	4	3	0	0	0	3
17887	550226	4	1	0	0	0	1
17887	550227	4	1	0	0	0	1
17887	550233	4	0	2	0	0	2
17887	550234	4	1	0	0	0	1
17887	550235	4	2	0	0	1	3
17887	550242	4	0	2	0	0	2
17887	550244	4	2	1	0	0	3
17887	550248	4	1	1	0	0	2
17887	185692	3	0	3	0	0	3
17887	187011	3	0	1	0	1	2
17887	190386	3	1	1	0	0	2
17887	191087	3	0	5	0	0	5
17887	192233	3	1	1	0	0	2
17887	192865	3	0	1	0	0	1
17887	193205	3	2	2	0	0	4
17887	200565	3	0	0	0	1	1
17887	203783	3	0	0	0	0	0
17887	204895	3	0	0	0	0	0
17887	206495	3	0	1	0	0	1
17887	207342	3	1	1	0	0	2
17887	210403	3	0	0	0	0	0
17887	213328	3	0	1	0	0	1
17887	214356	3	0	1	0	1	2
17887	216820	3	0	1	0	0	1
17887	216922	3	3	2	0	0	5
17887	216961	3	1	0	0	0	1
17887	217884	3	1	1	0	0	2
17887	218517	3	0	0	0	0	0
17887	218627	3	0	0	0	0	0
17887	287876	3	0	2	0	0	2
17887	287879	3	0	1	0	0	1
17887	287880	3	0	0	0	0	0
17887	287884	3	1	1	0	0	2
17887	287890	3	0	2	0	0	2
17887	287897	3	0	0	0	0	0
17887	287899	3	0	2	0	3	5
17887	287900	3	0	1	0	0	1
17887	287904	3	1	0	0	0	1
17887	549994	3	2	1	0	1	4
17887	549997	3	1	0	0	0	1
17887	549998	3	0	1	0	0	1
17887	549999	3	1	2	0	0	3
17887	550001	3	0	1	0	1	2
17887	550006	3	0	2	0	0	2
17887	550007	3	0	0	0	0	0
17887	550015	3	1	1	0	0	2
17887	550016	3	0	2	0	0	2
17887	550018	3	1	1	0	0	2
17887	550022	3	1	1	0	0	2
17887	550026	3	0	0	0	1	1
17887	550031	3	2	2	0	0	4
17887	550033	3	0	1	0	0	1
17887	550036	3	0	1	0	0	1
17887	550037	3	1	2	0	0	3
17887	550054	3	1	1	0	0	2
17887	550056	3	0	1	0	0	1
17887	550061	3	2	0	0	0	2
17887	550066	3	0	1	0	0	1
17887	550067	3	0	0	0	0	0
17887	550069	3	1	0	0	0	1
17887	550072	3	2	0	0	0	2
17887	550073	3	0	1	0	0	1
17887	550075	3	0	1	0	0	1
17887	550077	3	0	0	0	0	0
17887	550079	3	0	0	0	0	0
17887	550082	3	1	0	0	0	1
17887	550085	3	1	0	0	0	1
17887	550087	3	0	0	0	0	0
17887	550089	3	1	0	0	0	1
17887	550096	3	4	0	0	0	4
17887	550105	3	0	1	0	0	1
17887	550110	3	3	1	0	0	4
17887	550111	3	1	2	0	0	3
17887	550113	3	0	0	0	0	0
17887	550117	3	1	0	0	0	1
17887	550120	3	4	2	0	0	6
17887	550122	3	1	0	0	0	1
17887	550124	3	1	0	0	0	1
17887	550128	3	0	1	1	0	2
17887	550131	3	1	0	0	0	1
17887	550132	3	0	0	0	0	0
17887	550133	3	0	0	0	0	0
17887	550137	3	1	0	0	0	1
17887	550140	3	2	0	0	0	2
17887	550142	3	0	2	0	0	2
17887	550143	3	0	1	0	0	1
17887	550149	3	0	1	0	0	1
17887	550155	3	1	0	0	0	1
17887	550156	3	2	0	0	1	3
17887	550157	3	0	0	0	0	0
17887	550171	3	0	1	0	0	1
17887	550175	3	0	3	0	1	4
17887	550178	3	1	0	0	0	1
17887	550179	3	0	2	0	0	2
17887	550184	3	1	2	0	0	3
17887	550189	3	1	0	0	0	1
17887	550199	3	0	1	0	1	2
17887	550200	3	0	1	0	2	3
17887	550201	3	1	0	0	0	1
17887	550203	3	0	1	0	0	1
17887	550204	3	0	1	0	0	1
17887	550214	3	1	1	0	0	2
17887	550216	3	1	0	0	0	1
17887	550220	3	0	0	1	0	1
17887	550231	3	0	2	0	0	2
17887	550238	3	1	0	0	0	1
17887	550240	3	0	0	0	0	0
17887	550245	3	1	0	0	0	1
17887	550247	3	0	0	0	0	0
17887	194509	2	0	0	0	3	3
17887	198080	2	0	0	0	0	0
17887	200122	2	0	0	0	0	0
17887	204594	2	0	1	0	0	1
17887	206010	2	0	1	0	0	1
17887	209372	2	1	0	0	1	2
17887	212991	2	0	1	1	0	2
17887	213005	2	0	1	0	0	1
17887	215717	2	1	2	0	0	3
17887	216779	2	0	2	0	0	2
17887	218902	2	1	1	2	0	4
17887	220881	2	0	0	0	0	0
17887	287874	2	0	1	0	0	1
17887	287882	2	0	0	0	0	0
17887	287885	2	1	0	0	0	1
17887	287889	2	0	0	0	0	0
17887	287893	2	1	1	0	0	2
17887	287896	2	0	1	0	0	1
17887	287898	2	0	2	0	0	2
17887	287907	2	1	0	0	0	1
17887	549992	2	0	0	0	0	0
17887	549993	2	0	0	0	0	0
17887	549996	2	1	3	0	0	4
17887	550005	2	1	1	0	0	2
17887	550012	2	1	1	0	0	2
17887	550021	2	0	2	0	0	2
17887	550028	2	0	1	0	0	1
17887	550029	2	0	1	0	1	2
17887	550032	2	1	1	0	0	2
17887	550039	2	3	1	0	0	4
17887	550041	2	0	0	1	0	1
17887	550045	2	1	1	0	1	3
17887	550046	2	0	1	0	0	1
17887	550052	2	0	0	0	0	0
17887	550057	2	0	0	0	0	0
17887	550062	2	0	0	0	0	0
17887	550076	2	1	0	0	0	1
17887	550083	2	1	1	0	0	2
17887	550086	2	3	2	0	0	5
17887	550088	2	0	2	0	0	2
17887	550091	2	0	0	0	0	0
17887	550094	2	0	0	0	0	0
17887	550095	2	0	0	0	2	2
17887	550097	2	0	1	0	0	1
17887	550102	2	0	0	0	0	0
17887	550106	2	1	2	0	0	3
17887	550107	2	1	2	0	0	3
17887	550114	2	3	0	0	0	3
17887	550119	2	1	2	0	0	3
17887	550125	2	2	0	0	0	2
17887	550135	2	1	0	0	0	1
17887	550141	2	2	0	0	0	2
17887	550154	2	0	1	0	0	1
17887	550160	2	0	3	0	0	3
17887	550164	2	0	0	0	0	0
17887	550165	2	0	0	0	0	0
17887	550167	2	2	0	0	1	3
17887	550172	2	1	2	0	0	3
17887	550176	2	2	1	0	0	3
17887	550177	2	0	0	0	0	0
17887	550186	2	0	1	0	0	1
17887	550187	2	0	0	0	0	0
17887	550188	2	1	0	0	0	1
17887	550206	2	0	0	0	0	0
17887	550207	2	0	1	0	0	1
17887	550212	2	2	1	0	0	3
17887	550218	2	0	3	0	0	3
17887	550223	2	0	0	0	0	0
17887	181946	1	1	2	0	0	3
17887	185655	1	0	0	0	0	0
17887	186597	1	1	0	0	0	1
17887	188445	1	0	0	0	0	0
17887	195658	1	0	0	0	0	0
17887	195805	1	0	0	0	0	0
17887	196020	1	0	0	0	0	0
17887	196536	1	0	0	0	0	0
17887	205981	1	0	0	0	0	0
17887	205988	1	0	0	0	0	0
17887	206230	1	0	2	0	0	2
17887	209594	1	1	4	0	0	5
17887	211704	1	0	1	1	0	2
17887	213017	1	0	1	0	1	2
17887	213878	1	0	1	0	0	1
17887	216249	1	0	0	0	0	0
17887	287888	1	0	0	0	0	0
17887	287891	1	1	3	0	0	4
17887	287895	1	0	0	0	0	0
17887	287906	1	0	0	0	0	0
17887	549991	1	1	0	0	0	1
17887	550000	1	1	0	0	0	1
17887	550008	1	0	0	0	0	0
17887	550013	1	0	1	0	0	1
17887	550024	1	0	0	0	0	0
17887	550035	1	0	1	0	0	1
17887	550047	1	0	0	0	0	0
17887	550058	1	0	0	0	0	0
17887	550078	1	2	0	0	0	2
17887	550084	1	0	0	0	0	0
17887	550147	1	0	0	0	0	0
17887	550152	1	2	1	0	0	3
17887	550181	1	1	0	0	0	1
17887	550185	1	0	1	1	0	2
17887	550194	1	0	0	0	0	0
17887	550196	1	0	1	0	0	1
17887	550208	1	1	1	0	0	2
17887	550209	1	0	0	0	0	0
17887	550221	1	1	0	0	0	1
17887	550229	1	2	0	0	0	2
17887	550239	1	0	1	0	0	1
36312	558277	23	5	3	0	1	9
36312	207652	21	5	4	0	1	10
36312	558443	16	4	9	1	0	14
36312	558462	16	3	4	0	0	7
36312	558360	15	1	3	1	0	5
36312	195942	14	3	0	0	0	3
36312	558259	13	2	0	1	3	6
36312	558427	13	1	0	0	3	4
36312	558546	13	3	3	0	2	8
36312	558260	12	3	4	0	4	11
36312	558263	12	1	1	0	2	4
36312	558322	12	4	0	0	1	5
36312	558336	12	2	1	0	1	4
36312	558271	11	2	2	1	0	5
36312	558560	11	2	1	2	3	8
36312	199713	10	5	1	0	0	6
36312	558305	10	0	2	0	3	5
36312	558330	10	2	7	0	0	9
36312	558405	10	0	0	0	0	0
36312	558410	10	5	2	0	0	7
36312	558511	10	3	5	1	0	9
36312	558573	10	2	0	0	0	2
36312	211014	9	1	2	0	0	3
36312	292856	9	0	4	0	0	4
36312	558275	9	1	2	0	1	4
36312	558359	9	1	1	0	1	3
36312	558397	9	0	4	0	0	4
36312	558450	9	2	1	1	0	4
36312	558567	9	1	1	0	0	2
36312	558568	9	0	0	0	0	0
36312	205344	8	0	1	0	0	1
36312	558265	8	2	0	0	0	2
36312	558285	8	3	2	0	0	5
36312	558286	8	0	0	0	2	2
36312	558287	8	0	0	0	0	0
36312	558314	8	1	3	0	1	5
36312	558343	8	0	3	0	3	6
36312	558369	8	1	1	0	3	5
36312	558398	8	2	1	0	0	3
36312	558399	8	3	2	0	0	5
36312	558402	8	4	0	0	0	4
36312	558434	8	2	2	0	0	4
36312	558466	8	1	2	0	1	4
36312	558476	8	1	1	0	0	2
36312	558519	8	1	0	0	0	1
36312	558536	8	0	0	0	0	0
36312	558555	8	2	1	0	1	4
36312	558564	8	1	2	0	0	3
36312	558574	8	0	0	0	0	0
36312	202956	7	1	2	0	0	3
36312	558267	7	1	2	0	1	4
36312	558270	7	7	2	0	0	9
36312	558272	7	0	1	1	2	4
36312	558274	7	2	1	0	0	3
36312	558279	7	1	0	0	2	3
36312	558280	7	1	0	0	0	1
36312	558282	7	1	1	0	1	3
36312	558296	7	0	2	0	0	2
36312	558315	7	1	1	0	0	2
36312	558340	7	0	0	1	0	1
36312	558371	7	2	1	0	1	4
36312	558374	7	0	0	0	0	0
36312	558379	7	0	0	0	1	1
36312	558384	7	0	1	0	0	1
36312	558413	7	2	1	0	0	3
36312	558421	7	1	1	0	1	3
36312	558422	7	1	4	0	0	5
36312	558423	7	0	0	0	0	0
36312	558447	7	0	1	0	0	1
36312	558471	7	0	2	1	2	5
36312	558484	7	1	0	0	0	1
36312	558486	7	2	0	0	2	4
36312	558489	7	2	2	0	1	5
36312	558500	7	2	0	0	1	3
36312	558515	7	0	0	0	1	1
36312	558565	7	1	2	0	0	3
36312	183411	6	1	0	0	0	1
36312	185809	6	0	2	0	2	4
36312	214958	6	0	2	0	0	2
36312	558258	6	1	1	0	1	3
36312	558264	6	2	0	0	0	2
36312	558273	6	1	1	0	1	3
36312	558310	6	0	0	0	0	0
36312	558318	6	0	0	0	0	0
36312	558333	6	2	4	0	1	7
36312	558364	6	1	2	1	2	6
36312	558373	6	1	1	0	0	2
36312	558396	6	0	1	0	0	1
36312	558429	6	2	2	1	1	6
36312	558433	6	0	0	0	2	2
36312	558444	6	2	3	0	0	5
36312	558448	6	0	3	0	0	3
36312	558459	6	1	3	2	0	6
36312	558469	6	4	0	0	2	6
36312	558470	6	3	2	0	0	5
36312	558478	6	0	5	1	1	7
36312	558488	6	1	2	0	0	3
36312	558503	6	1	0	0	0	1
36312	558539	6	0	0	0	0	0
36312	558562	6	2	1	0	0	3
36312	558576	6	0	1	0	0	1
36312	188178	5	1	1	0	0	2
36312	193919	5	0	1	0	0	1
36312	198185	5	4	0	0	1	5
36312	214665	5	0	0	0	0	0
36312	292846	5	0	1	0	0	1
36312	292849	5	2	1	0	0	3
36312	558262	5	1	0	0	0	1
36312	558268	5	3	1	0	0	4
36312	558283	5	1	3	0	0	4
36312	558284	5	0	0	0	1	1
36312	558290	5	1	3	0	2	6
36312	558291	5	1	1	0	0	2
36312	558295	5	0	2	0	0	2
36312	558328	5	0	0	0	1	1
36312	558349	5	0	0	0	0	0
36312	558353	5	0	1	0	0	1
36312	558358	5	2	1	1	0	4
36312	558372	5	1	2	0	0	3
36312	558376	5	0	0	0	0	0
36312	558389	5	0	0	0	0	0
36312	558392	5	1	2	0	0	3
36312	558400	5	0	2	0	0	2
36312	558403	5	1	1	1	0	3
36312	558425	5	2	2	0	0	4
36312	558437	5	2	0	0	0	2
36312	558441	5	1	1	0	2	4
36312	558446	5	1	3	0	0	4
36312	558465	5	2	3	0	0	5
36312	558467	5	0	2	1	0	3
36312	558516	5	0	1	0	1	2
36312	558517	5	3	2	0	0	5
36312	558518	5	3	0	1	0	4
36312	558541	5	1	1	0	2	4
36312	558547	5	0	1	0	0	1
36312	558552	5	0	0	0	0	0
36312	558558	5	1	0	0	0	1
36312	188942	4	0	0	0	1	1
36312	189130	4	1	0	0	0	1
36312	195987	4	1	2	0	0	3
36312	201358	4	1	1	0	0	2
36312	206242	4	2	1	0	0	3
36312	207361	4	1	0	0	0	1
36312	208865	4	1	2	0	0	3
36312	215883	4	0	0	0	1	1
36312	292851	4	1	1	0	1	3
36312	292854	4	1	2	0	1	4
36312	558257	4	1	0	0	0	1
36312	558278	4	0	2	0	0	2
36312	558281	4	1	0	0	2	3
36312	558289	4	0	0	0	1	1
36312	558293	4	4	0	0	1	5
36312	558294	4	0	0	0	0	0
36312	558302	4	0	0	0	0	0
36312	558304	4	1	1	1	0	3
36312	558306	4	2	1	0	1	4
36312	558307	4	1	2	1	0	4
36312	558311	4	2	2	0	0	4
36312	558321	4	0	1	0	1	2
36312	558323	4	0	2	0	0	2
36312	558329	4	0	2	0	0	2
36312	558334	4	2	0	0	1	3
36312	558338	4	2	2	0	0	4
36312	558342	4	0	0	0	1	1
36312	558347	4	1	2	0	1	4
36312	558348	4	3	2	0	0	5
36312	558354	4	1	0	0	0	1
36312	558365	4	1	0	0	0	1
36312	558367	4	2	4	0	2	8
36312	558407	4	0	1	0	1	2
36312	558408	4	0	2	0	1	3
36312	558409	4	0	2	0	0	2
36312	558416	4	1	3	0	1	5
36312	558420	4	0	0	0	1	1
36312	558428	4	2	1	0	0	3
36312	558430	4	3	1	0	0	4
36312	558442	4	0	0	0	1	1
36312	558445	4	1	0	0	0	1
36312	558452	4	2	2	0	0	4
36312	558456	4	0	3	0	0	3
36312	558458	4	1	2	0	0	3
36312	558463	4	1	1	0	0	2
36312	558464	4	0	0	0	1	1
36312	558468	4	1	1	0	0	2
36312	558473	4	0	0	0	0	0
36312	558479	4	1	1	1	0	3
36312	558480	4	3	0	0	0	3
36312	558485	4	0	1	1	0	2
36312	558495	4	2	3	1	0	6
36312	558496	4	0	2	1	0	3
36312	558497	4	3	1	0	0	4
36312	558502	4	0	2	0	0	2
36312	558508	4	2	0	0	0	2
36312	558513	4	0	2	0	1	3
36312	558527	4	2	1	0	0	3
36312	558531	4	1	0	0	0	1
36312	558533	4	0	1	0	0	1
36312	558534	4	1	1	0	0	2
36312	558537	4	1	1	0	1	3
36312	558554	4	0	1	0	1	2
36312	558556	4	1	1	0	0	2
36312	558559	4	3	2	0	0	5
36312	558561	4	0	0	0	0	0
36312	558578	4	0	0	0	0	0
36312	183107	3	0	0	0	1	1
36312	189818	3	0	0	0	0	0
36312	194139	3	0	1	0	0	1
36312	204450	3	1	1	0	0	2
36312	208877	3	0	0	0	1	1
36312	292850	3	0	0	0	0	0
36312	292855	3	0	0	0	0	0
36312	558248	3	1	0	0	0	1
36312	558252	3	1	0	0	0	1
36312	558253	3	2	1	0	0	3
36312	558255	3	1	1	0	0	2
36312	558256	3	0	0	0	1	1
36312	558261	3	0	0	0	0	0
36312	558266	3	1	0	0	0	1
36312	558276	3	2	0	0	0	2
36312	558298	3	0	0	0	0	0
36312	558301	3	1	1	0	1	3
36312	558308	3	1	1	0	1	3
36312	558312	3	1	1	0	0	2
36312	558313	3	0	0	0	0	0
36312	558319	3	1	1	0	0	2
36312	558320	3	2	0	0	1	3
36312	558324	3	1	0	0	1	2
36312	558326	3	0	0	0	0	0
36312	558339	3	0	1	0	1	2
36312	558344	3	1	1	0	1	3
36312	558345	3	0	0	0	0	0
36312	558346	3	0	0	0	0	0
36312	558356	3	4	0	0	1	5
36312	558361	3	0	1	0	0	1
36312	558362	3	1	1	0	1	3
36312	558366	3	2	3	0	0	5
36312	558370	3	1	0	0	0	1
36312	558382	3	1	0	0	1	2
36312	558385	3	1	1	1	1	4
36312	558393	3	1	3	0	0	4
36312	558395	3	3	2	0	0	5
36312	558406	3	1	3	0	1	5
36312	558412	3	0	1	0	1	2
36312	558414	3	1	2	0	0	3
36312	558415	3	1	3	0	0	4
36312	558418	3	0	1	0	0	1
36312	558419	3	0	1	0	0	1
36312	558424	3	1	2	0	1	4
36312	558435	3	1	0	0	1	2
36312	558451	3	1	1	0	0	2
36312	558453	3	4	1	0	0	5
36312	558454	3	2	0	0	1	3
36312	558461	3	1	0	0	2	3
36312	558475	3	2	0	0	0	2
36312	558477	3	1	0	0	0	1
36312	558482	3	0	1	0	0	1
36312	558494	3	2	0	0	0	2
36312	558498	3	1	0	0	0	1
36312	558504	3	0	1	0	0	1
36312	558510	3	0	0	0	0	0
36312	558514	3	0	2	0	1	3
36312	558526	3	1	0	0	0	1
36312	558540	3	1	0	0	1	2
36312	558542	3	3	0	0	0	3
36312	558551	3	1	0	0	0	1
36312	558557	3	0	0	0	0	0
36312	558572	3	1	0	0	0	1
36312	558575	3	1	0	0	0	1
36312	558577	3	2	2	0	1	5
36312	558580	3	0	0	0	0	0
36312	558588	3	0	0	0	0	0
36312	194315	2	1	1	0	1	3
36312	201234	2	0	2	0	0	2
36312	204572	2	1	0	0	0	1
36312	207623	2	2	1	0	0	3
36312	292845	2	2	1	0	0	3
36312	558254	2	0	1	0	0	1
36312	558292	2	0	1	0	0	1
36312	558299	2	1	1	0	0	2
36312	558300	2	1	1	0	0	2
36312	558317	2	0	0	0	0	0
36312	558325	2	0	1	0	0	1
36312	558327	2	0	0	0	0	0
36312	558331	2	1	1	0	0	2
36312	558335	2	0	1	0	0	1
36312	558355	2	2	3	2	0	7
36312	558357	2	0	0	0	0	0
36312	558378	2	5	0	0	0	5
36312	558380	2	1	3	1	0	5
36312	558383	2	1	1	0	0	2
36312	558387	2	0	1	0	0	1
36312	558388	2	1	2	0	1	4
36312	558390	2	1	1	0	0	2
36312	558394	2	3	1	0	2	6
36312	558401	2	1	0	0	0	1
36312	558417	2	1	1	1	0	3
36312	558432	2	0	0	0	0	0
36312	558440	2	0	1	0	0	1
36312	558449	2	0	0	0	0	0
36312	558457	2	0	1	0	0	1
36312	558460	2	2	1	0	0	3
36312	558490	2	1	0	0	0	1
36312	558491	2	1	0	0	0	1
36312	558493	2	0	0	0	0	0
36312	558499	2	1	0	0	0	1
36312	558501	2	0	0	0	0	0
36312	558505	2	1	1	0	0	2
36312	558506	2	0	0	0	0	0
36312	558507	2	0	0	0	0	0
36312	558512	2	0	1	0	2	3
36312	558521	2	0	0	0	0	0
36312	558528	2	1	1	0	0	2
36312	558529	2	0	0	0	1	1
36312	558535	2	1	0	0	0	1
36312	558544	2	0	2	0	1	3
36312	558549	2	1	0	0	0	1
36312	558550	2	1	1	0	1	3
36312	558553	2	0	0	0	0	0
36312	558563	2	0	0	0	0	0
36312	558566	2	2	0	0	1	3
36312	558569	2	0	0	0	1	1
36312	558570	2	0	0	0	0	0
36312	558579	2	0	0	0	0	0
36312	558581	2	1	0	0	0	1
36312	558582	2	0	0	0	0	0
36312	558583	2	1	0	0	0	1
36312	558585	2	0	0	0	0	0
36312	201187	1	1	0	0	0	1
36312	207172	1	0	0	0	0	0
36312	207896	1	0	1	0	0	1
36312	558247	1	0	1	0	0	1
36312	558249	1	0	0	0	1	1
36312	558250	1	0	1	0	0	1
36312	558251	1	2	0	0	0	2
36312	558269	1	0	0	0	0	0
36312	558288	1	1	0	0	0	1
36312	558297	1	0	2	0	0	2
36312	558303	1	0	1	0	0	1
36312	558309	1	1	0	0	1	2
36312	558316	1	0	2	0	0	2
36312	558332	1	0	1	0	0	1
36312	558337	1	1	0	0	0	1
36312	558341	1	0	0	0	0	0
36312	558350	1	0	0	0	0	0
36312	558351	1	0	0	0	0	0
36312	558352	1	0	0	0	1	1
36312	558363	1	1	1	0	1	3
36312	558368	1	0	0	0	0	0
36312	558375	1	1	0	0	0	1
36312	558377	1	0	0	0	0	0
36312	558381	1	0	0	0	1	1
36312	558386	1	1	1	0	0	2
36312	558391	1	1	0	1	1	3
36312	558404	1	2	3	0	1	6
36312	558411	1	1	2	1	0	4
36312	558426	1	0	1	0	0	1
36312	558431	1	1	0	0	0	1
36312	558472	1	0	2	0	1	3
36312	558474	1	1	0	0	0	1
36312	558481	1	1	0	0	0	1
36312	558483	1	1	0	0	0	1
36312	558487	1	0	1	0	1	2
36312	558492	1	0	0	0	0	0
36312	558509	1	0	0	0	0	0
36312	558520	1	2	0	0	0	2
36312	558523	1	1	0	0	0	1
36312	558524	1	1	1	0	0	2
36312	558525	1	0	0	0	0	0
36312	558530	1	0	1	0	0	1
36312	558532	1	2	0	0	0	2
36312	558538	1	1	1	0	0	2
36312	558543	1	0	0	0	0	0
36312	558545	1	0	0	0	0	0
36312	558548	1	0	0	0	3	3
36312	558571	1	1	0	0	0	1
36312	558584	1	0	0	0	0	0
36312	558586	1	0	0	0	0	0
36312	558587	1	0	0	0	0	0
137782	556482	34	7	4	2	3	16
137782	556739	31	7	9	0	6	22
137782	556788	31	3	1	0	2	6
137782	556736	26	5	7	0	15	27
137782	556757	26	5	7	0	15	27
137782	556520	20	1	11	1	0	13
137782	556519	17	7	0	2	1	10
137782	556608	17	0	1	0	2	3
137782	556574	16	2	1	0	1	4
137782	556499	14	0	2	0	2	4
137782	556580	14	3	3	0	0	6
137782	556635	14	3	3	1	0	7
137782	556747	14	0	2	0	2	4
137782	556582	13	0	2	1	0	3
137782	556642	13	2	3	0	2	7
137782	556680	13	7	1	1	0	9
137782	556789	13	2	1	0	1	4
137782	556491	12	0	1	1	1	3
137782	556690	12	2	1	0	2	5
137782	556733	12	0	2	0	1	3
137782	556749	12	2	1	1	0	4
137782	556484	11	2	2	0	2	6
137782	556500	11	1	2	1	5	9
137782	556518	11	3	3	0	1	7
137782	556526	11	1	2	1	0	4
137782	556554	11	0	0	0	0	0
137782	556573	11	4	2	0	3	9
137782	556603	11	0	5	1	1	7
137782	556641	11	3	2	0	1	6
137782	556653	11	1	4	1	3	9
137782	556682	11	3	2	0	2	7
137782	556694	11	0	2	0	1	3
137782	556517	10	1	1	1	0	3
137782	556537	10	0	0	1	0	1
137782	556571	10	0	1	0	0	1
137782	556619	10	2	4	0	2	8
137782	556664	10	2	1	0	1	4
137782	556668	10	1	1	0	0	2
137782	556695	10	1	1	0	1	3
137782	556725	10	1	2	0	1	4
137782	556802	10	0	1	0	0	1
137782	556471	9	3	3	1	0	7
137782	556474	9	0	3	0	1	4
137782	556493	9	4	1	0	0	5
137782	556507	9	0	1	0	1	2
137782	556558	9	0	4	0	0	4
137782	556560	9	1	1	0	2	4
137782	556586	9	2	7	1	2	12
137782	556593	9	2	1	1	0	4
137782	556620	9	1	4	0	1	6
137782	556647	9	1	2	0	1	4
137782	556649	9	3	4	1	1	9
137782	556753	9	2	1	0	3	6
137782	556781	9	0	2	0	1	3
137782	556800	9	0	1	0	0	1
137782	556475	8	1	2	0	1	4
137782	556511	8	2	1	0	3	6
137782	556515	8	4	1	0	1	6
137782	556538	8	0	1	0	1	2
137782	556585	8	2	4	1	0	7
137782	556623	8	0	1	1	0	2
137782	556631	8	0	3	1	1	5
137782	556689	8	2	0	0	0	2
137782	556715	8	2	3	0	1	6
137782	556730	8	1	0	0	3	4
137782	556756	8	3	3	2	0	8
137782	556759	8	0	0	0	0	0
137782	556760	8	0	1	0	1	2
137782	556767	8	0	1	0	1	2
137782	556828	8	2	0	0	4	6
137782	556481	7	3	4	0	1	8
137782	556497	7	2	6	0	0	8
137782	556501	7	1	1	0	0	2
137782	556513	7	2	2	0	3	7
137782	556535	7	4	2	0	0	6
137782	556539	7	3	0	0	0	3
137782	556568	7	2	1	0	0	3
137782	556577	7	0	0	0	0	0
137782	556598	7	2	4	0	0	6
137782	556611	7	2	3	0	0	5
137782	556614	7	0	0	0	1	1
137782	556615	7	0	0	0	0	0
137782	556618	7	1	6	0	0	7
137782	556627	7	0	3	0	0	3
137782	556629	7	4	3	0	2	9
137782	556636	7	1	5	0	2	8
137782	556654	7	4	6	2	0	12
137782	556673	7	1	1	0	2	4
137782	556699	7	1	0	0	1	2
137782	556704	7	5	4	1	1	11
137782	556716	7	1	3	0	1	5
137782	556722	7	1	0	0	2	3
137782	556734	7	1	0	0	2	3
137782	556751	7	2	2	0	0	4
137782	556783	7	1	1	0	0	2
137782	556785	7	1	0	0	3	4
137782	556816	7	2	0	0	0	2
137782	556821	7	2	2	0	0	4
137782	556832	7	2	2	0	1	5
137782	556836	7	3	1	0	0	4
137782	556470	6	0	0	1	0	1
137782	556506	6	0	0	0	1	1
137782	556512	6	1	2	0	4	7
137782	556516	6	3	3	0	1	7
137782	556522	6	2	0	0	0	2
137782	556549	6	0	2	0	2	4
137782	556551	6	3	1	0	0	4
137782	556572	6	3	0	1	1	5
137782	556581	6	1	2	0	0	3
137782	556589	6	3	1	0	0	4
137782	556597	6	2	2	0	1	5
137782	556604	6	1	3	1	1	6
137782	556628	6	0	3	0	1	4
137782	556630	6	1	3	0	0	4
137782	556637	6	1	2	0	0	3
137782	556638	6	0	1	0	3	4
137782	556663	6	2	0	1	0	3
137782	556693	6	0	0	0	1	1
137782	556696	6	2	2	0	2	6
137782	556697	6	0	1	0	2	3
137782	556714	6	1	3	0	0	4
137782	556731	6	2	2	0	0	4
137782	556732	6	1	0	0	1	2
137782	556738	6	0	0	0	1	1
137782	556740	6	2	0	0	1	3
137782	556748	6	1	1	0	2	4
137782	556754	6	2	1	0	0	3
137782	556762	6	1	0	0	1	2
137782	556766	6	1	1	0	1	3
137782	556768	6	1	1	0	1	3
137782	556782	6	1	2	0	0	3
137782	556794	6	1	5	1	0	7
137782	556797	6	3	1	0	0	4
137782	556801	6	1	0	0	1	2
137782	556812	6	1	0	0	2	3
137782	556814	6	1	1	0	0	2
137782	556826	6	2	1	0	0	3
137782	556473	5	3	2	0	2	7
137782	556477	5	2	0	0	1	3
137782	556488	5	2	2	0	0	4
137782	556492	5	1	1	0	0	2
137782	556498	5	0	2	0	0	2
137782	556504	5	4	2	0	1	7
137782	556505	5	1	0	0	3	4
137782	556528	5	1	1	0	0	2
137782	556540	5	0	0	1	0	1
137782	556541	5	1	1	0	0	2
137782	556546	5	0	3	1	0	4
137782	556552	5	0	1	0	2	3
137782	556553	5	0	0	0	0	0
137782	556555	5	1	0	0	1	2
137782	556556	5	1	2	0	1	4
137782	556557	5	2	1	0	0	3
137782	556559	5	0	0	0	0	0
137782	556565	5	0	1	1	0	2
137782	556567	5	1	0	0	0	1
137782	556570	5	1	1	0	0	2
137782	556575	5	2	1	0	0	3
137782	556579	5	1	0	0	4	5
137782	556583	5	0	1	0	0	1
137782	556588	5	3	1	0	2	6
137782	556594	5	1	1	0	2	4
137782	556595	5	2	0	0	0	2
137782	556606	5	2	0	0	2	4
137782	556617	5	0	0	0	0	0
137782	556624	5	0	0	0	1	1
137782	556640	5	4	0	0	1	5
137782	556643	5	1	1	0	0	2
137782	556644	5	1	2	0	0	3
137782	556645	5	2	1	0	0	3
137782	556656	5	1	1	0	0	2
137782	556657	5	4	2	0	1	7
137782	556674	5	2	3	0	0	5
137782	556687	5	1	1	0	0	2
137782	556709	5	0	0	0	1	1
137782	556710	5	0	1	0	0	1
137782	556720	5	0	2	1	1	4
137782	556724	5	4	2	0	0	6
137782	556726	5	2	0	0	1	3
137782	556741	5	1	0	0	2	3
137782	556752	5	0	1	0	0	1
137782	556763	5	2	0	0	1	3
137782	556776	5	1	0	0	1	2
137782	556777	5	0	5	0	0	5
137782	556778	5	0	1	0	2	3
137782	556798	5	0	0	0	0	0
137782	556809	5	1	0	0	0	1
137782	556813	5	0	0	0	0	0
137782	556818	5	2	2	0	1	5
137782	556823	5	1	0	0	1	2
137782	556824	5	0	2	1	1	4
137782	556827	5	1	0	0	0	1
137782	556829	5	2	1	0	2	5
137782	556837	5	0	3	1	1	5
137782	556469	4	1	0	0	0	1
137782	556479	4	2	2	1	2	7
137782	556485	4	1	1	0	3	5
137782	556502	4	0	2	0	1	3
137782	556521	4	4	0	0	2	6
137782	556523	4	0	0	0	0	0
137782	556525	4	3	0	0	2	5
137782	556531	4	0	4	0	0	4
137782	556543	4	1	1	0	1	3
137782	556547	4	0	0	0	1	1
137782	556548	4	3	1	0	1	5
137782	556566	4	0	0	0	0	0
137782	556569	4	2	0	1	0	3
137782	556576	4	0	0	0	0	0
137782	556584	4	0	1	0	0	1
137782	556599	4	4	5	1	1	11
137782	556601	4	1	0	0	0	1
137782	556602	4	2	2	0	1	5
137782	556605	4	2	0	0	1	3
137782	556610	4	0	0	0	1	1
137782	556612	4	4	0	0	1	5
137782	556613	4	2	2	0	0	4
137782	556622	4	1	0	0	3	4
137782	556634	4	1	1	0	0	2
137782	556639	4	0	0	0	0	0
137782	556650	4	2	0	0	1	3
137782	556652	4	0	0	0	1	1
137782	556667	4	0	1	0	1	2
137782	556671	4	1	3	0	0	4
137782	556678	4	0	2	0	0	2
137782	556679	4	3	1	0	1	5
137782	556683	4	2	0	0	0	2
137782	556685	4	3	2	0	0	5
137782	556686	4	1	1	0	1	3
137782	556688	4	0	1	0	1	2
137782	556698	4	1	1	0	0	2
137782	556705	4	1	1	0	1	3
137782	556706	4	0	0	0	1	1
137782	556711	4	0	1	0	0	1
137782	556713	4	2	1	0	1	4
137782	556717	4	0	1	0	0	1
137782	556718	4	2	0	0	1	3
137782	556719	4	1	0	0	0	1
137782	556721	4	0	2	0	1	3
137782	556727	4	4	0	0	1	5
137782	556728	4	1	0	0	0	1
137782	556729	4	2	2	0	2	6
137782	556742	4	0	1	0	0	1
137782	556743	4	2	1	1	1	5
137782	556745	4	1	0	0	0	1
137782	556755	4	2	2	0	0	4
137782	556765	4	0	0	0	0	0
137782	556769	4	1	0	0	0	1
137782	556775	4	0	0	0	0	0
137782	556779	4	1	2	0	0	3
137782	556790	4	2	2	0	2	6
137782	556799	4	1	0	0	0	1
137782	556806	4	0	1	0	2	3
137782	556815	4	0	0	0	0	0
137782	556822	4	0	0	0	0	0
137782	556830	4	2	1	0	0	3
137782	556835	4	0	0	0	0	0
137782	556480	3	2	0	0	0	2
137782	556496	3	1	3	0	0	4
137782	556514	3	0	1	0	0	1
137782	556532	3	0	1	0	1	2
137782	556536	3	1	0	0	1	2
137782	556545	3	0	1	0	0	1
137782	556550	3	1	0	0	0	1
137782	556562	3	1	0	0	0	1
137782	556564	3	1	3	0	0	4
137782	556590	3	0	0	0	0	0
137782	556596	3	0	0	0	1	1
137782	556600	3	0	1	0	1	2
137782	556607	3	3	2	0	0	5
137782	556616	3	1	0	0	0	1
137782	556621	3	0	0	1	0	1
137782	556625	3	1	0	0	0	1
137782	556633	3	1	0	0	0	1
137782	556646	3	0	0	0	0	0
137782	556659	3	0	0	0	0	0
137782	556660	3	3	1	0	0	4
137782	556661	3	0	1	0	0	1
137782	556666	3	0	2	0	0	2
137782	556677	3	1	1	1	1	4
137782	556691	3	0	0	1	0	1
137782	556692	3	0	2	2	2	6
137782	556700	3	2	1	0	1	4
137782	556701	3	1	0	0	0	1
137782	556702	3	0	0	0	1	1
137782	556708	3	0	0	0	0	0
137782	556712	3	1	1	0	1	3
137782	556735	3	0	0	0	0	0
137782	556744	3	1	0	0	0	1
137782	556746	3	0	1	0	0	1
137782	556750	3	0	1	0	0	1
137782	556758	3	0	0	0	0	0
137782	556773	3	3	0	0	0	3
137782	556774	3	0	0	0	0	0
137782	556786	3	0	0	0	0	0
137782	556791	3	1	0	0	0	1
137782	556792	3	0	0	0	2	2
137782	556795	3	2	0	0	1	3
137782	556796	3	1	1	0	0	2
137782	556807	3	1	1	0	0	2
137782	556810	3	0	1	0	1	2
137782	556811	3	2	0	0	0	2
137782	556817	3	1	0	0	0	1
137782	556819	3	0	3	0	0	3
137782	556831	3	1	0	0	0	1
137782	556476	2	1	0	0	1	2
137782	556478	2	1	1	0	0	2
137782	556486	2	0	1	0	1	2
137782	556494	2	1	0	0	2	3
137782	556509	2	1	0	0	1	2
137782	556510	2	0	1	0	0	1
137782	556527	2	2	0	0	0	2
137782	556529	2	0	1	0	0	1
137782	556530	2	0	4	0	1	5
137782	556534	2	0	1	0	1	2
137782	556563	2	2	2	1	2	7
137782	556591	2	1	0	0	0	1
137782	556609	2	0	1	0	0	1
137782	556626	2	0	1	0	0	1
137782	556632	2	0	0	0	0	0
137782	556648	2	0	0	0	1	1
137782	556651	2	0	1	1	0	2
137782	556655	2	2	1	0	4	7
137782	556665	2	0	0	0	0	0
137782	556669	2	0	0	0	0	0
137782	556670	2	1	0	0	1	2
137782	556672	2	1	2	0	0	3
137782	556675	2	0	1	0	0	1
137782	556676	2	2	0	0	0	2
137782	556681	2	2	0	0	1	3
137782	556684	2	0	2	0	1	3
137782	556723	2	1	1	0	0	2
137782	556737	2	0	0	0	0	0
137782	556761	2	1	0	0	0	1
137782	556770	2	1	4	0	2	7
137782	556771	2	4	0	0	1	5
137782	556772	2	0	0	0	0	0
137782	556780	2	0	0	0	1	1
137782	556784	2	0	0	0	1	1
137782	556793	2	0	1	0	0	1
137782	556805	2	0	0	0	0	0
137782	556820	2	2	0	0	2	4
137782	556825	2	0	1	0	2	3
137782	556834	2	0	0	0	0	0
137782	556468	1	1	0	0	0	1
137782	556472	1	0	1	0	0	1
137782	556483	1	0	3	0	0	3
137782	556487	1	0	0	0	1	1
137782	556489	1	0	2	0	0	2
137782	556490	1	0	1	0	1	2
137782	556495	1	0	1	0	0	1
137782	556503	1	4	0	0	0	4
137782	556508	1	1	2	0	0	3
137782	556524	1	0	0	0	0	0
137782	556533	1	0	1	0	1	2
137782	556542	1	0	0	0	0	0
137782	556544	1	0	1	0	2	3
137782	556561	1	1	0	0	2	3
137782	556578	1	0	0	0	2	2
137782	556587	1	0	0	0	0	0
137782	556592	1	0	0	0	1	1
137782	556662	1	1	0	0	2	3
137782	556703	1	0	0	0	0	0
137782	556707	1	0	0	0	2	2
137782	556764	1	1	0	0	3	4
137782	556787	1	0	0	0	0	0
137782	556803	1	0	0	0	0	0
137782	556804	1	0	0	0	0	0
137782	556808	1	0	1	0	1	2
137782	556833	1	1	2	0	1	4
30818	570692	42	4	7	2	5	18
30818	570867	22	1	2	2	0	5
30818	202366	17	1	3	0	0	4
30818	570913	17	0	2	0	1	3
30818	291315	16	1	3	0	0	4
30818	570690	16	1	3	0	0	4
30818	570701	16	2	3	0	1	6
30818	219133	15	0	2	0	0	2
30818	291318	14	2	7	0	0	9
30818	570684	14	1	2	2	2	7
30818	570799	14	2	1	0	1	4
30818	570868	14	0	1	0	0	1
30818	291322	13	5	3	1	0	9
30818	570767	13	0	1	0	0	1
30818	570689	12	2	5	4	0	11
30818	570835	12	2	3	0	2	7
30818	291316	11	3	0	1	0	4
30818	570695	11	1	4	2	0	7
30818	570732	11	2	3	1	0	6
30818	570930	11	0	3	0	2	5
30818	570707	10	1	1	3	0	5
30818	570894	10	0	2	0	0	2
30818	570901	10	2	1	0	1	4
30818	570907	10	3	1	0	0	4
30818	570936	10	0	2	4	1	7
30818	186042	9	0	2	1	1	4
30818	291320	9	1	0	2	0	3
30818	570699	9	0	3	0	1	4
30818	570778	9	2	0	0	0	2
30818	570797	9	3	2	2	1	8
30818	291321	8	2	2	0	0	4
30818	570705	8	1	4	0	1	6
30818	570858	8	1	1	0	1	3
30818	570869	8	0	2	2	0	4
30818	570870	8	0	2	1	0	3
30818	570871	8	2	1	0	0	3
30818	570904	8	1	2	0	1	4
30818	570905	8	0	3	1	0	4
30818	195203	7	1	2	0	0	3
30818	206669	7	1	4	0	0	5
30818	220590	7	1	1	0	1	3
30818	291317	7	0	1	1	0	2
30818	570691	7	0	2	1	0	3
30818	570711	7	0	4	1	0	5
30818	570713	7	1	2	0	0	3
30818	570714	7	2	3	0	0	5
30818	570740	7	0	1	1	0	2
30818	570749	7	0	4	0	1	5
30818	570812	7	2	1	0	0	3
30818	570831	7	1	1	0	1	3
30818	570838	7	0	1	1	0	2
30818	570864	7	1	2	0	0	3
30818	570886	7	1	1	0	0	2
30818	570891	7	1	0	0	0	1
30818	570929	7	0	4	1	1	6
30818	570951	7	2	2	0	0	4
30818	214012	6	0	2	2	0	4
30818	291323	6	0	1	0	0	1
30818	570687	6	2	0	0	0	2
30818	570704	6	1	4	0	0	5
30818	570706	6	0	2	0	1	3
30818	570709	6	1	0	0	0	1
30818	570717	6	1	0	3	0	4
30818	570719	6	1	0	1	0	2
30818	570793	6	1	0	0	0	1
30818	570801	6	2	1	0	0	3
30818	570822	6	1	1	1	0	3
30818	570826	6	1	2	0	0	3
30818	570841	6	1	2	0	1	4
30818	570852	6	3	1	0	0	4
30818	570860	6	0	2	0	0	2
30818	570862	6	1	0	0	1	2
30818	570876	6	1	1	0	0	2
30818	570880	6	0	1	0	0	1
30818	570885	6	0	3	2	0	5
30818	570887	6	4	2	0	1	7
30818	570889	6	0	2	0	0	2
30818	570912	6	0	0	0	0	0
30818	570919	6	4	0	2	0	6
30818	570931	6	0	2	0	0	2
30818	570932	6	0	1	0	0	1
30818	570934	6	1	0	0	0	1
30818	570941	6	2	3	0	0	5
30818	570944	6	0	0	0	0	0
30818	183733	5	0	1	0	0	1
30818	194204	5	0	1	1	0	2
30818	195951	5	0	0	0	0	0
30818	198044	5	1	0	0	0	1
30818	199694	5	2	0	0	0	2
30818	199769	5	0	1	0	0	1
30818	205217	5	0	0	0	2	2
30818	213537	5	0	0	2	0	2
30818	216012	5	1	2	0	0	3
30818	570688	5	2	0	0	0	2
30818	570698	5	1	1	0	0	2
30818	570728	5	1	3	0	1	5
30818	570745	5	3	0	1	0	4
30818	570752	5	0	2	0	0	2
30818	570753	5	1	0	0	0	1
30818	570771	5	1	2	0	0	3
30818	570796	5	0	2	0	0	2
30818	570806	5	0	2	0	0	2
30818	570807	5	2	2	0	0	4
30818	570810	5	1	1	0	0	2
30818	570815	5	0	4	1	0	5
30818	570816	5	0	2	0	0	2
30818	570818	5	1	2	1	1	5
30818	570821	5	1	1	0	0	2
30818	570825	5	1	0	0	0	1
30818	570833	5	2	2	0	0	4
30818	570840	5	1	1	0	0	2
30818	570850	5	0	1	0	2	3
30818	570855	5	3	2	0	0	5
30818	570866	5	1	3	2	0	6
30818	570873	5	3	0	0	2	5
30818	570898	5	1	1	0	0	2
30818	570906	5	0	1	0	0	1
30818	570914	5	0	0	0	0	0
30818	570924	5	1	1	0	0	2
30818	570947	5	1	2	0	1	4
30818	570952	5	1	0	0	0	1
30818	570955	5	0	0	0	0	0
30818	193910	4	1	2	0	0	3
30818	195993	4	2	2	0	0	4
30818	201229	4	0	3	0	1	4
30818	208935	4	1	1	0	0	2
30818	210587	4	0	1	0	1	2
30818	570675	4	1	4	0	0	5
30818	570683	4	0	1	1	0	2
30818	570700	4	0	0	0	0	0
30818	570702	4	0	0	0	0	0
30818	570708	4	0	0	0	0	0
30818	570723	4	1	0	0	1	2
30818	570734	4	0	2	1	0	3
30818	570736	4	1	1	0	0	2
30818	570738	4	1	1	0	0	2
30818	570739	4	1	0	0	0	1
30818	570744	4	0	3	0	0	3
30818	570747	4	0	1	0	0	1
30818	570748	4	0	1	0	0	1
30818	570754	4	1	1	0	0	2
30818	570758	4	0	0	0	0	0
30818	570760	4	0	1	0	0	1
30818	570761	4	2	3	0	0	5
30818	570762	4	0	0	0	0	0
30818	570763	4	0	1	0	0	1
30818	570773	4	1	1	1	0	3
30818	570774	4	1	1	0	1	3
30818	570775	4	1	2	1	0	4
30818	570776	4	1	3	0	0	4
30818	570780	4	3	2	0	1	6
30818	570782	4	0	3	0	0	3
30818	570790	4	0	0	0	0	0
30818	570794	4	2	0	0	0	2
30818	570804	4	0	2	0	0	2
30818	570814	4	1	0	0	0	1
30818	570817	4	1	1	0	0	2
30818	570819	4	1	1	0	0	2
30818	570837	4	0	0	0	0	0
30818	570839	4	0	1	0	0	1
30818	570843	4	0	0	0	0	0
30818	570846	4	0	0	0	1	1
30818	570848	4	1	0	0	0	1
30818	570853	4	0	0	0	1	1
30818	570865	4	0	1	0	0	1
30818	570882	4	1	0	0	0	1
30818	570883	4	0	2	0	0	2
30818	570888	4	1	0	0	0	1
30818	570892	4	2	1	1	0	4
30818	570895	4	1	0	0	0	1
30818	570897	4	1	0	0	0	1
30818	570910	4	2	1	1	0	4
30818	570911	4	2	2	0	1	5
30818	570916	4	0	0	0	0	0
30818	570917	4	0	1	0	1	2
30818	570920	4	1	1	0	0	2
30818	570921	4	0	1	0	0	1
30818	570928	4	0	1	0	0	1
30818	570937	4	2	0	0	1	3
30818	570938	4	1	2	0	0	3
30818	570939	4	1	2	0	0	3
30818	570940	4	0	0	0	1	1
30818	570945	4	3	0	0	0	3
30818	570946	4	0	1	0	0	1
30818	189128	3	0	2	0	0	2
30818	189684	3	1	0	0	0	1
30818	190975	3	0	2	0	0	2
30818	192011	3	0	1	0	0	1
30818	197445	3	0	3	1	0	4
30818	198682	3	1	1	0	0	2
30818	206705	3	0	0	0	0	0
30818	211808	3	0	2	0	0	2
30818	212797	3	0	0	0	0	0
30818	217937	3	1	0	0	0	1
30818	219942	3	0	1	0	0	1
30818	219982	3	0	1	0	2	3
30818	291319	3	0	2	0	0	2
30818	291324	3	0	1	0	1	2
30818	570678	3	0	2	0	0	2
30818	570680	3	0	0	0	0	0
30818	570694	3	1	0	0	1	2
30818	570696	3	1	2	0	0	3
30818	570697	3	1	0	0	0	1
30818	570710	3	0	1	0	0	1
30818	570718	3	0	2	0	0	2
30818	570727	3	0	1	0	0	1
30818	570730	3	0	1	0	0	1
30818	570742	3	0	1	0	0	1
30818	570750	3	0	0	0	0	0
30818	570751	3	0	2	0	0	2
30818	570755	3	1	0	0	2	3
30818	570764	3	0	1	0	0	1
30818	570765	3	1	1	0	0	2
30818	570766	3	0	0	0	0	0
30818	570768	3	1	0	0	1	2
30818	570770	3	2	0	2	0	4
30818	570779	3	0	1	1	0	2
30818	570783	3	0	1	0	0	1
30818	570785	3	1	2	0	0	3
30818	570786	3	1	2	0	0	3
30818	570789	3	0	0	0	0	0
30818	570802	3	1	4	0	0	5
30818	570809	3	3	1	0	0	4
30818	570820	3	1	0	0	0	1
30818	570824	3	1	1	0	0	2
30818	570827	3	1	1	0	0	2
30818	570828	3	1	1	0	0	2
30818	570829	3	2	1	0	0	3
30818	570830	3	2	1	0	0	3
30818	570832	3	0	3	0	0	3
30818	570836	3	1	1	0	0	2
30818	570842	3	0	1	0	0	1
30818	570845	3	1	0	0	0	1
30818	570847	3	1	1	0	0	2
30818	570849	3	0	1	0	0	1
30818	570851	3	0	1	0	0	1
30818	570856	3	0	0	0	0	0
30818	570857	3	0	1	0	0	1
30818	570872	3	0	3	0	0	3
30818	570875	3	0	1	0	0	1
30818	570890	3	3	0	1	0	4
30818	570902	3	0	0	0	0	0
30818	570918	3	1	1	0	0	2
30818	570922	3	0	0	1	0	1
30818	570923	3	1	2	0	0	3
30818	570925	3	0	2	0	0	2
30818	570942	3	0	2	0	0	2
30818	570949	3	0	0	0	0	0
30818	570953	3	0	1	0	0	1
30818	185307	2	0	1	0	0	1
30818	186283	2	1	0	0	0	1
30818	186674	2	1	0	0	0	1
30818	190052	2	1	0	0	1	2
30818	192108	2	0	1	0	1	2
30818	192799	2	0	0	0	0	0
30818	194484	2	2	0	0	0	2
30818	200070	2	1	1	0	1	3
30818	201202	2	0	1	0	0	1
30818	201392	2	0	0	0	0	0
30818	203681	2	1	0	0	0	1
30818	206409	2	0	0	1	0	1
30818	207634	2	1	1	0	0	2
30818	210775	2	0	1	0	0	1
30818	291326	2	2	0	0	0	2
30818	570677	2	1	2	0	0	3
30818	570681	2	1	1	0	1	3
30818	570682	2	0	1	0	1	2
30818	570685	2	1	1	0	0	2
30818	570686	2	0	1	0	0	1
30818	570693	2	1	1	0	0	2
30818	570712	2	1	0	0	0	1
30818	570716	2	0	0	0	0	0
30818	570720	2	0	1	0	0	1
30818	570721	2	0	0	0	0	0
30818	570725	2	0	2	0	0	2
30818	570726	2	0	0	0	0	0
30818	570729	2	0	1	0	0	1
30818	570731	2	0	0	0	0	0
30818	570733	2	1	2	0	0	3
30818	570735	2	0	2	0	0	2
30818	570737	2	1	1	0	0	2
30818	570741	2	0	0	0	0	0
30818	570759	2	0	0	0	0	0
30818	570769	2	2	4	1	0	7
30818	570772	2	0	2	0	0	2
30818	570777	2	0	0	1	0	1
30818	570781	2	0	2	0	2	4
30818	570784	2	0	2	0	1	3
30818	570791	2	1	1	0	2	4
30818	570792	2	0	0	0	1	1
30818	570795	2	0	0	0	0	0
30818	570798	2	0	1	0	1	2
30818	570800	2	1	3	0	0	4
30818	570813	2	0	0	0	0	0
30818	570823	2	0	0	0	1	1
30818	570834	2	2	1	0	0	3
30818	570861	2	2	1	0	0	3
30818	570863	2	0	0	0	0	0
30818	570874	2	0	2	0	0	2
30818	570878	2	0	2	0	0	2
30818	570879	2	0	0	0	0	0
30818	570884	2	0	0	0	0	0
30818	570899	2	0	0	0	0	0
30818	570900	2	0	2	0	0	2
30818	570909	2	0	0	0	0	0
30818	570927	2	1	2	0	0	3
30818	570933	2	1	1	0	1	3
30818	570935	2	1	0	0	1	2
30818	570948	2	0	0	0	0	0
30818	570950	2	0	0	0	0	0
30818	570954	2	0	1	0	0	1
30818	570957	2	0	1	0	0	1
30818	183856	1	0	0	0	1	1
30818	185150	1	1	1	0	0	2
30818	186673	1	1	1	0	0	2
30818	187103	1	0	1	0	0	1
30818	190312	1	0	0	0	0	0
30818	191182	1	1	1	0	0	2
30818	192107	1	0	0	0	0	0
30818	199961	1	0	0	0	0	0
30818	207062	1	0	1	0	0	1
30818	216604	1	1	1	0	0	2
30818	217699	1	0	0	0	0	0
30818	221072	1	0	0	0	0	0
30818	291325	1	0	0	0	0	0
30818	570676	1	0	1	0	0	1
30818	570679	1	0	0	0	0	0
30818	570722	1	0	1	0	0	1
30818	570724	1	2	0	0	1	3
30818	570743	1	0	1	0	0	1
30818	570746	1	0	1	0	0	1
30818	570756	1	0	1	0	0	1
30818	570757	1	0	1	0	0	1
30818	570787	1	0	0	0	0	0
30818	570788	1	0	0	0	0	0
30818	570803	1	2	0	0	0	2
30818	570805	1	0	0	0	0	0
30818	570808	1	1	1	0	0	2
30818	570811	1	0	3	0	0	3
30818	570844	1	0	2	0	0	2
30818	570854	1	1	0	0	0	1
30818	570859	1	0	0	0	0	0
30818	570877	1	0	0	2	0	2
30818	570881	1	1	0	0	0	1
30818	570893	1	1	1	0	0	2
30818	570896	1	1	1	0	0	2
30818	570903	1	0	0	0	0	0
30818	570908	1	0	1	0	0	1
30818	570915	1	0	3	0	0	3
30818	570926	1	0	1	0	0	1
30818	570943	1	0	1	0	0	1
30818	570956	1	0	0	0	0	0
30818	570958	1	0	1	0	2	3
16060	579082	17	1	3	0	1	5
16060	579079	13	1	2	0	1	4
16060	579112	13	3	3	0	0	6
16060	579126	13	1	2	0	0	3
16060	579075	12	0	0	0	1	1
16060	210945	11	1	4	1	1	7
16060	579073	11	2	3	0	0	5
16060	579081	11	1	4	1	1	7
16060	579294	11	0	1	0	2	3
16060	579134	10	5	4	0	1	10
16060	579025	9	2	1	1	1	5
16060	579089	9	1	2	0	2	5
16060	579102	9	1	0	0	1	2
16060	579237	9	2	3	0	0	5
16060	579241	9	3	0	0	4	7
16060	197361	8	2	2	0	1	5
16060	198248	8	1	1	0	0	2
16060	204206	8	0	0	0	0	0
16060	212275	8	6	4	0	0	10
16060	579042	8	1	1	0	1	3
16060	579076	8	6	4	0	0	10
16060	579084	8	2	4	0	0	6
16060	579106	8	0	1	0	0	1
16060	579156	8	2	0	0	0	2
16060	579171	8	1	1	0	1	3
16060	579258	8	0	2	2	1	5
16060	579272	8	1	6	0	2	9
16060	207493	7	0	2	0	0	2
16060	287399	7	1	1	0	0	2
16060	287404	7	2	2	0	1	5
16060	287409	7	1	0	0	0	1
16060	579027	7	0	1	0	1	2
16060	579028	7	1	2	0	2	5
16060	579031	7	0	0	0	0	0
16060	579058	7	1	4	0	0	5
16060	579070	7	1	3	1	0	5
16060	579100	7	1	0	0	0	1
16060	579130	7	0	2	0	1	3
16060	579132	7	1	2	0	0	3
16060	579135	7	1	2	0	1	4
16060	579173	7	3	2	0	1	6
16060	579180	7	1	0	0	3	4
16060	579203	7	3	2	0	0	5
16060	579232	7	3	1	0	1	5
16060	579274	7	2	4	0	0	6
16060	579303	7	0	1	0	0	1
16060	199113	6	1	1	0	0	2
16060	203838	6	2	1	0	0	3
16060	287400	6	0	3	0	3	6
16060	287408	6	1	2	1	2	6
16060	287410	6	1	2	1	0	4
16060	287411	6	0	1	0	1	2
16060	579018	6	2	3	0	0	5
16060	579022	6	0	0	0	1	1
16060	579023	6	3	2	0	2	7
16060	579026	6	0	1	0	0	1
16060	579033	6	0	1	0	0	1
16060	579044	6	3	2	0	1	6
16060	579059	6	0	3	0	1	4
16060	579067	6	0	1	0	0	1
16060	579069	6	1	1	0	0	2
16060	579085	6	2	1	0	1	4
16060	579096	6	1	1	0	0	2
16060	579099	6	2	2	0	1	5
16060	579140	6	0	2	0	0	2
16060	579155	6	2	1	0	0	3
16060	579157	6	0	0	0	0	0
16060	579161	6	2	1	1	0	4
16060	579181	6	0	5	0	0	5
16060	579230	6	1	0	0	1	2
16060	579239	6	2	2	0	0	4
16060	579288	6	1	2	0	0	3
16060	193892	5	1	2	0	1	4
16060	206462	5	1	1	0	0	2
16060	212967	5	2	3	0	0	5
16060	287402	5	1	3	0	0	4
16060	579035	5	2	2	0	0	4
16060	579037	5	0	4	0	0	4
16060	579045	5	1	2	0	0	3
16060	579053	5	0	0	0	0	0
16060	579078	5	1	1	0	0	2
16060	579093	5	1	1	0	0	2
16060	579109	5	2	2	0	0	4
16060	579110	5	0	4	0	0	4
16060	579125	5	1	0	0	0	1
16060	579138	5	2	1	0	1	4
16060	579143	5	2	2	0	0	4
16060	579151	5	0	3	0	2	5
16060	579158	5	1	3	0	0	4
16060	579172	5	0	1	0	0	1
16060	579175	5	0	4	0	1	5
16060	579195	5	1	2	0	0	3
16060	579206	5	1	0	0	0	1
16060	579208	5	1	0	0	0	1
16060	579224	5	1	4	1	1	7
16060	579243	5	0	0	0	0	0
16060	579245	5	1	1	0	1	3
16060	579248	5	1	1	0	1	3
16060	579254	5	0	3	0	1	4
16060	579265	5	1	1	0	1	3
16060	579266	5	0	3	0	0	3
16060	579271	5	3	5	2	1	11
16060	579283	5	4	2	0	0	6
16060	579291	5	1	2	0	1	4
16060	579296	5	0	2	0	0	2
16060	579300	5	1	2	0	1	4
16060	189955	4	0	2	0	0	2
16060	202926	4	1	1	0	0	2
16060	203158	4	1	0	0	0	1
16060	204944	4	2	3	1	0	6
16060	208092	4	2	2	0	0	4
16060	210399	4	0	1	0	0	1
16060	221600	4	1	0	0	0	1
16060	287406	4	1	2	0	1	4
16060	287412	4	0	2	0	1	3
16060	579024	4	1	0	0	2	3
16060	579032	4	3	1	0	0	4
16060	579047	4	0	1	0	1	2
16060	579051	4	1	1	0	0	2
16060	579060	4	1	3	0	0	4
16060	579072	4	0	1	0	0	1
16060	579083	4	0	2	0	0	2
16060	579107	4	2	2	0	0	4
16060	579116	4	1	2	0	0	3
16060	579120	4	1	1	0	0	2
16060	579129	4	1	1	0	0	2
16060	579133	4	1	1	0	1	3
16060	579141	4	2	2	0	0	4
16060	579149	4	0	3	1	0	4
16060	579164	4	1	2	0	0	3
16060	579166	4	2	4	0	0	6
16060	579176	4	1	2	0	0	3
16060	579185	4	1	2	0	0	3
16060	579193	4	0	2	1	1	4
16060	579194	4	2	0	0	0	2
16060	579207	4	0	3	0	0	3
16060	579212	4	1	0	0	0	1
16060	579213	4	1	3	0	0	4
16060	579215	4	3	1	0	1	5
16060	579219	4	1	0	0	0	1
16060	579220	4	0	1	0	0	1
16060	579221	4	3	0	0	0	3
16060	579228	4	0	2	0	1	3
16060	579231	4	0	1	0	0	1
16060	579234	4	0	0	0	1	1
16060	579238	4	0	0	0	0	0
16060	579242	4	0	0	1	1	2
16060	579249	4	1	1	0	0	2
16060	579252	4	3	0	0	0	3
16060	579253	4	1	2	0	1	4
16060	579262	4	1	0	0	0	1
16060	579275	4	1	0	0	1	2
16060	579276	4	0	1	0	2	3
16060	579278	4	0	0	0	0	0
16060	579287	4	0	3	0	0	3
16060	579292	4	0	3	0	0	3
16060	579301	4	3	1	0	0	4
16060	198150	3	0	1	0	1	2
16060	206482	3	0	0	0	0	0
16060	207127	3	1	1	0	0	2
16060	216857	3	1	1	0	0	2
16060	221068	3	0	0	0	0	0
16060	287401	3	1	0	0	0	1
16060	287405	3	1	1	0	0	2
16060	287413	3	0	0	0	0	0
16060	287414	3	0	4	0	1	5
16060	287415	3	0	0	0	1	1
16060	579039	3	0	2	0	0	2
16060	579041	3	0	3	0	0	3
16060	579043	3	2	0	0	0	2
16060	579050	3	1	2	0	0	3
16060	579052	3	1	1	0	3	5
16060	579054	3	0	1	0	0	1
16060	579056	3	1	2	0	1	4
16060	579057	3	1	0	0	0	1
16060	579068	3	1	0	0	0	1
16060	579077	3	1	1	0	0	2
16060	579087	3	0	1	0	0	1
16060	579088	3	1	0	0	0	1
16060	579103	3	2	2	0	0	4
16060	579108	3	4	1	0	0	5
16060	579111	3	0	1	1	1	3
16060	579113	3	0	4	0	0	4
16060	579114	3	0	0	0	0	0
16060	579115	3	0	2	0	0	2
16060	579131	3	3	3	0	0	6
16060	579136	3	1	1	0	1	3
16060	579142	3	0	2	0	0	2
16060	579147	3	3	0	0	0	3
16060	579148	3	0	0	0	0	0
16060	579154	3	1	0	0	0	1
16060	579159	3	0	0	0	1	1
16060	579165	3	1	0	0	0	1
16060	579169	3	1	0	0	0	1
16060	579170	3	0	1	0	0	1
16060	579174	3	1	3	0	0	4
16060	579177	3	1	2	0	0	3
16060	579178	3	0	2	0	0	2
16060	579183	3	3	1	0	0	4
16060	579184	3	0	2	0	0	2
16060	579186	3	0	2	0	2	4
16060	579187	3	0	1	1	0	2
16060	579188	3	0	0	0	0	0
16060	579189	3	0	1	0	0	1
16060	579190	3	0	1	0	0	1
16060	579199	3	0	4	0	2	6
16060	579201	3	1	0	0	0	1
16060	579204	3	0	2	0	0	2
16060	579205	3	0	2	0	0	2
16060	579210	3	0	2	0	1	3
16060	579211	3	1	1	0	0	2
16060	579216	3	1	3	0	1	5
16060	579217	3	0	0	0	1	1
16060	579226	3	1	1	0	0	2
16060	579227	3	1	2	0	0	3
16060	579229	3	0	2	0	0	2
16060	579233	3	0	2	0	1	3
16060	579235	3	0	0	1	0	1
16060	579255	3	2	0	0	0	2
16060	579257	3	0	3	0	0	3
16060	579260	3	1	1	0	0	2
16060	579261	3	1	0	0	0	1
16060	579267	3	1	2	0	0	3
16060	579273	3	1	1	0	0	2
16060	579279	3	1	1	0	0	2
16060	579281	3	1	1	0	0	2
16060	579284	3	2	1	0	0	3
16060	579285	3	1	0	0	0	1
16060	579286	3	3	1	0	0	4
16060	579290	3	1	1	0	0	2
16060	579293	3	0	0	0	1	1
16060	579295	3	0	1	0	0	1
16060	579297	3	1	2	0	0	3
16060	579298	3	0	0	1	1	2
16060	185210	2	0	1	0	2	3
16060	187002	2	1	0	0	0	1
16060	190083	2	1	0	0	0	1
16060	196419	2	1	1	0	1	3
16060	199153	2	0	0	0	1	1
16060	200112	2	0	2	0	0	2
16060	203211	2	0	1	0	0	1
16060	210554	2	0	0	0	0	0
16060	212561	2	0	2	0	1	3
16060	214530	2	1	1	0	0	2
16060	218671	2	1	0	0	0	1
16060	218869	2	1	0	0	0	1
16060	287403	2	0	0	0	0	0
16060	579019	2	0	1	0	0	1
16060	579020	2	1	0	0	0	1
16060	579029	2	0	0	0	0	0
16060	579030	2	1	0	0	0	1
16060	579034	2	0	1	0	0	1
16060	579036	2	1	2	0	0	3
16060	579038	2	2	2	0	0	4
16060	579040	2	0	0	0	0	0
16060	579055	2	0	3	0	1	4
16060	579061	2	1	2	0	1	4
16060	579062	2	0	1	0	1	2
16060	579074	2	0	0	0	0	0
16060	579080	2	2	2	0	1	5
16060	579086	2	0	1	0	0	1
16060	579090	2	0	0	0	0	0
16060	579091	2	1	4	0	0	5
16060	579094	2	0	1	0	0	1
16060	579095	2	0	1	0	0	1
16060	579097	2	1	0	0	0	1
16060	579098	2	0	0	0	0	0
16060	579101	2	1	1	0	0	2
16060	579105	2	1	2	0	0	3
16060	579118	2	1	2	0	0	3
16060	579122	2	1	4	0	0	5
16060	579123	2	0	1	0	0	1
16060	579128	2	3	0	0	0	3
16060	579137	2	1	1	0	0	2
16060	579139	2	2	0	0	0	2
16060	579145	2	3	0	0	0	3
16060	579150	2	0	1	0	0	1
16060	579152	2	0	0	0	0	0
16060	579153	2	2	1	0	2	5
16060	579162	2	0	0	0	2	2
16060	579163	2	2	0	0	0	2
16060	579168	2	1	0	0	0	1
16060	579179	2	0	1	0	0	1
16060	579182	2	1	0	0	0	1
16060	579192	2	0	1	0	0	1
16060	579196	2	0	0	0	0	0
16060	579197	2	1	0	0	0	1
16060	579198	2	2	2	0	0	4
16060	579200	2	0	1	0	1	2
16060	579202	2	3	1	0	0	4
16060	579209	2	0	0	0	0	0
16060	579218	2	0	1	0	0	1
16060	579222	2	1	2	0	0	3
16060	579236	2	0	0	0	0	0
16060	579240	2	0	2	0	0	2
16060	579244	2	1	1	0	0	2
16060	579246	2	1	1	0	1	3
16060	579247	2	0	2	0	0	2
16060	579251	2	0	1	0	0	1
16060	579256	2	1	0	0	1	2
16060	579259	2	0	0	0	0	0
16060	579263	2	0	2	0	0	2
16060	579264	2	0	1	0	0	1
16060	579268	2	1	1	0	0	2
16060	579269	2	1	2	0	0	3
16060	579270	2	2	2	0	0	4
16060	579277	2	1	1	0	0	2
16060	579280	2	0	1	0	0	1
16060	579302	2	1	1	0	0	2
16060	185528	1	0	1	0	0	1
16060	188432	1	2	1	0	0	3
16060	194392	1	1	1	0	0	2
16060	198049	1	0	0	0	0	0
16060	200270	1	0	0	0	0	0
16060	200271	1	0	0	0	0	0
16060	210781	1	1	1	0	0	2
16060	219011	1	0	0	0	0	0
16060	220988	1	0	2	0	0	2
16060	221911	1	0	1	0	0	1
16060	287407	1	0	3	0	0	3
16060	579021	1	0	0	0	0	0
16060	579046	1	1	2	0	1	4
16060	579048	1	0	1	0	0	1
16060	579049	1	0	0	1	4	5
16060	579071	1	1	2	0	0	3
16060	579092	1	1	3	0	0	4
16060	579104	1	1	1	0	0	2
16060	579117	1	0	1	0	0	1
16060	579119	1	3	0	0	0	3
16060	579121	1	0	1	0	0	1
16060	579124	1	0	0	0	0	0
16060	579127	1	1	1	0	0	2
16060	579144	1	1	2	0	0	3
16060	579146	1	0	0	0	0	0
16060	579160	1	0	0	0	0	0
16060	579167	1	1	2	0	0	3
16060	579191	1	0	0	0	0	0
16060	579214	1	0	1	0	0	1
16060	579223	1	1	0	0	0	1
16060	579225	1	0	0	0	0	0
16060	579250	1	0	1	0	1	2
16060	579282	1	0	1	0	1	2
16060	579289	1	1	2	0	0	3
16060	579299	1	0	2	0	0	2
12028	193963	39	6	3	0	2	11
12028	286263	38	6	3	0	2	11
12028	88931	38	6	3	0	2	11
12028	388116	33	1	2	2	1	6
12028	101249	28	9	0	0	0	9
12028	286242	28	2	2	1	0	5
12028	388065	28	0	6	1	0	7
12028	100839	27	1	5	0	1	7
12028	214656	27	1	5	0	1	7
12028	286243	27	2	2	0	0	4
12028	286257	27	1	5	0	1	7
12028	388169	26	1	5	0	1	7
12028	388170	26	1	5	0	1	7
12028	388143	25	3	10	0	2	15
12028	78651	25	3	4	0	0	7
12028	388087	22	3	3	0	0	6
12028	388135	22	7	3	0	0	10
12028	286244	21	3	8	1	0	12
12028	388080	20	7	0	2	1	10
12028	105621	19	1	3	1	1	6
12028	190988	17	1	4	1	0	6
12028	286240	17	1	5	0	1	7
12028	286241	17	0	3	0	0	3
12028	388086	17	2	3	0	0	5
12028	95533	16	2	0	2	1	5
12028	208838	15	1	5	0	0	6
12028	286259	15	1	5	0	0	6
12028	286239	14	2	7	1	0	10
12028	388054	14	0	2	0	4	6
12028	388068	14	0	2	0	0	2
12028	388072	14	0	2	0	0	2
12028	388098	14	2	4	0	1	7
12028	286238	13	1	4	1	1	7
12028	388187	13	3	0	0	4	7
12028	573380	13	0	1	2	0	3
12028	100205	12	2	2	0	1	5
12028	188365	12	3	3	0	0	6
12028	286237	12	2	2	1	2	7
12028	388030	12	2	0	2	1	5
12028	388083	12	2	0	2	0	4
12028	388084	12	1	4	0	0	5
12028	388126	12	2	2	0	0	4
12028	388141	12	5	1	1	1	8
12028	388203	12	2	3	1	1	7
12028	183789	11	1	4	0	2	7
12028	286250	11	1	0	0	2	3
12028	388062	11	3	1	1	1	6
12028	388183	11	2	0	0	1	3
12028	70620	11	1	1	1	6	9
12028	74872	11	2	1	0	0	3
12028	100983	10	1	1	0	1	3
12028	186027	10	2	2	0	0	4
12028	186739	10	2	2	0	0	4
12028	286261	10	1	1	0	1	3
12028	388034	10	1	1	0	0	2
12028	388073	10	3	2	0	1	6
12028	388078	10	2	1	1	3	7
12028	388132	10	2	6	0	0	8
12028	388146	10	2	2	1	0	5
12028	388152	10	1	1	0	1	3
12028	388156	10	0	2	0	0	2
12028	388168	10	4	0	0	1	5
12028	388193	10	1	2	0	1	4
12028	573363	10	3	0	0	1	4
12028	188122	9	2	1	1	1	5
12028	388048	9	0	2	1	1	4
12028	388059	9	4	3	0	2	9
12028	388066	9	2	2	0	0	4
12028	388094	9	1	2	1	0	4
12028	388129	9	1	3	1	2	7
12028	388162	9	3	0	1	0	4
12028	388189	9	3	4	0	1	8
12028	83275	9	0	2	0	1	3
12028	189967	8	0	1	0	0	1
12028	286273	8	0	2	0	0	2
12028	388039	8	0	2	0	0	2
12028	388049	8	2	3	0	2	7
12028	388055	8	0	1	2	0	3
12028	388056	8	0	1	2	0	3
12028	388091	8	1	5	0	0	6
12028	388114	8	3	2	0	0	5
12028	388122	8	3	5	0	1	9
12028	388123	8	3	5	0	1	9
12028	388134	8	3	4	0	0	7
12028	388165	8	0	7	2	0	9
12028	388175	8	1	0	0	0	1
12028	388184	8	1	2	0	3	6
12028	388186	8	1	2	0	0	3
12028	388190	8	2	4	1	0	7
12028	388201	8	1	3	0	0	4
12028	388206	8	0	2	0	0	2
12028	456061	8	0	1	2	0	3
12028	573379	8	1	3	0	0	4
12028	84163	8	0	2	0	0	2
12028	207092	7	1	0	0	0	1
12028	207810	7	0	0	0	1	1
12028	209739	7	2	0	0	1	3
12028	213368	7	0	1	0	1	2
12028	220856	7	0	3	0	3	6
12028	388061	7	2	0	0	0	2
12028	388077	7	1	2	0	0	3
12028	388079	7	0	2	1	2	5
12028	388090	7	1	2	0	1	4
12028	388096	7	4	2	0	1	7
12028	388112	7	0	1	0	3	4
12028	388142	7	1	0	0	0	1
12028	388155	7	1	3	0	1	5
12028	388157	7	1	3	1	0	5
12028	388171	7	3	0	0	2	5
12028	388173	7	0	1	0	0	1
12028	388182	7	1	3	1	1	6
12028	388205	7	2	1	0	0	3
12028	573377	7	1	4	0	0	5
12028	73109	7	0	0	0	0	0
12028	193172	6	0	0	0	0	0
12028	193447	6	2	2	0	0	4
12028	202919	6	1	2	0	0	3
12028	207396	6	1	2	0	0	3
12028	210115	6	1	2	0	0	3
12028	286249	6	0	1	0	0	1
12028	286262	6	2	7	0	0	9
12028	286268	6	0	1	0	0	1
12028	286269	6	0	0	0	0	0
12028	388041	6	2	3	1	0	6
12028	388042	6	1	0	0	0	1
12028	388047	6	1	2	0	0	3
12028	388050	6	2	0	0	0	2
12028	388051	6	3	1	0	0	4
12028	388075	6	2	1	0	1	4
12028	388089	6	2	1	0	0	3
12028	388104	6	1	2	0	0	3
12028	388137	6	1	1	0	0	2
12028	388158	6	2	3	1	0	6
12028	388159	6	2	3	0	0	5
12028	388164	6	0	0	0	1	1
12028	388174	6	3	2	1	1	7
12028	388177	6	2	3	1	1	7
12028	388191	6	3	1	0	1	5
12028	388202	6	1	0	0	1	2
12028	50794	6	2	7	0	0	9
12028	573367	6	1	0	0	0	1
12028	573374	6	1	1	0	0	2
12028	573378	6	1	1	0	0	2
12028	79077	6	0	0	0	0	0
12028	80675	6	0	1	0	0	1
12028	82086	6	2	1	0	0	3
12028	86457	6	3	0	0	1	4
12028	103306	5	2	2	0	0	4
12028	104053	5	0	0	0	3	3
12028	106616	5	0	1	0	0	1
12028	183122	5	0	0	1	0	1
12028	184649	5	3	3	0	0	6
12028	203647	5	1	1	0	0	2
12028	204286	5	1	2	0	0	3
12028	210381	5	1	1	0	0	2
12028	210544	5	2	2	0	0	4
12028	214002	5	3	1	0	0	4
12028	215102	5	0	2	0	0	2
12028	286245	5	1	4	0	2	7
12028	286251	5	1	2	0	0	3
12028	286254	5	0	1	0	0	1
12028	286255	5	0	2	2	0	4
12028	286260	5	1	1	0	0	2
12028	286267	5	1	2	1	0	4
12028	388037	5	0	3	0	0	3
12028	388064	5	0	1	0	1	2
12028	388074	5	1	2	0	0	3
12028	388103	5	0	0	3	0	3
12028	388110	5	3	1	0	0	4
12028	388113	5	3	2	0	1	6
12028	388119	5	0	0	0	0	0
12028	388120	5	0	3	0	1	4
12028	388124	5	0	1	0	0	1
12028	388125	5	1	2	1	0	4
12028	388140	5	1	3	0	0	4
12028	388147	5	0	1	0	1	2
12028	388149	5	1	1	0	0	2
12028	388167	5	1	3	0	0	4
12028	388176	5	1	4	0	0	5
12028	388179	5	0	3	0	0	3
12028	388180	5	0	1	0	0	1
12028	388195	5	1	3	0	3	7
12028	388196	5	0	1	0	0	1
12028	388199	5	0	2	0	0	2
12028	59652	5	1	2	1	0	4
12028	71188	5	0	1	0	0	1
12028	71482	5	1	4	0	2	7
12028	78490	5	0	0	0	1	1
12028	84377	5	1	2	0	0	3
12028	95511	5	1	0	0	0	1
12028	191036	4	1	3	0	1	5
12028	193722	4	0	2	0	0	2
12028	193916	4	0	2	0	0	2
12028	201892	4	2	1	0	0	3
12028	205995	4	0	4	1	0	5
12028	208141	4	0	0	0	0	0
12028	210163	4	0	0	0	0	0
12028	211026	4	1	3	2	0	6
12028	211853	4	1	1	0	0	2
12028	286246	4	0	1	1	0	2
12028	286248	4	0	1	0	2	3
12028	286272	4	2	0	0	0	2
12028	388045	4	0	1	0	0	1
12028	388063	4	1	1	0	0	2
12028	388093	4	1	2	0	1	4
12028	388095	4	0	2	0	0	2
12028	388097	4	0	2	0	1	3
12028	388100	4	0	1	0	0	1
12028	388101	4	0	1	0	1	2
12028	388105	4	1	3	0	0	4
12028	388107	4	2	4	0	0	6
12028	388111	4	3	0	0	0	3
12028	388128	4	0	0	0	1	1
12028	388136	4	1	0	0	0	1
12028	388145	4	1	1	0	0	2
12028	388153	4	0	1	0	0	1
12028	388154	4	0	1	0	0	1
12028	388160	4	0	1	0	1	2
12028	388163	4	0	0	0	1	1
12028	388166	4	1	0	0	0	1
12028	388172	4	0	0	0	2	2
12028	388181	4	0	3	0	0	3
12028	388185	4	2	0	0	1	3
12028	388197	4	0	4	0	0	4
12028	388198	4	1	0	0	1	2
12028	388208	4	0	0	0	0	0
12028	573373	4	2	2	0	0	4
12028	573375	4	0	1	1	0	2
12028	58785	4	1	1	0	0	2
12028	74751	4	1	1	0	0	2
12028	84937	4	1	0	0	0	1
12028	85584	4	1	2	1	0	4
12028	105304	3	1	1	0	0	2
12028	184302	3	1	0	0	0	1
12028	184762	3	1	1	0	0	2
12028	190756	3	0	1	0	0	1
12028	198663	3	1	1	0	0	2
12028	202153	3	0	0	0	0	0
12028	206068	3	1	2	0	0	3
12028	214740	3	1	1	0	0	2
12028	215313	3	0	0	0	1	1
12028	217837	3	1	1	0	1	3
12028	221143	3	1	1	0	0	2
12028	286247	3	1	1	0	0	2
12028	286253	3	0	1	0	0	1
12028	286256	3	3	0	0	0	3
12028	286258	3	0	1	0	0	1
12028	286264	3	1	1	0	0	2
12028	286266	3	1	1	0	0	2
12028	286271	3	1	1	0	1	3
12028	388031	3	0	0	0	0	0
12028	388032	3	2	0	0	1	3
12028	388033	3	0	0	0	1	1
12028	388035	3	0	1	0	0	1
12028	388038	3	1	2	0	0	3
12028	388058	3	0	3	0	1	4
12028	388085	3	0	0	0	0	0
12028	388088	3	0	0	0	0	0
12028	388092	3	0	2	0	0	2
12028	388099	3	0	0	0	0	0
12028	388108	3	1	2	0	0	3
12028	388121	3	1	6	1	1	9
12028	388133	3	0	3	0	0	3
12028	388139	3	0	1	0	0	1
12028	388151	3	4	1	0	0	5
12028	388161	3	0	1	0	0	1
12028	388178	3	3	2	0	0	5
12028	388188	3	3	1	0	0	4
12028	388192	3	2	2	0	0	4
12028	388204	3	1	3	0	1	5
12028	388207	3	1	0	0	1	2
12028	53950	3	0	3	0	1	4
12028	54132	3	1	1	0	0	2
12028	573366	3	0	2	0	0	2
12028	573370	3	0	1	0	0	1
12028	573372	3	2	0	0	0	2
12028	84644	3	0	1	0	0	1
12028	86008	3	3	0	0	0	3
12028	92817	3	0	1	0	0	1
12028	97857	3	1	1	0	0	2
12028	105768	2	0	0	1	0	1
12028	188456	2	0	1	0	0	1
12028	199731	2	0	1	0	0	1
12028	202267	2	0	2	0	0	2
12028	206757	2	0	0	0	0	0
12028	207292	2	0	2	0	0	2
12028	208656	2	0	0	0	0	0
12028	221040	2	0	0	0	0	0
12028	286265	2	1	1	0	0	2
12028	286270	2	0	3	0	0	3
12028	388028	2	0	1	0	0	1
12028	388029	2	1	1	0	0	2
12028	388036	2	2	2	0	0	4
12028	388040	2	0	5	0	1	6
12028	388046	2	1	0	0	0	1
12028	388052	2	1	1	0	1	3
12028	388060	2	1	0	0	0	1
12028	388067	2	0	3	0	0	3
12028	388082	2	1	3	0	0	4
12028	388102	2	0	2	0	0	2
12028	388106	2	0	0	0	0	0
12028	388109	2	1	1	0	1	3
12028	388117	2	1	0	0	0	1
12028	388127	2	0	1	1	0	2
12028	388130	2	0	1	0	0	1
12028	388131	2	3	1	0	0	4
12028	388138	2	0	1	0	1	2
12028	388144	2	0	0	0	0	0
12028	388148	2	1	1	0	0	2
12028	388200	2	1	2	0	1	4
12028	573360	2	0	0	0	0	0
12028	573364	2	0	0	0	0	0
12028	573369	2	1	0	0	0	1
12028	573371	2	0	0	0	0	0
12028	90195	2	1	1	0	0	2
12028	97241	2	0	0	0	0	0
12028	185561	1	0	1	0	0	1
12028	185590	1	0	0	0	0	0
12028	191205	1	0	1	0	0	1
12028	202266	1	0	0	0	0	0
12028	206721	1	0	0	0	0	0
12028	207601	1	0	0	0	0	0
12028	286252	1	0	0	0	0	0
12028	388043	1	0	0	0	0	0
12028	388044	1	0	0	0	0	0
12028	388053	1	0	0	0	2	2
12028	388057	1	2	0	0	1	3
12028	388076	1	1	2	0	0	3
12028	388081	1	1	1	0	1	3
12028	388115	1	0	1	0	0	1
12028	388118	1	1	2	0	0	3
12028	388150	1	0	3	0	1	4
12028	388194	1	0	0	0	0	0
12028	573361	1	0	1	0	0	1
12028	573362	1	0	1	0	1	2
12028	573365	1	0	0	0	0	0
12028	573368	1	1	0	0	0	1
12028	573376	1	0	0	0	0	0
10345	558097	48	4	4	1	5	14
10345	558110	45	6	7	7	1	21
10345	558101	43	8	8	1	5	22
10345	558095	37	5	4	1	3	13
10345	558100	34	4	1	3	2	10
10345	558099	33	5	0	1	4	10
10345	210629	31	4	1	2	10	17
10345	558109	31	0	0	0	0	0
10345	558111	29	2	3	1	6	12
10345	199052	28	1	4	1	2	8
10345	285670	28	1	4	1	2	8
10345	558237	28	0	1	2	2	5
10345	74324	28	1	4	1	2	8
10345	285676	27	4	4	1	6	15
10345	558129	27	1	0	0	2	3
10345	184112	24	4	3	0	3	10
10345	558125	21	4	3	0	3	10
10345	558098	20	5	2	1	3	11
10345	558166	20	1	1	0	1	3
10345	285693	19	8	1	3	1	13
10345	558127	19	0	2	0	1	3
10345	558128	18	0	2	0	1	3
10345	105417	16	0	4	1	5	10
10345	185945	16	1	1	0	1	3
10345	285683	16	0	4	1	5	10
10345	558103	16	0	0	2	0	2
10345	558185	16	0	1	0	2	3
10345	285664	15	2	0	1	0	3
10345	209941	14	0	4	1	5	10
10345	212214	14	2	0	2	0	4
10345	558108	14	1	5	0	0	6
10345	558116	14	2	0	2	0	4
10345	558148	14	1	2	0	1	4
10345	192981	13	0	0	1	0	1
10345	201438	13	0	0	0	1	1
10345	558126	13	1	0	0	0	1
10345	197468	12	2	0	0	0	2
10345	558150	12	1	1	0	0	2
10345	558205	12	0	2	0	2	4
10345	558229	12	1	1	1	5	8
10345	183423	11	1	2	1	2	6
10345	194894	11	2	3	2	0	7
10345	285689	11	1	3	0	0	4
10345	55126	11	2	2	0	1	5
10345	558102	11	0	2	1	4	7
10345	558130	11	3	0	0	1	4
10345	558140	11	1	1	0	0	2
10345	72902	11	0	2	0	0	2
10345	216178	10	4	1	1	4	10
10345	285672	10	2	2	0	3	7
10345	558161	10	0	3	0	2	5
10345	558221	10	1	0	1	4	6
10345	558235	10	1	0	1	4	6
10345	103098	9	4	1	1	4	10
10345	191127	9	2	0	0	1	3
10345	220493	9	1	1	0	3	5
10345	285696	9	4	1	1	4	10
10345	285697	9	1	2	1	1	5
10345	558117	9	1	5	2	1	9
10345	558123	9	1	1	1	1	4
10345	558165	9	0	0	0	0	0
10345	558206	9	0	2	0	0	2
10345	558218	9	3	0	0	0	3
10345	558230	9	4	1	1	4	10
10345	186033	8	1	0	1	0	2
10345	203660	8	0	0	0	0	0
10345	206665	8	1	0	0	1	2
10345	285671	8	1	0	0	2	3
10345	285680	8	1	0	2	0	3
10345	285687	8	1	0	0	0	1
10345	558118	8	3	2	0	1	6
10345	558131	8	3	1	0	2	6
10345	558139	8	4	3	0	1	8
10345	558144	8	0	1	0	0	1
10345	558149	8	0	1	0	1	2
10345	558172	8	1	3	1	1	6
10345	558183	8	1	0	0	2	3
10345	558195	8	0	0	0	3	3
10345	558219	8	0	3	0	3	6
10345	65054	8	1	0	0	2	3
10345	69203	8	1	0	0	0	1
10345	70700	8	1	0	2	0	3
10345	108516	7	0	0	0	1	1
10345	186309	7	3	4	0	1	8
10345	188999	7	1	0	0	1	2
10345	194525	7	0	3	0	3	6
10345	202740	7	1	2	0	1	4
10345	205232	7	0	0	0	2	2
10345	285678	7	1	0	1	0	2
10345	285682	7	3	1	1	1	6
10345	285684	7	0	0	0	1	1
10345	558106	7	1	2	0	0	3
10345	558135	7	0	1	0	1	2
10345	558192	7	1	2	2	1	6
10345	558202	7	2	1	1	1	5
10345	558204	7	3	1	0	1	5
10345	558209	7	1	1	0	0	2
10345	558211	7	1	2	1	2	6
10345	558215	7	4	5	0	1	10
10345	558217	7	1	0	0	2	3
10345	558227	7	1	0	0	0	1
10345	100978	6	1	0	1	3	5
10345	188810	6	1	0	0	1	2
10345	197234	6	1	0	2	0	3
10345	203204	6	1	0	2	3	6
10345	203898	6	0	0	0	2	2
10345	207744	6	1	1	0	2	4
10345	210985	6	1	1	1	0	3
10345	212325	6	0	0	0	0	0
10345	213375	6	0	0	0	0	0
10345	217406	6	1	0	0	1	2
10345	285668	6	1	0	1	3	5
10345	285673	6	1	1	0	0	2
10345	558094	6	0	0	0	1	1
10345	558107	6	2	2	2	0	6
10345	558113	6	0	0	0	0	0
10345	558119	6	1	2	0	1	4
10345	558141	6	1	0	0	0	1
10345	558146	6	0	3	0	4	7
10345	558152	6	1	2	0	2	5
10345	558156	6	0	0	0	2	2
10345	558163	6	0	0	0	1	1
10345	558187	6	2	0	1	0	3
10345	558201	6	2	1	1	0	4
10345	558210	6	1	1	0	0	2
10345	558241	6	1	1	0	0	2
10345	57159	6	0	0	0	0	0
10345	99608	6	1	1	0	0	2
10345	108111	5	0	0	0	0	0
10345	183815	5	1	0	0	1	2
10345	193764	5	0	0	0	1	1
10345	200000	5	0	1	0	2	3
10345	200788	5	2	2	0	2	6
10345	201713	5	1	0	0	0	1
10345	203248	5	0	1	0	1	2
10345	205446	5	1	0	0	1	2
10345	214684	5	0	0	0	1	1
10345	217297	5	1	2	0	2	5
10345	221899	5	1	1	1	3	6
10345	285675	5	1	2	0	1	4
10345	285677	5	0	0	0	2	2
10345	285688	5	0	1	1	0	2
10345	285694	5	1	0	0	1	2
10345	558104	5	1	1	0	2	4
10345	558122	5	0	1	0	4	5
10345	558124	5	1	0	1	0	2
10345	558143	5	1	2	1	0	4
10345	558151	5	1	2	0	1	4
10345	558160	5	0	1	0	0	1
10345	558167	5	0	0	1	2	3
10345	558170	5	5	0	0	1	6
10345	558177	5	2	4	1	2	9
10345	558180	5	0	0	0	0	0
10345	558225	5	0	1	0	0	1
10345	70744	5	0	0	0	2	2
10345	70910	5	0	1	1	0	2
10345	183223	4	1	0	0	1	2
10345	185207	4	0	0	0	1	1
10345	197232	4	1	0	0	1	2
10345	202211	4	2	1	0	1	4
10345	206203	4	2	1	0	0	3
10345	207206	4	2	0	0	1	3
10345	207958	4	1	2	0	0	3
10345	208293	4	0	0	0	2	2
10345	210335	4	2	0	0	3	5
10345	210473	4	0	1	0	2	3
10345	214923	4	1	1	0	1	3
10345	215369	4	1	1	0	0	2
10345	215828	4	0	1	1	1	3
10345	216663	4	1	0	3	1	5
10345	217679	4	1	1	0	1	3
10345	217896	4	2	1	0	0	3
10345	218033	4	0	1	0	0	1
10345	285659	4	0	0	0	1	1
10345	285674	4	0	1	0	1	2
10345	285681	4	2	2	0	2	6
10345	285685	4	1	0	0	0	1
10345	285686	4	2	0	0	0	2
10345	50787	4	2	0	0	0	2
10345	558105	4	1	1	0	0	2
10345	558120	4	0	1	0	0	1
10345	558137	4	2	0	0	0	2
10345	558145	4	0	2	0	0	2
10345	558158	4	1	1	0	1	3
10345	558168	4	2	1	0	1	4
10345	558171	4	0	0	0	0	0
10345	558176	4	0	1	0	0	1
10345	558181	4	0	2	2	0	4
10345	558182	4	1	0	0	0	1
10345	558186	4	1	0	0	0	1
10345	558189	4	2	0	0	1	3
10345	558191	4	0	2	0	0	2
10345	558199	4	1	0	0	0	1
10345	558200	4	0	1	0	3	4
10345	558220	4	1	0	0	4	5
10345	558231	4	0	0	0	0	0
10345	558233	4	1	0	0	0	1
10345	558234	4	1	0	0	2	3
10345	558238	4	1	3	0	1	5
10345	76438	4	2	2	0	2	6
10345	79068	4	0	1	0	1	2
10345	80206	4	0	0	0	1	1
10345	191597	3	0	1	0	1	2
10345	194291	3	1	1	0	1	3
10345	194352	3	2	1	0	0	3
10345	194508	3	0	0	0	0	0
10345	195573	3	0	0	0	3	3
10345	195862	3	1	0	0	2	3
10345	196021	3	1	1	0	1	3
10345	196966	3	1	0	0	1	2
10345	201378	3	0	0	0	1	1
10345	202925	3	1	0	0	3	4
10345	203032	3	0	2	0	0	2
10345	203340	3	0	0	0	0	0
10345	204794	3	0	1	0	2	3
10345	205888	3	0	0	1	0	1
10345	206859	3	0	2	0	0	2
10345	206899	3	0	0	0	0	0
10345	206901	3	0	1	0	1	2
10345	206978	3	2	1	0	1	4
10345	214309	3	0	0	0	1	1
10345	216767	3	0	1	0	1	2
10345	218891	3	0	1	0	2	3
10345	285662	3	6	0	0	1	7
10345	285666	3	1	1	0	1	3
10345	285691	3	1	0	0	0	1
10345	285692	3	0	2	1	0	3
10345	285695	3	0	0	0	0	0
10345	558114	3	1	1	0	1	3
10345	558115	3	1	1	1	0	3
10345	558133	3	3	1	0	0	4
10345	558134	3	0	0	1	1	2
10345	558142	3	1	0	0	1	2
10345	558147	3	0	1	0	1	2
10345	558153	3	0	2	0	0	2
10345	558157	3	0	1	0	2	3
10345	558162	3	1	0	0	1	2
10345	558169	3	1	1	0	0	2
10345	558174	3	0	0	0	0	0
10345	558184	3	0	0	0	2	2
10345	558188	3	1	0	0	0	1
10345	558190	3	0	0	0	0	0
10345	558193	3	1	0	0	1	2
10345	558198	3	0	2	0	5	7
10345	558208	3	1	1	0	2	4
10345	558212	3	0	0	1	1	2
10345	558214	3	0	0	0	3	3
10345	558222	3	0	2	1	3	6
10345	558223	3	0	0	0	0	0
10345	558224	3	1	1	0	1	3
10345	558232	3	0	0	0	0	0
10345	558240	3	0	1	0	1	2
10345	72426	3	0	0	0	0	0
10345	80541	3	1	0	0	0	1
10345	183753	2	0	1	0	2	3
10345	184022	2	2	1	0	2	5
10345	184964	2	1	1	0	3	5
10345	188489	2	0	1	0	1	2
10345	191100	2	0	2	0	0	2
10345	191412	2	0	0	0	0	0
10345	192408	2	0	1	0	0	1
10345	195689	2	0	1	0	0	1
10345	199967	2	0	0	0	0	0
10345	200107	2	0	1	0	1	2
10345	204902	2	0	1	1	1	3
10345	206461	2	0	1	0	1	2
10345	207117	2	0	0	0	1	1
10345	207483	2	0	1	0	0	1
10345	207713	2	1	1	0	0	2
10345	208997	2	0	0	0	0	0
10345	210019	2	0	0	1	1	2
10345	210049	2	0	0	0	1	1
10345	210748	2	0	0	0	1	1
10345	211172	2	0	0	0	1	1
10345	213335	2	0	0	0	1	1
10345	213598	2	0	0	0	1	1
10345	217082	2	0	0	0	0	0
10345	285667	2	0	0	0	1	1
10345	285679	2	1	0	0	0	1
10345	558112	2	1	0	0	0	1
10345	558121	2	1	2	0	3	6
10345	558132	2	1	0	0	0	1
10345	558136	2	0	1	0	3	4
10345	558138	2	0	0	0	1	1
10345	558154	2	0	1	0	1	2
10345	558155	2	0	0	1	0	1
10345	558159	2	0	0	1	0	1
10345	558164	2	3	3	0	0	6
10345	558173	2	1	1	0	1	3
10345	558175	2	0	0	0	1	1
10345	558178	2	0	0	0	2	2
10345	558179	2	1	0	0	0	1
10345	558194	2	0	1	0	0	1
10345	558196	2	1	2	1	3	7
10345	558207	2	1	0	0	0	1
10345	558216	2	2	0	0	0	2
10345	558226	2	0	0	0	1	1
10345	558228	2	0	1	0	0	1
10345	558236	2	2	3	0	0	5
10345	558239	2	0	0	0	0	0
10345	558242	2	0	3	0	1	4
10345	95834	2	0	0	0	1	1
10345	185488	1	0	0	0	0	0
10345	185591	1	0	0	0	0	0
10345	185599	1	0	0	0	1	1
10345	185621	1	0	1	0	0	1
10345	187168	1	0	0	0	1	1
10345	190017	1	0	1	0	1	2
10345	190096	1	0	0	0	1	1
10345	192793	1	0	4	0	0	4
10345	197186	1	0	2	0	1	3
10345	197310	1	0	1	0	1	2
10345	198450	1	0	2	1	0	3
10345	198485	1	0	0	0	0	0
10345	199959	1	0	0	0	0	0
10345	200037	1	1	1	0	0	2
10345	200319	1	0	0	0	0	0
10345	200320	1	0	0	0	0	0
10345	201600	1	0	0	0	1	1
10345	203781	1	0	0	0	1	1
10345	206107	1	0	0	0	0	0
10345	206508	1	0	0	0	0	0
10345	208124	1	0	0	0	1	1
10345	208802	1	1	0	0	1	2
10345	211113	1	1	0	0	2	3
10345	217421	1	0	0	0	0	0
10345	220750	1	0	1	0	1	2
10345	285690	1	1	0	0	0	1
10345	558096	1	1	1	0	0	2
10345	558197	1	0	0	0	0	0
10345	558203	1	0	0	0	0	0
10345	558213	1	0	4	0	0	4
1755	81099	62	5	9	1	7	22
1755	82317	41	4	3	4	5	16
1755	283413	39	3	11	0	3	17
1755	522406	39	3	11	0	3	17
1755	57415	39	3	11	0	3	17
1755	51259	19	0	0	0	2	2
1755	202422	17	1	1	0	0	2
1755	283409	16	1	1	0	0	2
1755	522376	16	1	1	0	0	2
1755	82601	16	1	1	0	0	2
1755	522378	14	2	1	0	0	3
1755	522558	12	1	1	0	3	5
1755	188813	11	0	2	0	1	3
1755	522478	11	2	0	0	2	4
1755	283433	10	0	2	0	1	3
1755	283438	10	2	1	0	2	5
1755	51637	10	1	5	1	0	7
1755	522467	10	3	1	0	1	5
1755	522526	10	2	0	0	0	2
1755	59706	10	0	2	0	1	3
1755	217067	9	1	4	0	0	5
1755	283423	9	2	2	0	1	5
1755	522373	9	0	3	0	0	3
1755	522386	9	0	3	0	1	4
1755	522415	9	5	0	1	0	6
1755	522488	9	2	2	0	0	4
1755	97671	9	2	2	0	1	5
1755	100944	8	3	1	0	0	4
1755	185768	8	1	4	0	1	6
1755	194902	8	0	2	0	0	2
1755	283439	8	3	1	0	0	4
1755	522366	8	3	4	1	1	9
1755	522414	8	2	2	0	0	4
1755	283432	7	1	0	0	0	1
1755	283435	7	3	0	0	0	3
1755	51432	7	0	4	0	0	4
1755	522381	7	1	1	0	0	2
1755	522384	7	2	3	0	0	5
1755	522387	7	2	1	0	2	5
1755	522405	7	0	1	0	0	1
1755	522411	7	1	1	0	2	4
1755	522429	7	1	1	0	2	4
1755	522450	7	1	3	0	0	4
1755	522531	7	0	3	0	1	4
1755	522549	7	0	1	0	2	3
1755	197058	6	1	4	0	0	5
1755	198247	6	1	0	0	0	1
1755	199178	6	0	1	0	0	1
1755	199726	6	0	0	0	0	0
1755	206273	6	0	0	0	0	0
1755	208204	6	2	2	0	0	4
1755	209208	6	0	2	2	0	4
1755	214016	6	0	1	0	0	1
1755	52170	6	1	2	0	0	3
1755	522369	6	0	3	0	0	3
1755	522383	6	0	0	2	0	2
1755	522423	6	0	0	0	0	0
1755	522446	6	0	2	0	0	2
1755	522447	6	3	3	0	0	6
1755	522482	6	2	2	0	1	5
1755	522525	6	0	1	0	0	1
1755	522545	6	0	2	0	3	5
1755	522547	6	2	1	0	0	3
1755	58629	6	2	0	0	0	2
1755	101573	5	0	2	0	0	2
1755	101952	5	0	2	0	1	3
1755	186903	5	1	1	0	1	3
1755	193207	5	0	3	0	0	3
1755	214837	5	0	2	0	1	3
1755	215862	5	0	1	1	3	5
1755	218619	5	0	1	0	0	1
1755	283412	5	2	2	0	0	4
1755	283419	5	0	2	0	0	2
1755	283421	5	0	2	0	0	2
1755	50726	5	0	2	0	0	2
1755	522389	5	1	4	0	0	5
1755	522391	5	1	1	0	0	2
1755	522410	5	1	1	0	0	2
1755	522434	5	1	0	0	2	3
1755	522435	5	2	1	0	0	3
1755	522437	5	1	0	0	0	1
1755	522438	5	1	1	0	0	2
1755	522441	5	0	0	0	1	1
1755	522445	5	1	1	0	0	2
1755	522461	5	0	1	0	0	1
1755	522472	5	0	0	0	0	0
1755	522497	5	1	1	0	0	2
1755	522499	5	2	2	0	0	4
1755	522513	5	0	3	0	0	3
1755	522527	5	3	3	0	0	6
1755	522529	5	1	3	0	0	4
1755	522546	5	2	1	0	1	4
1755	522551	5	1	3	0	1	5
1755	522553	5	0	2	0	0	2
1755	522556	5	2	0	0	0	2
1755	522559	5	1	1	0	0	2
1755	96547	5	2	1	0	0	3
1755	184011	4	0	2	0	0	2
1755	186958	4	0	2	0	0	2
1755	198079	4	0	0	0	0	0
1755	201273	4	0	0	0	0	0
1755	201303	4	1	2	0	0	3
1755	202957	4	2	1	1	0	4
1755	204282	4	0	1	0	0	1
1755	207325	4	1	1	0	0	2
1755	212475	4	1	0	0	0	1
1755	215379	4	1	0	0	0	1
1755	216126	4	0	1	0	0	1
1755	217276	4	0	1	0	0	1
1755	221071	4	0	0	0	1	1
1755	283414	4	1	0	0	1	2
1755	283418	4	1	3	0	3	7
1755	283425	4	0	1	0	0	1
1755	283427	4	2	2	0	0	4
1755	283429	4	0	4	0	0	4
1755	283430	4	2	0	0	1	3
1755	522367	4	0	0	0	0	0
1755	522372	4	1	1	0	0	2
1755	522392	4	0	3	0	2	5
1755	522393	4	1	1	0	2	4
1755	522394	4	1	1	0	2	4
1755	522396	4	1	0	0	0	1
1755	522404	4	2	2	0	0	4
1755	522407	4	2	3	0	0	5
1755	522408	4	1	2	0	0	3
1755	522424	4	2	1	0	0	3
1755	522426	4	1	4	0	0	5
1755	522428	4	3	2	0	0	5
1755	522439	4	1	1	0	0	2
1755	522453	4	2	0	0	1	3
1755	522458	4	2	2	0	0	4
1755	522464	4	1	2	1	0	4
1755	522466	4	0	2	0	1	3
1755	522468	4	0	1	0	1	2
1755	522471	4	0	0	0	0	0
1755	522475	4	1	4	0	0	5
1755	522476	4	0	2	0	0	2
1755	522477	4	1	0	0	1	2
1755	522479	4	0	0	0	0	0
1755	522495	4	0	0	0	0	0
1755	522496	4	2	5	0	0	7
1755	522498	4	1	0	0	0	1
1755	522506	4	1	0	0	0	1
1755	522511	4	1	3	0	0	4
1755	522517	4	1	0	0	0	1
1755	522519	4	1	0	0	1	2
1755	522528	4	0	2	1	0	3
1755	522530	4	1	2	0	0	3
1755	522532	4	0	1	0	0	1
1755	522533	4	2	0	0	0	2
1755	522541	4	1	1	0	0	2
1755	522543	4	0	2	0	1	3
1755	522544	4	2	1	0	0	3
1755	522564	4	0	1	0	1	2
1755	522565	4	1	2	0	0	3
1755	66656	4	0	4	0	0	4
1755	70807	4	2	0	0	1	3
1755	90513	4	1	3	0	3	7
1755	96234	4	0	1	0	0	1
1755	103076	3	0	1	0	0	1
1755	189156	3	1	1	0	0	2
1755	192239	3	2	1	1	0	4
1755	193575	3	0	1	0	0	1
1755	203167	3	0	1	0	0	1
1755	210309	3	0	1	0	0	1
1755	211880	3	2	1	0	0	3
1755	216691	3	0	0	0	0	0
1755	216875	3	0	0	0	1	1
1755	218560	3	1	1	0	0	2
1755	283408	3	0	0	0	0	0
1755	283411	3	0	1	0	0	1
1755	283417	3	2	1	0	2	5
1755	283420	3	0	3	0	0	3
1755	283422	3	1	2	0	0	3
1755	283434	3	1	1	0	0	2
1755	283436	3	0	1	0	0	1
1755	283437	3	1	0	0	0	1
1755	522368	3	0	3	0	0	3
1755	522370	3	0	0	0	1	1
1755	522374	3	0	1	0	0	1
1755	522377	3	0	4	0	0	4
1755	522379	3	0	2	0	0	2
1755	522390	3	0	1	0	0	1
1755	522403	3	1	2	0	0	3
1755	522409	3	0	1	0	1	2
1755	522416	3	0	0	0	0	0
1755	522417	3	1	2	0	1	4
1755	522418	3	0	1	0	0	1
1755	522419	3	0	1	0	0	1
1755	522422	3	0	1	0	1	2
1755	522425	3	0	0	0	1	1
1755	522430	3	2	2	1	0	5
1755	522440	3	0	3	0	0	3
1755	522444	3	0	0	0	0	0
1755	522448	3	0	1	0	0	1
1755	522451	3	0	2	0	0	2
1755	522452	3	0	1	0	0	1
1755	522459	3	1	0	0	0	1
1755	522462	3	3	0	0	0	3
1755	522465	3	1	0	0	0	1
1755	522470	3	1	1	0	1	3
1755	522473	3	1	3	0	0	4
1755	522481	3	0	0	0	0	0
1755	522483	3	2	0	0	0	2
1755	522484	3	3	1	0	0	4
1755	522487	3	1	4	0	0	5
1755	522489	3	0	0	0	0	0
1755	522490	3	1	1	0	0	2
1755	522492	3	1	3	0	0	4
1755	522493	3	0	1	0	0	1
1755	522494	3	0	1	0	0	1
1755	522500	3	1	2	0	0	3
1755	522503	3	1	2	0	1	4
1755	522505	3	0	1	0	2	3
1755	522507	3	0	0	0	0	0
1755	522508	3	1	2	0	0	3
1755	522509	3	2	1	0	0	3
1755	522510	3	0	2	0	0	2
1755	522514	3	1	1	0	0	2
1755	522516	3	1	3	0	0	4
1755	522523	3	1	2	0	0	3
1755	522534	3	3	2	0	0	5
1755	522535	3	1	0	0	0	1
1755	522536	3	1	0	0	1	2
1755	522538	3	1	1	0	0	2
1755	522539	3	0	1	0	0	1
1755	522548	3	1	1	0	0	2
1755	522550	3	0	1	0	0	1
1755	522554	3	0	0	0	0	0
1755	522557	3	0	4	0	0	4
1755	522561	3	1	1	0	1	3
1755	522563	3	0	2	0	0	2
1755	59049	3	1	2	0	0	3
1755	79039	3	2	1	0	2	5
1755	82088	3	0	3	0	1	4
1755	84358	3	0	1	0	0	1
1755	91921	3	0	3	0	0	3
1755	93620	3	1	1	0	0	2
1755	186558	2	0	1	0	0	1
1755	193201	2	1	1	0	1	3
1755	200077	2	0	0	0	0	0
1755	206218	2	1	0	0	0	1
1755	207451	2	0	1	0	0	1
1755	208333	2	0	1	0	0	1
1755	211901	2	0	0	0	0	0
1755	216778	2	0	3	0	0	3
1755	218769	2	1	0	0	2	3
1755	221602	2	0	1	0	0	1
1755	283415	2	1	0	0	0	1
1755	283416	2	1	1	0	0	2
1755	283424	2	0	2	0	0	2
1755	283426	2	0	1	0	0	1
1755	283431	2	0	2	0	0	2
1755	522363	2	0	1	0	0	1
1755	522364	2	1	1	0	0	2
1755	522365	2	0	0	0	1	1
1755	522371	2	0	1	0	0	1
1755	522380	2	0	0	0	1	1
1755	522382	2	0	0	0	0	0
1755	522388	2	2	2	0	0	4
1755	522395	2	1	0	0	1	2
1755	522397	2	1	2	0	0	3
1755	522398	2	0	2	0	0	2
1755	522399	2	0	2	1	0	3
1755	522402	2	0	1	0	0	1
1755	522420	2	1	1	0	2	4
1755	522421	2	1	2	0	0	3
1755	522427	2	2	3	0	0	5
1755	522431	2	1	1	0	0	2
1755	522436	2	1	0	0	1	2
1755	522442	2	1	0	0	0	1
1755	522443	2	0	1	0	0	1
1755	522449	2	1	0	0	0	1
1755	522454	2	1	1	0	0	2
1755	522455	2	1	0	0	0	1
1755	522457	2	1	0	0	0	1
1755	522469	2	1	1	0	0	2
1755	522474	2	2	0	0	0	2
1755	522485	2	1	1	0	0	2
1755	522491	2	0	0	0	0	0
1755	522501	2	1	0	0	0	1
1755	522502	2	0	0	0	0	0
1755	522512	2	1	1	0	0	2
1755	522515	2	0	1	0	0	1
1755	522518	2	0	0	0	0	0
1755	522520	2	1	1	0	1	3
1755	522521	2	0	0	0	0	0
1755	522522	2	0	2	0	0	2
1755	522524	2	0	1	0	0	1
1755	522537	2	0	0	0	0	0
1755	522542	2	0	1	0	0	1
1755	522552	2	0	1	0	0	1
1755	522555	2	0	1	0	0	1
1755	522560	2	1	1	0	0	2
1755	522562	2	1	2	0	0	3
1755	72416	2	0	2	0	0	2
1755	74950	2	0	2	0	0	2
1755	85616	2	0	0	0	0	0
1755	86908	2	1	1	0	0	2
1755	185656	1	0	1	0	1	2
1755	201443	1	0	0	0	0	0
1755	205989	1	0	0	0	0	0
1755	207823	1	0	1	0	0	1
1755	207940	1	0	1	0	0	1
1755	210761	1	0	1	0	0	1
1755	214401	1	0	1	0	0	1
1755	221553	1	0	1	0	0	1
1755	283410	1	0	1	0	0	1
1755	283428	1	0	1	0	0	1
1755	522375	1	0	4	0	0	4
1755	522385	1	2	1	0	0	3
1755	522400	1	1	0	0	1	2
1755	522401	1	1	2	0	0	3
1755	522412	1	0	2	0	0	2
1755	522413	1	0	1	0	0	1
1755	522432	1	2	1	0	0	3
1755	522433	1	0	0	0	0	0
1755	522456	1	1	1	0	0	2
1755	522460	1	0	1	0	1	2
1755	522463	1	0	1	0	1	2
1755	522480	1	0	0	0	0	0
1755	522486	1	0	2	0	0	2
1755	522540	1	0	1	0	1	2
1755	98489	1	0	1	0	0	1
80248	458635	33	7	1	1	0	9
80248	458451	27	8	3	2	6	19
80248	458647	19	0	1	2	0	3
80248	458421	17	3	0	0	1	4
80248	458589	17	3	0	1	1	5
80248	277986	15	0	0	4	0	4
80248	458454	15	0	0	1	0	1
80248	277982	14	2	1	0	2	5
80248	277983	14	2	1	0	2	5
80248	458505	14	3	2	0	2	7
80248	458537	14	2	0	0	0	2
80248	458408	13	2	2	1	2	7
80248	458433	13	1	0	0	1	2
80248	458477	13	1	3	1	1	6
80248	458530	13	2	1	0	2	5
80248	458429	12	0	2	0	2	4
80248	458431	12	0	0	0	2	2
80248	458437	12	1	1	0	1	3
80248	458501	12	5	4	1	3	13
80248	458690	12	1	0	0	1	2
80248	277980	10	3	0	0	0	3
80248	458436	10	0	2	1	5	8
80248	458574	10	2	1	3	1	7
80248	458439	9	1	0	0	0	1
80248	458535	9	3	1	0	1	5
80248	458547	9	0	0	0	1	1
80248	458570	9	1	0	0	0	1
80248	458620	9	2	0	0	0	2
80248	458653	9	4	2	0	0	6
80248	458709	9	3	1	0	2	6
80248	458435	8	0	0	1	1	2
80248	458464	8	2	1	0	0	3
80248	458465	8	2	0	0	1	3
80248	458483	8	1	0	1	4	6
80248	458502	8	2	2	0	0	4
80248	458553	8	2	1	1	4	8
80248	458565	8	2	0	2	1	5
80248	458651	8	0	0	1	1	2
80248	458661	8	1	0	0	0	1
80248	458684	8	5	1	0	0	6
80248	458699	8	0	0	1	0	1
80248	458701	8	0	2	0	3	5
80248	458707	8	0	0	0	1	1
80248	277977	7	0	1	0	1	2
80248	277979	7	0	0	1	0	1
80248	458416	7	4	1	0	0	5
80248	458418	7	2	0	0	0	2
80248	458426	7	1	0	0	0	1
80248	458438	7	1	0	1	0	2
80248	458440	7	1	1	1	0	3
80248	458445	7	0	0	0	1	1
80248	458446	7	2	0	0	1	3
80248	458453	7	1	3	1	0	5
80248	458459	7	1	0	1	0	2
80248	458481	7	2	0	1	0	3
80248	458489	7	1	0	0	0	1
80248	458529	7	2	0	0	1	3
80248	458548	7	3	1	0	0	4
80248	458597	7	3	1	1	1	6
80248	458605	7	1	2	1	0	4
80248	458628	7	3	0	0	0	3
80248	458642	7	0	0	0	0	0
80248	458648	7	1	0	0	0	1
80248	458668	7	2	1	2	1	6
80248	458671	7	3	0	0	0	3
80248	458673	7	2	0	0	1	3
80248	458693	7	2	1	1	1	5
80248	458696	7	3	1	1	1	6
80248	458422	6	1	1	2	3	7
80248	458432	6	3	2	0	0	5
80248	458462	6	2	0	0	0	2
80248	458468	6	0	2	0	2	4
80248	458471	6	4	1	1	0	6
80248	458476	6	1	1	0	1	3
80248	458482	6	2	0	0	0	2
80248	458486	6	1	1	0	0	2
80248	458487	6	1	0	0	1	2
80248	458493	6	0	4	0	0	4
80248	458494	6	0	4	0	0	4
80248	458500	6	1	0	0	0	1
80248	458507	6	2	0	0	0	2
80248	458531	6	5	0	0	0	5
80248	458532	6	0	0	0	1	1
80248	458569	6	2	0	0	1	3
80248	458585	6	2	2	0	0	4
80248	458593	6	1	0	0	1	2
80248	458601	6	1	0	0	1	2
80248	458615	6	2	0	0	0	2
80248	458638	6	0	0	0	0	0
80248	458640	6	1	1	0	0	2
80248	458644	6	0	1	1	2	4
80248	458660	6	2	1	1	1	5
80248	458662	6	2	1	0	1	4
80248	458664	6	1	0	0	0	1
80248	458687	6	2	0	0	1	3
80248	458697	6	2	1	3	1	7
80248	277973	5	1	2	1	0	4
80248	277974	5	0	0	0	1	1
80248	458443	5	0	1	0	0	1
80248	458444	5	0	1	0	0	1
80248	458450	5	1	2	1	0	4
80248	458452	5	1	1	0	0	2
80248	458458	5	2	1	2	0	5
80248	458469	5	1	1	0	0	2
80248	458474	5	1	1	1	1	4
80248	458488	5	0	0	0	2	2
80248	458495	5	0	1	0	2	3
80248	458499	5	4	2	1	0	7
80248	458510	5	3	0	0	1	4
80248	458523	5	3	2	0	0	5
80248	458538	5	2	1	0	0	3
80248	458545	5	1	2	0	0	3
80248	458546	5	2	0	0	1	3
80248	458551	5	1	0	0	0	1
80248	458552	5	0	0	0	0	0
80248	458554	5	1	0	1	1	3
80248	458560	5	1	0	0	1	2
80248	458572	5	1	0	0	0	1
80248	458587	5	0	1	3	0	4
80248	458592	5	0	0	0	0	0
80248	458613	5	3	0	0	0	3
80248	458616	5	1	0	0	2	3
80248	458618	5	2	1	0	1	4
80248	458621	5	1	0	0	1	2
80248	458622	5	3	2	0	2	7
80248	458630	5	2	0	0	0	2
80248	458637	5	0	0	2	5	7
80248	458646	5	3	1	0	3	7
80248	458655	5	2	0	0	3	5
80248	458659	5	2	1	0	0	3
80248	458669	5	1	0	0	0	1
80248	458682	5	1	1	0	1	3
80248	458695	5	1	1	1	2	5
80248	458698	5	0	0	0	0	0
80248	458703	5	2	2	0	1	5
80248	458706	5	4	0	0	1	5
80248	277970	4	0	0	0	0	0
80248	277971	4	1	0	0	0	1
80248	277978	4	1	0	0	0	1
80248	277981	4	1	0	1	2	4
80248	458407	4	1	0	1	0	2
80248	458414	4	1	1	0	1	3
80248	458420	4	1	2	0	0	3
80248	458423	4	3	0	0	0	3
80248	458424	4	1	0	0	0	1
80248	458441	4	0	0	0	0	0
80248	458456	4	0	0	0	0	0
80248	458460	4	0	0	1	1	2
80248	458466	4	0	0	0	2	2
80248	458473	4	1	0	0	2	3
80248	458479	4	0	1	2	1	4
80248	458480	4	0	0	0	1	1
80248	458484	4	1	0	1	0	2
80248	458492	4	1	0	0	0	1
80248	458497	4	2	0	0	1	3
80248	458498	4	2	0	0	1	3
80248	458521	4	0	0	1	3	4
80248	458528	4	1	0	0	0	1
80248	458533	4	2	0	0	0	2
80248	458536	4	2	3	0	7	12
80248	458541	4	0	0	0	1	1
80248	458542	4	2	0	0	0	2
80248	458543	4	0	0	1	1	2
80248	458549	4	0	0	1	1	2
80248	458556	4	1	1	0	1	3
80248	458559	4	1	0	0	0	1
80248	458561	4	1	0	0	0	1
80248	458562	4	0	2	0	2	4
80248	458563	4	2	0	0	0	2
80248	458567	4	0	0	0	1	1
80248	458573	4	0	1	0	0	1
80248	458578	4	2	0	0	2	4
80248	458583	4	1	0	1	2	4
80248	458584	4	1	0	0	0	1
80248	458588	4	1	0	2	1	4
80248	458591	4	0	0	1	0	1
80248	458595	4	0	0	0	0	0
80248	458600	4	0	0	0	0	0
80248	458606	4	0	0	0	0	0
80248	458610	4	0	1	0	0	1
80248	458611	4	1	0	0	0	1
80248	458617	4	0	0	0	0	0
80248	458619	4	2	1	1	2	6
80248	458624	4	1	1	0	1	3
80248	458632	4	1	0	0	1	2
80248	458634	4	2	1	0	0	3
80248	458643	4	1	0	0	2	3
80248	458650	4	2	0	0	1	3
80248	458652	4	1	2	0	0	3
80248	458657	4	1	0	0	0	1
80248	458666	4	2	0	1	0	3
80248	458667	4	1	0	1	1	3
80248	458670	4	2	0	0	1	3
80248	458679	4	2	0	0	0	2
80248	458681	4	1	1	0	1	3
80248	458685	4	1	0	2	0	3
80248	458686	4	1	2	0	0	3
80248	458691	4	3	0	0	0	3
80248	458700	4	1	0	0	0	1
80248	458702	4	3	1	0	0	4
80248	458704	4	1	2	0	1	4
80248	277972	3	0	0	0	0	0
80248	277984	3	0	0	0	0	0
80248	277985	3	1	0	0	3	4
80248	458412	3	1	0	0	0	1
80248	458413	3	3	2	0	1	6
80248	458417	3	0	0	0	2	2
80248	458419	3	0	1	1	0	2
80248	458427	3	1	1	0	1	3
80248	458428	3	2	1	0	0	3
80248	458430	3	2	2	0	1	5
80248	458434	3	0	0	1	0	1
80248	458442	3	1	0	0	1	2
80248	458447	3	1	0	0	0	1
80248	458448	3	0	0	0	0	0
80248	458457	3	2	2	1	0	5
80248	458470	3	1	0	0	0	1
80248	458472	3	0	0	0	1	1
80248	458475	3	3	0	1	0	4
80248	458478	3	0	0	1	0	1
80248	458490	3	0	0	0	0	0
80248	458491	3	2	0	0	0	2
80248	458504	3	2	1	0	0	3
80248	458508	3	1	0	0	1	2
80248	458509	3	0	1	0	1	2
80248	458519	3	0	1	0	1	2
80248	458522	3	1	0	0	0	1
80248	458524	3	0	0	0	0	0
80248	458525	3	1	1	0	0	2
80248	458539	3	1	0	0	0	1
80248	458544	3	2	1	1	1	5
80248	458564	3	1	0	0	0	1
80248	458566	3	2	0	0	0	2
80248	458571	3	0	0	0	2	2
80248	458576	3	3	1	0	1	5
80248	458577	3	2	1	0	0	3
80248	458582	3	1	0	0	0	1
80248	458586	3	2	0	0	0	2
80248	458598	3	0	0	0	0	0
80248	458603	3	2	0	0	0	2
80248	458604	3	0	1	1	0	2
80248	458614	3	0	0	0	0	0
80248	458623	3	0	1	0	0	1
80248	458625	3	0	0	0	3	3
80248	458626	3	2	0	1	0	3
80248	458627	3	0	0	0	0	0
80248	458629	3	0	1	0	1	2
80248	458633	3	0	0	0	0	0
80248	458641	3	0	0	0	0	0
80248	458649	3	0	0	0	0	0
80248	458656	3	2	0	0	0	2
80248	458658	3	0	0	2	1	3
80248	458665	3	0	0	0	0	0
80248	458672	3	0	0	0	0	0
80248	458674	3	1	0	0	1	2
80248	458677	3	0	0	0	0	0
80248	458678	3	1	1	0	0	2
80248	458680	3	2	2	0	0	4
80248	458688	3	2	1	1	1	5
80248	458689	3	1	1	0	0	2
80248	458694	3	1	1	0	1	3
80248	458705	3	2	0	0	2	4
80248	458708	3	3	0	0	1	4
80248	277969	2	0	0	0	0	0
80248	277976	2	0	0	0	0	0
80248	458409	2	1	0	0	2	3
80248	458410	2	2	0	1	0	3
80248	458411	2	0	1	0	1	2
80248	458449	2	0	0	0	0	0
80248	458463	2	0	0	1	1	2
80248	458467	2	1	1	0	0	2
80248	458485	2	2	0	0	0	2
80248	458496	2	0	0	0	0	0
80248	458503	2	1	0	0	0	1
80248	458511	2	0	0	0	0	0
80248	458513	2	1	0	0	2	3
80248	458514	2	0	0	0	0	0
80248	458515	2	0	0	0	3	3
80248	458516	2	0	0	0	0	0
80248	458518	2	0	1	0	1	2
80248	458520	2	0	0	0	1	1
80248	458526	2	3	0	0	2	5
80248	458534	2	1	0	0	0	1
80248	458540	2	2	0	0	0	2
80248	458555	2	0	0	0	0	0
80248	458558	2	0	0	0	0	0
80248	458568	2	0	0	0	0	0
80248	458579	2	1	0	0	0	1
80248	458580	2	1	0	0	0	1
80248	458581	2	0	0	1	0	1
80248	458590	2	1	0	0	0	1
80248	458594	2	0	0	0	0	0
80248	458596	2	0	0	0	0	0
80248	458599	2	2	0	0	0	2
80248	458602	2	0	1	0	0	1
80248	458607	2	1	0	0	0	1
80248	458608	2	1	0	0	1	2
80248	458609	2	1	0	0	0	1
80248	458612	2	3	0	1	1	5
80248	458631	2	1	3	1	0	5
80248	458636	2	0	0	1	0	1
80248	458645	2	2	0	0	0	2
80248	458654	2	0	0	0	0	0
80248	458676	2	0	0	0	0	0
80248	458683	2	1	0	0	0	1
80248	458692	2	1	2	0	1	4
80248	277975	1	0	0	0	0	0
80248	458415	1	0	2	0	0	2
80248	458425	1	0	1	0	0	1
80248	458455	1	1	1	0	1	3
80248	458461	1	1	1	0	2	4
80248	458506	1	0	0	0	3	3
80248	458512	1	0	1	0	0	1
80248	458517	1	0	0	0	0	0
80248	458527	1	0	0	0	0	0
80248	458550	1	0	1	1	0	2
80248	458557	1	0	0	0	0	0
80248	458575	1	1	0	0	0	1
80248	458639	1	1	0	0	0	1
80248	458663	1	0	0	0	0	0
80248	458675	1	0	0	0	0	0
65247	51255	32	5	7	5	1	18
65247	96114	28	4	5	2	1	12
65247	217650	26	0	1	4	1	6
65247	493741	26	0	1	4	1	6
65247	493704	24	3	6	5	1	15
65247	222215	23	7	7	2	1	17
65247	493587	22	1	3	3	2	9
65247	493722	19	5	5	2	1	13
65247	63381	19	5	1	0	0	6
65247	75417	19	2	4	1	1	8
65247	107593	18	3	3	1	1	8
65247	102671	16	4	1	0	0	5
65247	493698	16	1	2	3	4	10
65247	493700	16	4	3	1	0	8
65247	66949	16	3	2	5	6	16
65247	83234	16	4	3	1	0	8
65247	493727	15	2	1	0	1	4
65247	493745	15	1	7	1	2	11
65247	493566	14	1	2	0	2	5
65247	493734	14	6	0	0	0	6
65247	95692	14	2	0	1	2	5
65247	103374	13	1	1	0	1	3
65247	190164	13	1	3	1	3	8
65247	59636	13	0	1	0	0	1
65247	493709	12	3	2	3	1	9
65247	188388	11	2	2	1	3	8
65247	102414	10	2	3	1	0	6
65247	300544	10	2	3	1	0	6
65247	493513	10	2	3	0	2	7
65247	101332	9	3	2	0	5	10
65247	493699	9	2	1	2	2	7
65247	493707	9	2	2	0	2	6
65247	493717	9	6	2	0	1	9
65247	78548	9	1	1	0	2	4
65247	189226	8	1	1	1	3	6
65247	205564	8	0	1	0	0	1
65247	212807	8	3	0	0	1	4
65247	493702	8	1	0	0	1	2
65247	493746	8	0	1	0	2	3
65247	78549	8	1	0	0	1	2
65247	92532	8	2	0	1	0	3
65247	207529	7	2	4	0	1	7
65247	300545	7	2	4	0	1	7
65247	493581	7	1	1	3	0	5
65247	493597	7	1	4	0	1	6
65247	493619	7	2	0	1	0	3
65247	493620	7	4	3	0	1	8
65247	493655	7	1	0	0	2	3
65247	493718	7	1	1	0	1	3
65247	493723	7	3	1	0	1	5
65247	493737	7	2	1	0	4	7
65247	50271	7	1	0	0	2	3
65247	88411	7	2	4	0	1	7
65247	92594	7	1	1	0	0	2
65247	191875	6	1	1	0	0	2
65247	204141	6	0	2	3	2	7
65247	300548	6	0	0	0	0	0
65247	300551	6	0	2	3	2	7
65247	300554	6	1	1	0	0	2
65247	493522	6	3	1	0	4	8
65247	493545	6	0	1	0	1	2
65247	493593	6	2	1	0	0	3
65247	493605	6	1	2	0	1	4
65247	493614	6	2	1	0	1	4
65247	493627	6	0	1	0	0	1
65247	493648	6	1	1	3	1	6
65247	493686	6	1	4	0	4	9
65247	493708	6	2	0	2	1	5
65247	493720	6	1	2	0	1	4
65247	493725	6	1	0	0	2	3
65247	493728	6	3	0	1	2	6
65247	493729	6	0	0	0	0	0
65247	493735	6	1	1	0	0	2
65247	493739	6	0	5	0	0	5
65247	493744	6	0	7	0	4	11
65247	64651	6	1	1	0	0	2
65247	77976	6	0	0	0	0	0
65247	84509	6	0	2	3	2	7
65247	86308	6	2	1	0	2	5
65247	101902	5	2	1	0	1	4
65247	186654	5	0	0	0	3	3
65247	204077	5	1	0	0	1	2
65247	300546	5	1	0	1	1	3
65247	300556	5	3	2	1	2	8
65247	300557	5	2	1	0	1	4
65247	493539	5	1	2	0	0	3
65247	493556	5	0	0	0	1	1
65247	493558	5	0	1	0	1	2
65247	493565	5	5	3	0	2	10
65247	493567	5	1	2	0	0	3
65247	493570	5	1	1	0	0	2
65247	493571	5	4	0	0	1	5
65247	493584	5	2	0	1	1	4
65247	493585	5	1	2	1	2	6
65247	493604	5	4	1	0	1	6
65247	493626	5	0	2	2	0	4
65247	493646	5	0	1	0	2	3
65247	493654	5	0	2	1	0	3
65247	493714	5	0	2	2	3	7
65247	493724	5	0	2	0	0	2
65247	493730	5	2	1	0	1	4
65247	493743	5	1	2	0	1	4
65247	49531	5	1	0	1	1	3
65247	55211	5	2	0	0	1	3
65247	56721	5	1	1	1	1	4
65247	66764	5	0	3	0	0	3
65247	68794	5	2	0	1	2	5
65247	84334	5	3	0	0	1	4
65247	91173	5	3	2	1	2	8
65247	94614	5	1	0	0	1	2
65247	102913	4	1	1	1	2	5
65247	183123	4	1	0	0	1	2
65247	183708	4	1	0	1	0	2
65247	208397	4	1	0	0	0	1
65247	211135	4	0	1	0	1	2
65247	493526	4	2	2	2	0	6
65247	493528	4	1	1	0	0	2
65247	493533	4	0	1	0	1	2
65247	493542	4	1	0	0	1	2
65247	493544	4	0	0	0	2	2
65247	493550	4	0	0	0	0	0
65247	493557	4	0	1	0	2	3
65247	493563	4	1	2	0	2	5
65247	493577	4	3	1	0	0	4
65247	493580	4	1	1	0	1	3
65247	493588	4	1	3	0	1	5
65247	493589	4	1	0	0	2	3
65247	493590	4	3	1	0	0	4
65247	493591	4	1	3	0	1	5
65247	493594	4	2	3	0	1	6
65247	493603	4	1	0	0	2	3
65247	493607	4	0	3	0	1	4
65247	493608	4	1	1	0	0	2
65247	493613	4	1	1	0	1	3
65247	493618	4	1	0	1	2	4
65247	493624	4	1	2	1	0	4
65247	493625	4	0	0	0	1	1
65247	493629	4	0	0	1	0	1
65247	493637	4	4	1	0	2	7
65247	493643	4	2	2	0	0	4
65247	493651	4	1	2	0	1	4
65247	493669	4	3	0	0	1	4
65247	493673	4	1	3	0	0	4
65247	493674	4	2	0	0	1	3
65247	493675	4	0	3	0	1	4
65247	493676	4	1	2	0	1	4
65247	493678	4	1	1	0	1	3
65247	493681	4	3	1	0	1	5
65247	493685	4	0	0	0	6	6
65247	493689	4	0	1	0	0	1
65247	493690	4	2	0	0	2	4
65247	493693	4	0	0	0	1	1
65247	493694	4	0	3	0	3	6
65247	493695	4	1	2	0	0	3
65247	493701	4	0	1	0	4	5
65247	493711	4	1	1	0	2	4
65247	493715	4	1	0	0	0	1
65247	493716	4	0	1	0	2	3
65247	493721	4	2	2	0	2	6
65247	493726	4	3	1	0	0	4
65247	493733	4	1	0	0	0	1
65247	493740	4	1	1	0	0	2
65247	493742	4	1	0	0	0	1
65247	89279	4	0	0	2	1	3
65247	89596	4	1	0	0	1	2
65247	104493	3	1	2	0	1	4
65247	182013	3	0	1	0	2	3
65247	187927	3	0	1	0	1	2
65247	193363	3	1	1	0	2	4
65247	208465	3	1	0	0	2	3
65247	300547	3	1	0	0	5	6
65247	300550	3	0	0	0	0	0
65247	300552	3	1	2	0	1	4
65247	300555	3	1	1	0	0	2
65247	493516	3	1	1	0	0	2
65247	493518	3	0	0	0	0	0
65247	493521	3	0	0	0	0	0
65247	493525	3	1	2	0	1	4
65247	493529	3	1	0	0	0	1
65247	493534	3	0	1	0	1	2
65247	493548	3	0	1	0	2	3
65247	493551	3	0	1	0	0	1
65247	493554	3	0	0	0	1	1
65247	493572	3	1	0	0	0	1
65247	493579	3	0	0	0	1	1
65247	493583	3	1	0	0	0	1
65247	493592	3	0	3	0	0	3
65247	493595	3	2	0	0	1	3
65247	493598	3	3	1	0	0	4
65247	493599	3	0	2	0	2	4
65247	493600	3	1	0	0	0	1
65247	493609	3	1	1	0	0	2
65247	493610	3	3	1	1	2	7
65247	493612	3	0	2	0	1	3
65247	493631	3	1	0	0	1	2
65247	493633	3	1	1	0	2	4
65247	493635	3	0	2	0	2	4
65247	493638	3	2	0	0	2	4
65247	493640	3	0	0	0	0	0
65247	493649	3	1	1	0	1	3
65247	493656	3	1	1	0	0	2
65247	493657	3	1	0	0	0	1
65247	493659	3	1	0	0	1	2
65247	493660	3	1	1	0	2	4
65247	493661	3	1	0	0	1	2
65247	493667	3	4	1	0	1	6
65247	493670	3	1	2	0	1	4
65247	493671	3	0	0	0	1	1
65247	493672	3	1	0	0	1	2
65247	493677	3	0	1	0	1	2
65247	493679	3	1	2	0	1	4
65247	493680	3	0	1	0	3	4
65247	493684	3	1	3	0	1	5
65247	493687	3	0	0	0	1	1
65247	493688	3	1	0	0	1	2
65247	493692	3	0	1	0	1	2
65247	493697	3	0	1	0	1	2
65247	493705	3	0	0	0	1	1
65247	493706	3	1	0	0	1	2
65247	493712	3	1	0	0	0	1
65247	493713	3	1	1	0	0	2
65247	493731	3	0	3	2	4	9
65247	493732	3	0	2	0	1	3
65247	71293	3	0	0	0	0	0
65247	77785	3	0	0	0	0	0
65247	94805	3	1	0	0	5	6
65247	183265	2	0	0	0	0	0
65247	192504	2	0	1	0	0	1
65247	300549	2	0	3	0	0	3
65247	300553	2	1	2	1	1	5
65247	493505	2	0	0	0	1	1
65247	493506	2	0	0	0	1	1
65247	493507	2	0	1	0	0	1
65247	493508	2	1	0	0	1	2
65247	493509	2	0	0	0	0	0
65247	493510	2	0	0	0	0	0
65247	493511	2	1	0	0	1	2
65247	493519	2	0	1	0	0	1
65247	493520	2	1	0	0	1	2
65247	493524	2	1	2	0	1	4
65247	493527	2	1	0	0	1	2
65247	493530	2	2	0	0	3	5
65247	493531	2	0	3	0	0	3
65247	493532	2	1	0	0	1	2
65247	493535	2	1	0	0	2	3
65247	493536	2	1	0	0	1	2
65247	493537	2	1	1	0	0	2
65247	493538	2	1	0	0	0	1
65247	493540	2	0	0	0	0	0
65247	493541	2	0	0	0	1	1
65247	493543	2	0	1	0	0	1
65247	493546	2	0	1	0	1	2
65247	493553	2	1	1	0	2	4
65247	493559	2	2	0	0	0	2
65247	493560	2	0	0	0	0	0
65247	493562	2	0	0	0	0	0
65247	493568	2	1	0	0	0	1
65247	493569	2	0	2	0	0	2
65247	493573	2	0	0	0	1	1
65247	493574	2	1	0	0	0	1
65247	493575	2	0	0	0	1	1
65247	493576	2	2	0	0	0	2
65247	493596	2	0	1	0	2	3
65247	493601	2	0	0	0	1	1
65247	493602	2	1	0	0	2	3
65247	493606	2	1	1	0	1	3
65247	493611	2	0	1	0	0	1
65247	493615	2	1	0	0	1	2
65247	493616	2	0	0	0	0	0
65247	493621	2	0	0	0	1	1
65247	493630	2	0	1	0	0	1
65247	493632	2	0	1	0	1	2
65247	493634	2	1	1	0	0	2
65247	493636	2	0	0	0	1	1
65247	493639	2	0	1	0	2	3
65247	493641	2	0	2	0	1	3
65247	493642	2	2	1	0	1	4
65247	493650	2	2	1	0	2	5
65247	493652	2	1	0	0	1	2
65247	493658	2	1	0	0	1	2
65247	493662	2	0	0	2	1	3
65247	493664	2	1	0	0	0	1
65247	493665	2	0	1	0	1	2
65247	493668	2	0	2	0	0	2
65247	493691	2	0	1	0	0	1
65247	493696	2	2	0	0	1	3
65247	493703	2	0	3	0	0	3
65247	493710	2	0	2	0	0	2
65247	493719	2	2	2	0	0	4
65247	59698	2	0	0	0	1	1
65247	94128	2	1	2	1	1	5
65247	210529	1	0	0	0	0	0
65247	493504	1	0	1	0	0	1
65247	493512	1	1	0	0	0	1
65247	493514	1	2	0	0	0	2
65247	493515	1	1	1	0	0	2
65247	493517	1	2	1	0	1	4
65247	493523	1	0	0	0	0	0
65247	493547	1	0	0	0	0	0
65247	493549	1	0	0	0	1	1
65247	493552	1	0	0	0	1	1
65247	493555	1	0	0	0	1	1
65247	493561	1	0	0	0	0	0
65247	493564	1	0	0	0	1	1
65247	493578	1	0	1	0	0	1
65247	493582	1	0	1	0	1	2
65247	493586	1	1	1	0	1	3
65247	493617	1	1	0	0	0	1
65247	493622	1	0	0	0	0	0
65247	493623	1	0	0	0	0	0
65247	493628	1	0	1	0	0	1
65247	493647	1	2	0	0	1	3
65247	493653	1	0	1	1	0	2
65247	493663	1	0	1	0	1	2
65247	493666	1	0	1	0	0	1
65247	493682	1	0	1	0	1	2
65247	493683	1	0	4	0	0	4
65247	493736	1	1	1	0	0	2
65247	493738	1	0	1	0	0	1
36224	95522	17	3	2	0	0	5
36224	102091	13	3	1	0	2	6
36224	214778	13	3	1	0	2	6
36224	292814	13	3	1	0	2	6
36224	617158	12	3	0	1	2	6
36224	617180	12	0	1	1	0	2
36224	617211	9	5	2	0	0	7
36224	210983	8	1	0	0	0	1
36224	617182	8	3	0	0	0	3
36224	617273	8	4	0	0	0	4
36224	617280	8	1	1	0	2	4
36224	617324	8	4	1	0	0	5
36224	530661	7	0	0	0	0	0
36224	617174	7	3	1	0	2	6
36224	617198	7	3	4	0	0	7
36224	617206	7	1	2	0	2	5
36224	617253	7	0	2	0	1	3
36224	617349	7	3	0	0	0	3
36224	617393	7	2	1	0	1	4
36224	196782	6	2	0	0	1	3
36224	617150	6	1	0	0	0	1
36224	617162	6	4	1	1	1	7
36224	617175	6	3	0	0	1	4
36224	617181	6	10	0	1	0	11
36224	617199	6	2	1	0	0	3
36224	617214	6	5	0	0	0	5
36224	617219	6	3	0	0	0	3
36224	617220	6	1	1	0	1	3
36224	617222	6	1	0	0	0	1
36224	617247	6	2	2	0	0	4
36224	617254	6	2	0	0	0	2
36224	617265	6	2	1	0	0	3
36224	617301	6	4	0	0	0	4
36224	617326	6	1	0	1	0	2
36224	617335	6	5	0	0	0	5
36224	617339	6	3	0	0	0	3
36224	617340	6	2	0	0	1	3
36224	101710	5	1	0	0	1	2
36224	220246	5	2	1	0	0	3
36224	292811	5	1	0	0	1	2
36224	292816	5	3	0	0	1	4
36224	292817	5	2	0	0	0	2
36224	617149	5	1	3	0	1	5
36224	617151	5	5	2	0	0	7
36224	617159	5	0	0	0	0	0
36224	617169	5	5	1	0	0	6
36224	617178	5	3	0	0	1	4
36224	617184	5	3	1	0	0	4
36224	617186	5	0	0	0	0	0
36224	617212	5	2	0	0	1	3
36224	617218	5	0	3	0	1	4
36224	617228	5	1	0	0	0	1
36224	617230	5	1	1	0	0	2
36224	617233	5	1	1	0	1	3
36224	617250	5	2	1	0	0	3
36224	617257	5	3	0	0	0	3
36224	617278	5	1	1	0	0	2
36224	617281	5	4	1	1	0	6
36224	617287	5	3	1	0	0	4
36224	617290	5	3	0	1	0	4
36224	617291	5	2	1	0	0	3
36224	617296	5	3	1	0	0	4
36224	617298	5	3	1	0	1	5
36224	617308	5	2	0	0	0	2
36224	617312	5	1	0	0	0	1
36224	617343	5	1	0	0	0	1
36224	617351	5	3	0	0	0	3
36224	617353	5	4	2	0	0	6
36224	617380	5	3	1	0	1	5
36224	617386	5	4	0	0	0	4
36224	617388	5	0	1	0	0	1
36224	617397	5	3	1	0	0	4
36224	617401	5	2	2	0	0	4
36224	76734	5	3	0	0	1	4
36224	197305	4	0	0	0	1	1
36224	202967	4	0	0	0	0	0
36224	208150	4	2	0	0	0	2
36224	218559	4	2	2	0	0	4
36224	219994	4	0	1	0	0	1
36224	292807	4	0	1	0	2	3
36224	292818	4	2	2	0	0	4
36224	617148	4	1	0	2	0	3
36224	617157	4	1	0	0	0	1
36224	617165	4	1	0	0	0	1
36224	617166	4	1	0	0	0	1
36224	617168	4	2	0	0	0	2
36224	617171	4	2	1	0	0	3
36224	617187	4	1	0	0	0	1
36224	617191	4	3	1	0	0	4
36224	617192	4	1	1	0	0	2
36224	617202	4	1	0	0	0	1
36224	617203	4	1	1	0	0	2
36224	617207	4	5	1	0	0	6
36224	617208	4	2	1	1	0	4
36224	617210	4	4	2	0	0	6
36224	617221	4	3	0	0	0	3
36224	617223	4	2	0	0	0	2
36224	617232	4	2	0	0	1	3
36224	617236	4	0	0	0	1	1
36224	617238	4	2	0	0	0	2
36224	617243	4	3	1	0	0	4
36224	617245	4	2	1	0	0	3
36224	617249	4	3	1	0	0	4
36224	617259	4	2	0	0	0	2
36224	617268	4	2	0	0	1	3
36224	617271	4	1	0	0	0	1
36224	617272	4	2	1	0	0	3
36224	617279	4	7	4	0	0	11
36224	617284	4	1	0	0	0	1
36224	617288	4	2	0	0	0	2
36224	617302	4	2	1	0	0	3
36224	617304	4	2	2	0	0	4
36224	617306	4	3	0	0	0	3
36224	617309	4	0	1	0	0	1
36224	617311	4	3	1	0	0	4
36224	617314	4	1	0	0	0	1
36224	617319	4	1	1	0	0	2
36224	617322	4	1	1	0	0	2
36224	617325	4	0	0	1	1	2
36224	617328	4	3	1	0	0	4
36224	617329	4	1	3	0	0	4
36224	617330	4	2	1	0	0	3
36224	617336	4	3	1	0	0	4
36224	617338	4	2	0	0	0	2
36224	617341	4	2	0	0	0	2
36224	617352	4	1	2	0	1	4
36224	617362	4	2	1	0	0	3
36224	617364	4	3	0	0	0	3
36224	617366	4	3	1	0	0	4
36224	617371	4	1	0	0	0	1
36224	617375	4	5	0	0	0	5
36224	617376	4	2	1	0	1	4
36224	617377	4	0	1	0	0	1
36224	617378	4	1	2	0	0	3
36224	617383	4	1	1	0	0	2
36224	617385	4	1	2	0	0	3
36224	617387	4	3	2	0	0	5
36224	72549	4	3	3	0	0	6
36224	93888	4	2	2	0	0	4
36224	185467	3	3	0	0	0	3
36224	189160	3	0	0	0	1	1
36224	189679	3	0	1	0	0	1
36224	199231	3	5	1	0	0	6
36224	201610	3	3	0	0	0	3
36224	203101	3	1	0	0	0	1
36224	210779	3	2	1	0	0	3
36224	211227	3	2	1	0	0	3
36224	212756	3	2	0	0	0	2
36224	216375	3	2	0	0	1	3
36224	292809	3	1	0	0	0	1
36224	292810	3	2	0	0	0	2
36224	292813	3	0	0	0	0	0
36224	530662	3	1	0	0	0	1
36224	617145	3	0	0	0	1	1
36224	617146	3	2	0	0	1	3
36224	617147	3	1	0	0	0	1
36224	617153	3	4	1	0	0	5
36224	617154	3	2	0	0	0	2
36224	617160	3	0	1	0	0	1
36224	617163	3	2	0	0	0	2
36224	617164	3	3	0	0	0	3
36224	617167	3	1	1	0	1	3
36224	617170	3	3	0	0	0	3
36224	617173	3	1	0	0	0	1
36224	617176	3	2	3	0	0	5
36224	617179	3	2	0	0	0	2
36224	617183	3	1	0	0	1	2
36224	617185	3	2	1	0	0	3
36224	617189	3	0	0	0	0	0
36224	617190	3	1	0	0	0	1
36224	617193	3	1	1	0	1	3
36224	617196	3	3	0	0	0	3
36224	617201	3	0	0	0	0	0
36224	617205	3	0	1	0	1	2
36224	617217	3	3	0	0	0	3
36224	617224	3	0	0	0	1	1
36224	617226	3	1	2	0	1	4
36224	617227	3	2	0	0	0	2
36224	617231	3	1	1	0	1	3
36224	617234	3	2	1	0	0	3
36224	617235	3	0	0	0	0	0
36224	617244	3	1	1	0	0	2
36224	617246	3	2	1	0	0	3
36224	617248	3	1	1	0	0	2
36224	617264	3	1	1	0	0	2
36224	617282	3	0	0	0	0	0
36224	617285	3	2	0	0	1	3
36224	617293	3	1	4	0	0	5
36224	617294	3	0	0	0	0	0
36224	617295	3	4	1	0	0	5
36224	617299	3	0	1	0	0	1
36224	617300	3	2	0	0	0	2
36224	617310	3	2	0	0	0	2
36224	617317	3	2	0	0	0	2
36224	617321	3	0	1	0	0	1
36224	617323	3	2	2	0	0	4
36224	617331	3	0	1	0	0	1
36224	617333	3	1	1	0	0	2
36224	617344	3	2	1	0	0	3
36224	617347	3	1	1	0	2	4
36224	617357	3	4	0	0	1	5
36224	617358	3	3	0	0	0	3
36224	617359	3	2	0	0	1	3
36224	617361	3	1	0	0	0	1
36224	617363	3	1	2	0	0	3
36224	617367	3	2	0	0	0	2
36224	617369	3	4	0	0	0	4
36224	617370	3	0	1	0	0	1
36224	617373	3	3	3	0	0	6
36224	617381	3	1	1	0	0	2
36224	617389	3	2	1	0	1	4
36224	617391	3	3	0	0	0	3
36224	617392	3	1	0	0	1	2
36224	617395	3	2	4	0	0	6
36224	617398	3	0	0	0	0	0
36224	617400	3	3	0	0	0	3
36224	79149	3	0	0	0	0	0
36224	183799	2	2	0	0	1	3
36224	184570	2	0	0	0	0	0
36224	193084	2	1	0	0	0	1
36224	199729	2	0	0	0	0	0
36224	203820	2	1	0	0	0	1
36224	205523	2	1	0	0	0	1
36224	209291	2	0	0	0	0	0
36224	292808	2	2	0	0	0	2
36224	292812	2	1	0	0	0	1
36224	292815	2	1	0	0	0	1
36224	617143	2	2	0	0	0	2
36224	617152	2	2	0	0	0	2
36224	617156	2	2	1	0	0	3
36224	617161	2	2	2	0	0	4
36224	617172	2	1	0	0	0	1
36224	617188	2	3	0	0	0	3
36224	617194	2	2	0	0	0	2
36224	617195	2	0	1	0	1	2
36224	617200	2	0	1	0	1	2
36224	617209	2	1	2	0	0	3
36224	617213	2	1	0	0	0	1
36224	617216	2	1	1	0	0	2
36224	617225	2	1	1	0	0	2
36224	617239	2	3	1	0	0	4
36224	617240	2	1	1	0	0	2
36224	617241	2	0	1	0	0	1
36224	617242	2	1	0	0	0	1
36224	617252	2	2	0	0	0	2
36224	617255	2	0	1	0	0	1
36224	617256	2	1	1	0	0	2
36224	617262	2	0	0	0	0	0
36224	617266	2	1	1	0	0	2
36224	617274	2	1	1	0	1	3
36224	617275	2	2	1	0	0	3
36224	617276	2	2	0	0	1	3
36224	617277	2	1	0	0	0	1
36224	617286	2	2	0	0	1	3
36224	617292	2	3	0	0	0	3
36224	617297	2	1	0	0	0	1
36224	617303	2	2	1	0	0	3
36224	617307	2	1	0	0	0	1
36224	617313	2	1	0	0	0	1
36224	617315	2	2	0	0	0	2
36224	617316	2	0	0	0	0	0
36224	617318	2	2	2	0	0	4
36224	617320	2	2	0	0	0	2
36224	617327	2	2	1	0	1	4
36224	617332	2	2	1	0	1	4
36224	617334	2	1	2	0	0	3
36224	617342	2	1	1	0	0	2
36224	617345	2	2	0	0	0	2
36224	617346	2	0	2	0	1	3
36224	617348	2	2	0	0	0	2
36224	617354	2	1	0	0	0	1
36224	617355	2	2	0	0	0	2
36224	617365	2	0	1	0	0	1
36224	617374	2	2	0	0	0	2
36224	617379	2	3	0	0	0	3
36224	617382	2	3	0	0	0	3
36224	617384	2	0	0	0	0	0
36224	617394	2	1	0	0	0	1
36224	617396	2	3	0	0	0	3
36224	617399	2	2	0	0	0	2
36224	98504	2	1	0	0	0	1
36224	184231	1	1	0	0	0	1
36224	186363	1	0	0	0	0	0
36224	186613	1	1	0	0	0	1
36224	186985	1	1	0	0	0	1
36224	190966	1	0	0	0	0	0
36224	191184	1	1	0	0	0	1
36224	205019	1	1	0	0	0	1
36224	208898	1	0	0	0	0	0
36224	212021	1	1	0	0	0	1
36224	215721	1	1	0	0	0	1
36224	617144	1	1	0	0	0	1
36224	617155	1	5	0	0	0	5
36224	617177	1	3	0	0	0	3
36224	617197	1	1	0	0	0	1
36224	617204	1	0	1	0	1	2
36224	617215	1	1	0	0	0	1
36224	617229	1	1	0	1	0	2
36224	617237	1	3	0	0	0	3
36224	617251	1	0	0	0	0	0
36224	617258	1	0	0	0	0	0
36224	617260	1	3	0	0	0	3
36224	617261	1	1	0	0	0	1
36224	617263	1	1	1	0	0	2
36224	617267	1	1	1	0	0	2
36224	617269	1	0	0	0	0	0
36224	617270	1	2	0	0	1	3
36224	617283	1	0	1	0	0	1
36224	617289	1	1	0	0	0	1
36224	617305	1	1	2	0	0	3
36224	617337	1	1	0	0	0	1
36224	617350	1	2	0	0	0	2
36224	617356	1	0	0	0	0	0
36224	617360	1	1	0	0	0	1
36224	617368	1	2	0	0	0	2
36224	617372	1	1	0	0	2	3
36224	617390	1	0	0	0	0	0
29082	50324	27	2	2	0	1	5
29082	290882	26	4	4	0	0	8
29082	56694	26	4	4	0	0	8
29082	102390	20	0	0	0	0	0
29082	523984	13	2	0	0	0	2
29082	67146	13	3	0	1	1	5
29082	290881	11	3	0	0	0	3
29082	290885	11	2	0	0	1	3
29082	524022	11	3	0	0	0	3
29082	73984	11	2	0	0	1	3
29082	83359	11	3	0	0	0	3
29082	88553	11	0	2	0	0	2
29082	524006	9	1	0	1	0	2
29082	524088	9	4	0	0	0	4
29082	524080	8	1	0	0	0	1
29082	524092	8	0	0	0	4	4
29082	78867	8	2	0	0	0	2
29082	524030	7	1	1	0	0	2
29082	524056	7	0	0	0	0	0
29082	524214	7	3	1	0	0	4
29082	524220	7	2	1	0	0	3
29082	524222	7	3	0	1	0	4
29082	524230	7	2	2	0	0	4
29082	523997	6	1	0	0	0	1
29082	524003	6	2	2	0	1	5
29082	524060	6	3	0	1	0	4
29082	524070	6	1	1	0	0	2
29082	524119	6	2	0	1	0	3
29082	524143	6	2	1	0	1	4
29082	524215	6	5	0	0	0	5
29082	524234	6	2	0	0	0	2
29082	524239	6	1	0	0	2	3
29082	524240	6	1	0	0	2	3
29082	524248	6	0	0	0	1	1
29082	524255	6	6	0	1	1	8
29082	56440	6	0	0	0	0	0
29082	523996	5	0	1	0	0	1
29082	524008	5	0	1	0	0	1
29082	524024	5	0	2	0	0	2
29082	524043	5	1	1	0	1	3
29082	524045	5	2	0	0	0	2
29082	524049	5	1	0	0	1	2
29082	524076	5	1	0	0	0	1
29082	524078	5	2	0	0	0	2
29082	524093	5	2	0	0	0	2
29082	524134	5	1	3	0	0	4
29082	524137	5	1	1	0	0	2
29082	524139	5	2	0	0	0	2
29082	524151	5	0	0	0	0	0
29082	524177	5	1	1	0	0	2
29082	524180	5	4	0	0	0	4
29082	524181	5	0	0	0	0	0
29082	524191	5	1	1	0	1	3
29082	524206	5	0	0	0	1	1
29082	524233	5	1	0	0	0	1
29082	524244	5	2	0	0	0	2
29082	524251	5	1	1	0	1	3
29082	524252	5	0	0	0	0	0
29082	97656	5	1	1	1	0	3
29082	290884	4	0	1	2	0	3
29082	523999	4	2	1	0	0	3
29082	524002	4	1	1	1	0	3
29082	524012	4	0	0	0	1	1
29082	524025	4	2	0	0	0	2
29082	524029	4	1	0	0	0	1
29082	524032	4	0	1	0	0	1
29082	524035	4	0	0	0	0	0
29082	524037	4	2	1	1	0	4
29082	524046	4	2	0	0	0	2
29082	524048	4	1	0	0	0	1
29082	524063	4	3	1	1	0	5
29082	524069	4	2	1	0	0	3
29082	524075	4	0	0	0	0	0
29082	524083	4	0	0	2	0	2
29082	524089	4	2	1	0	0	3
29082	524090	4	1	0	0	0	1
29082	524107	4	1	1	0	0	2
29082	524113	4	3	0	0	0	3
29082	524124	4	2	0	0	0	2
29082	524125	4	0	0	0	1	1
29082	524126	4	1	1	0	0	2
29082	524130	4	1	1	0	0	2
29082	524136	4	0	0	0	0	0
29082	524154	4	0	0	1	0	1
29082	524157	4	2	0	0	0	2
29082	524161	4	1	0	0	2	3
29082	524165	4	0	0	0	0	0
29082	524174	4	1	0	0	0	1
29082	524193	4	1	1	0	0	2
29082	524204	4	2	0	0	0	2
29082	524208	4	0	1	0	0	1
29082	524211	4	1	0	0	0	1
29082	524213	4	1	0	0	1	2
29082	524216	4	0	1	0	0	1
29082	524217	4	3	3	1	1	8
29082	524219	4	2	0	0	0	2
29082	524221	4	0	2	0	0	2
29082	524245	4	2	0	0	0	2
29082	524254	4	0	0	0	0	0
29082	524260	4	0	1	0	1	2
29082	524262	4	1	0	0	0	1
29082	54704	4	0	1	2	0	3
29082	62110	4	1	0	0	0	1
29082	83252	4	1	0	0	0	1
29082	93124	4	3	0	0	0	3
29082	189333	3	0	0	1	1	2
29082	203993	3	1	0	0	0	1
29082	523983	3	0	1	0	1	2
29082	523987	3	1	0	0	0	1
29082	523989	3	1	0	0	0	1
29082	523992	3	1	0	0	0	1
29082	523998	3	1	0	1	0	2
29082	524009	3	0	2	0	0	2
29082	524017	3	0	0	0	0	0
29082	524018	3	0	1	0	1	2
29082	524021	3	0	0	0	0	0
29082	524031	3	2	0	0	0	2
29082	524033	3	0	0	0	0	0
29082	524051	3	3	0	0	0	3
29082	524054	3	2	1	0	0	3
29082	524057	3	0	1	0	0	1
29082	524058	3	0	0	0	0	0
29082	524059	3	2	0	1	0	3
29082	524061	3	1	0	0	0	1
29082	524062	3	2	0	0	0	2
29082	524066	3	1	1	1	0	3
29082	524071	3	1	0	0	0	1
29082	524073	3	0	1	1	0	2
29082	524077	3	1	0	0	0	1
29082	524087	3	1	0	0	1	2
29082	524094	3	0	0	0	0	0
29082	524095	3	1	0	0	0	1
29082	524096	3	1	1	0	0	2
29082	524097	3	1	0	1	0	2
29082	524100	3	0	0	1	0	1
29082	524103	3	2	0	0	1	3
29082	524108	3	2	0	0	0	2
29082	524109	3	0	0	0	0	0
29082	524111	3	1	0	0	0	1
29082	524117	3	0	0	0	2	2
29082	524127	3	2	0	1	0	3
29082	524129	3	1	0	0	0	1
29082	524135	3	0	0	0	0	0
29082	524140	3	2	1	0	3	6
29082	524142	3	0	1	0	1	2
29082	524145	3	1	0	0	0	1
29082	524148	3	0	0	0	0	0
29082	524149	3	1	0	0	0	1
29082	524155	3	1	0	0	0	1
29082	524159	3	0	1	0	0	1
29082	524162	3	0	0	1	0	1
29082	524173	3	0	0	0	0	0
29082	524176	3	2	0	0	1	3
29082	524184	3	1	0	0	0	1
29082	524188	3	1	1	0	2	4
29082	524197	3	1	0	0	0	1
29082	524198	3	1	0	0	0	1
29082	524201	3	1	0	0	0	1
29082	524205	3	2	0	0	0	2
29082	524207	3	3	0	0	0	3
29082	524209	3	1	1	0	0	2
29082	524210	3	1	0	0	0	1
29082	524223	3	1	0	0	0	1
29082	524227	3	2	1	0	0	3
29082	524231	3	1	0	0	0	1
29082	524241	3	0	1	0	0	1
29082	524243	3	1	1	0	0	2
29082	524249	3	1	0	0	0	1
29082	524263	3	0	0	0	0	0
29082	524264	3	1	0	0	0	1
29082	524265	3	0	1	0	0	1
29082	524267	3	1	0	0	0	1
29082	524269	3	0	1	0	0	1
29082	56301	3	0	0	0	0	0
29082	83446	3	1	2	0	1	4
29082	195810	2	0	3	0	0	3
29082	523982	2	0	0	0	0	0
29082	523985	2	0	1	1	0	2
29082	523990	2	2	0	0	0	2
29082	523995	2	1	0	0	0	1
29082	524000	2	2	0	0	0	2
29082	524001	2	3	0	0	0	3
29082	524005	2	1	0	0	0	1
29082	524007	2	2	0	0	0	2
29082	524010	2	0	0	1	0	1
29082	524016	2	1	0	0	0	1
29082	524023	2	1	0	0	0	1
29082	524026	2	1	0	0	0	1
29082	524028	2	0	0	0	0	0
29082	524036	2	1	1	0	0	2
29082	524039	2	1	0	0	0	1
29082	524040	2	1	0	0	0	1
29082	524044	2	0	0	0	1	1
29082	524047	2	1	0	0	0	1
29082	524050	2	0	1	0	0	1
29082	524053	2	1	0	0	0	1
29082	524064	2	0	0	0	0	0
29082	524065	2	0	0	0	1	1
29082	524067	2	0	1	0	0	1
29082	524068	2	1	0	0	0	1
29082	524072	2	0	0	0	0	0
29082	524074	2	1	0	0	0	1
29082	524084	2	0	0	0	0	0
29082	524085	2	2	0	0	0	2
29082	524086	2	2	0	0	0	2
29082	524091	2	1	0	0	0	1
29082	524098	2	0	1	0	0	1
29082	524099	2	0	0	0	0	0
29082	524101	2	0	0	1	0	1
29082	524102	2	1	0	0	0	1
29082	524106	2	1	0	0	0	1
29082	524110	2	0	0	0	0	0
29082	524112	2	1	0	0	0	1
29082	524114	2	0	0	0	0	0
29082	524115	2	1	0	0	0	1
29082	524118	2	0	0	0	0	0
29082	524120	2	1	0	0	2	3
29082	524122	2	2	0	0	0	2
29082	524128	2	1	0	0	0	1
29082	524131	2	1	1	0	0	2
29082	524133	2	1	0	0	0	1
29082	524138	2	1	0	0	0	1
29082	524141	2	0	0	0	0	0
29082	524146	2	2	0	0	0	2
29082	524150	2	0	1	0	0	1
29082	524152	2	0	0	0	0	0
29082	524153	2	1	0	0	0	1
29082	524158	2	1	0	0	0	1
29082	524163	2	0	0	0	0	0
29082	524164	2	2	0	0	0	2
29082	524166	2	1	0	0	0	1
29082	524171	2	1	0	0	0	1
29082	524172	2	0	0	0	0	0
29082	524175	2	2	0	0	0	2
29082	524178	2	1	0	0	0	1
29082	524179	2	0	1	0	0	1
29082	524183	2	0	0	0	1	1
29082	524185	2	1	0	0	0	1
29082	524186	2	1	0	0	1	2
29082	524187	2	1	0	0	0	1
29082	524189	2	1	0	0	0	1
29082	524192	2	0	0	0	0	0
29082	524194	2	1	0	0	0	1
29082	524200	2	1	0	0	0	1
29082	524202	2	1	0	0	0	1
29082	524212	2	0	0	0	1	1
29082	524218	2	1	0	0	0	1
29082	524224	2	0	0	0	0	0
29082	524226	2	0	2	0	1	3
29082	524228	2	1	0	0	0	1
29082	524232	2	1	1	0	1	3
29082	524237	2	3	0	0	0	3
29082	524238	2	1	0	0	0	1
29082	524247	2	2	0	0	0	2
29082	524256	2	0	1	0	0	1
29082	524257	2	1	0	0	1	2
29082	524258	2	1	0	0	0	1
29082	524259	2	1	0	0	0	1
29082	524261	2	0	0	1	0	1
29082	524266	2	0	0	2	0	2
29082	524270	2	1	1	0	0	2
29082	524271	2	1	0	0	0	1
29082	59688	2	1	0	0	1	2
29082	83489	2	0	0	0	1	1
29082	208415	1	0	0	0	0	0
29082	523986	1	0	0	0	0	0
29082	523988	1	1	0	0	0	1
29082	523991	1	1	1	0	0	2
29082	523993	1	0	0	0	0	0
29082	523994	1	0	0	0	0	0
29082	524004	1	0	1	0	0	1
29082	524011	1	1	0	0	0	1
29082	524013	1	0	0	0	1	1
29082	524014	1	1	1	0	0	2
29082	524015	1	1	0	0	0	1
29082	524019	1	1	0	0	0	1
29082	524020	1	0	0	0	0	0
29082	524027	1	0	0	0	0	0
29082	524034	1	0	1	0	0	1
29082	524038	1	1	0	0	0	1
29082	524041	1	0	1	0	1	2
29082	524042	1	0	1	0	0	1
29082	524052	1	0	0	0	0	0
29082	524055	1	1	0	0	0	1
29082	524079	1	0	0	0	1	1
29082	524081	1	0	1	0	0	1
29082	524082	1	0	0	0	0	0
29082	524104	1	1	1	0	1	3
29082	524105	1	0	0	0	0	0
29082	524116	1	2	1	0	0	3
29082	524121	1	0	0	0	0	0
29082	524123	1	0	0	0	0	0
29082	524132	1	0	1	0	0	1
29082	524144	1	1	0	0	0	1
29082	524147	1	1	2	0	0	3
29082	524156	1	1	0	0	0	1
29082	524160	1	0	0	0	1	1
29082	524167	1	0	0	0	0	0
29082	524168	1	0	0	0	0	0
29082	524169	1	1	0	0	0	1
29082	524170	1	0	1	0	0	1
29082	524182	1	1	0	0	0	1
29082	524190	1	2	0	1	0	3
29082	524195	1	0	0	0	0	0
29082	524196	1	0	0	0	0	0
29082	524199	1	0	0	0	0	0
29082	524203	1	2	0	0	0	2
29082	524225	1	1	0	0	0	1
29082	524229	1	2	0	0	0	2
29082	524235	1	0	1	0	0	1
29082	524236	1	0	2	0	0	2
29082	524242	1	1	0	0	0	1
29082	524246	1	0	1	0	0	1
29082	524250	1	0	0	0	0	0
29082	524253	1	1	1	0	0	2
29082	524268	1	1	0	0	0	1
29082	524272	1	0	0	0	0	0
6689	427543	16	4	4	0	0	8
6689	427544	16	4	4	0	0	8
6689	284688	12	1	1	0	1	3
6689	284692	11	4	5	0	0	9
6689	427551	11	3	2	0	2	7
6689	185356	10	1	2	0	2	5
6689	212993	10	2	4	0	2	8
6689	427688	10	0	2	2	1	5
6689	427749	10	2	0	0	1	3
6689	189154	9	3	0	0	0	3
6689	284690	9	3	2	0	0	5
6689	427648	9	0	1	1	0	2
6689	427664	9	3	2	0	0	5
6689	427683	9	2	0	0	0	2
6689	427761	9	5	3	0	0	8
6689	427771	9	3	2	0	0	5
6689	427528	8	1	4	0	1	6
6689	427649	8	1	1	0	1	3
6689	427678	8	1	1	1	0	3
6689	427765	8	0	1	0	1	2
6689	187031	7	1	3	0	0	4
6689	427535	7	1	6	0	0	7
6689	427548	7	0	1	0	2	3
6689	427550	7	1	2	0	2	5
6689	427647	7	0	3	0	0	3
6689	427651	7	2	3	0	0	5
6689	427700	7	1	2	0	1	4
6689	427740	7	0	2	0	2	4
6689	427756	7	2	4	0	1	7
6689	427769	7	1	2	0	0	3
6689	427534	6	0	2	0	0	2
6689	427546	6	1	2	0	2	5
6689	427549	6	0	3	0	1	4
6689	427561	6	0	3	1	0	4
6689	427562	6	1	3	0	1	5
6689	427586	6	1	1	0	0	2
6689	427587	6	0	2	1	0	3
6689	427591	6	1	1	0	0	2
6689	427622	6	1	2	0	0	3
6689	427639	6	1	1	0	1	3
6689	427640	6	2	1	0	0	3
6689	427659	6	2	1	0	0	3
6689	427671	6	1	1	0	0	2
6689	427689	6	0	2	0	0	2
6689	427714	6	1	2	0	0	3
6689	427721	6	0	2	0	1	3
6689	427732	6	1	1	0	0	2
6689	427739	6	3	0	0	2	5
6689	427764	6	1	1	0	0	2
6689	183797	5	0	2	0	1	3
6689	194844	5	0	1	0	0	1
6689	198077	5	0	0	0	0	0
6689	214303	5	1	1	0	1	3
6689	220064	5	0	0	0	0	0
6689	284698	5	1	1	0	1	3
6689	427526	5	0	3	0	0	3
6689	427538	5	0	0	0	0	0
6689	427553	5	1	0	0	1	2
6689	427559	5	2	1	0	1	4
6689	427566	5	1	2	0	2	5
6689	427569	5	1	3	0	0	4
6689	427582	5	1	0	0	1	2
6689	427590	5	1	1	0	0	2
6689	427592	5	0	0	0	0	0
6689	427597	5	1	2	2	1	6
6689	427604	5	0	1	0	1	2
6689	427612	5	1	2	0	0	3
6689	427613	5	0	1	0	1	2
6689	427621	5	2	3	0	0	5
6689	427631	5	3	2	0	2	7
6689	427652	5	1	2	0	0	3
6689	427656	5	0	1	0	0	1
6689	427665	5	3	1	2	1	7
6689	427667	5	2	2	0	0	4
6689	427670	5	1	3	0	0	4
6689	427672	5	1	1	0	1	3
6689	427673	5	0	1	0	1	2
6689	427681	5	0	1	0	1	2
6689	427696	5	2	0	0	0	2
6689	427701	5	1	1	0	0	2
6689	427704	5	1	1	0	1	3
6689	427715	5	4	1	0	0	5
6689	427716	5	1	0	0	0	1
6689	427730	5	1	1	1	0	3
6689	427741	5	1	1	0	0	2
6689	427742	5	1	1	0	2	4
6689	427745	5	1	1	0	0	2
6689	427772	5	1	3	0	0	4
6689	427774	5	1	2	0	0	3
6689	427776	5	3	2	0	0	5
6689	195191	4	1	1	0	2	4
6689	284689	4	1	1	0	0	2
6689	427527	4	1	3	0	0	4
6689	427552	4	0	2	0	0	2
6689	427554	4	5	1	0	0	6
6689	427574	4	2	2	0	0	4
6689	427584	4	1	1	0	0	2
6689	427585	4	0	2	0	0	2
6689	427599	4	1	0	0	0	1
6689	427603	4	1	1	0	0	2
6689	427605	4	1	1	0	0	2
6689	427606	4	0	0	0	0	0
6689	427607	4	0	0	0	0	0
6689	427615	4	0	0	0	0	0
6689	427619	4	1	2	0	0	3
6689	427625	4	0	0	0	0	0
6689	427626	4	1	3	0	2	6
6689	427629	4	0	1	0	0	1
6689	427632	4	0	0	0	0	0
6689	427634	4	0	0	0	0	0
6689	427635	4	1	2	0	0	3
6689	427637	4	0	1	0	0	1
6689	427650	4	2	1	0	0	3
6689	427655	4	1	0	0	0	1
6689	427658	4	1	1	0	0	2
6689	427669	4	0	0	0	0	0
6689	427680	4	0	1	0	0	1
6689	427682	4	0	1	0	0	1
6689	427687	4	3	1	0	0	4
6689	427690	4	0	0	0	0	0
6689	427694	4	1	1	0	0	2
6689	427697	4	1	3	0	0	4
6689	427698	4	0	1	0	0	1
6689	427708	4	0	0	0	0	0
6689	427709	4	0	1	0	0	1
6689	427713	4	0	3	0	0	3
6689	427718	4	0	0	0	0	0
6689	427719	4	1	2	0	0	3
6689	427723	4	1	3	2	1	7
6689	427724	4	1	2	0	1	4
6689	427729	4	1	3	0	0	4
6689	427733	4	0	1	0	0	1
6689	427735	4	1	1	0	0	2
6689	427736	4	1	1	0	0	2
6689	427747	4	2	5	0	0	7
6689	427755	4	0	2	0	0	2
6689	427759	4	0	1	0	0	1
6689	427762	4	0	3	0	0	3
6689	427763	4	0	0	0	0	0
6689	427768	4	1	1	1	0	3
6689	427773	4	0	1	0	0	1
6689	427777	4	0	4	0	0	4
6689	185600	3	0	0	0	0	0
6689	187948	3	1	3	0	0	4
6689	190318	3	1	0	0	0	1
6689	193211	3	0	1	0	0	1
6689	198081	3	1	0	0	0	1
6689	202964	3	0	1	0	0	1
6689	204978	3	1	1	0	0	2
6689	207069	3	0	0	0	0	0
6689	209604	3	0	0	1	0	1
6689	216780	3	1	3	0	0	4
6689	284691	3	2	2	0	1	5
6689	427531	3	1	1	0	0	2
6689	427536	3	2	1	0	2	5
6689	427555	3	1	0	0	0	1
6689	427556	3	0	1	0	0	1
6689	427557	3	0	0	0	0	0
6689	427558	3	1	4	0	0	5
6689	427560	3	0	3	0	0	3
6689	427563	3	0	0	0	0	0
6689	427564	3	0	1	2	1	4
6689	427570	3	1	0	0	0	1
6689	427571	3	1	0	0	0	1
6689	427572	3	1	0	0	0	1
6689	427575	3	2	2	1	0	5
6689	427577	3	1	2	0	0	3
6689	427588	3	0	2	0	0	2
6689	427594	3	0	0	0	0	0
6689	427596	3	1	1	0	0	2
6689	427598	3	1	0	0	0	1
6689	427601	3	0	1	0	0	1
6689	427609	3	0	0	0	1	1
6689	427610	3	1	2	0	0	3
6689	427611	3	0	1	0	1	2
6689	427616	3	0	1	0	1	2
6689	427620	3	0	0	0	0	0
6689	427633	3	2	0	0	0	2
6689	427636	3	2	1	0	0	3
6689	427641	3	0	1	0	0	1
6689	427643	3	0	2	0	0	2
6689	427646	3	1	0	0	0	1
6689	427654	3	0	1	0	0	1
6689	427657	3	1	0	0	0	1
6689	427661	3	3	1	1	2	7
6689	427662	3	2	1	0	0	3
6689	427663	3	0	0	0	1	1
6689	427666	3	3	2	0	0	5
6689	427668	3	2	0	0	0	2
6689	427674	3	1	2	0	1	4
6689	427675	3	1	2	0	1	4
6689	427676	3	0	2	1	2	5
6689	427679	3	0	1	0	0	1
6689	427684	3	0	0	0	0	0
6689	427686	3	0	0	0	0	0
6689	427691	3	0	1	0	0	1
6689	427692	3	2	0	0	0	2
6689	427706	3	1	0	0	0	1
6689	427711	3	0	1	0	0	1
6689	427717	3	0	0	1	0	1
6689	427720	3	0	1	0	0	1
6689	427725	3	1	2	0	1	4
6689	427726	3	0	2	0	0	2
6689	427728	3	1	2	0	0	3
6689	427731	3	0	1	0	0	1
6689	427737	3	0	1	0	0	1
6689	427738	3	0	1	0	0	1
6689	427744	3	3	0	0	0	3
6689	427746	3	2	1	0	1	4
6689	427748	3	0	1	0	0	1
6689	427750	3	1	0	0	0	1
6689	427752	3	1	0	0	0	1
6689	427753	3	0	0	0	0	0
6689	427757	3	0	2	0	0	2
6689	427758	3	1	2	0	0	3
6689	427760	3	1	0	0	0	1
6689	427766	3	0	1	0	0	1
6689	427770	3	0	0	0	1	1
6689	427778	3	0	1	0	0	1
6689	427779	3	1	1	0	1	3
6689	183769	2	0	1	0	0	1
6689	188987	2	0	0	0	0	0
6689	192382	2	1	1	0	0	2
6689	198488	2	0	2	0	0	2
6689	206194	2	0	1	0	0	1
6689	212338	2	0	0	0	0	0
6689	214686	2	0	2	0	0	2
6689	217223	2	1	1	0	0	2
6689	218556	2	0	2	0	0	2
6689	218668	2	0	1	0	0	1
6689	284693	2	0	2	1	0	3
6689	284694	2	1	1	0	0	2
6689	284696	2	1	2	0	0	3
6689	284697	2	0	0	0	0	0
6689	284699	2	0	2	0	0	2
6689	427529	2	0	2	0	0	2
6689	427532	2	0	2	0	0	2
6689	427533	2	0	2	0	0	2
6689	427537	2	2	0	0	0	2
6689	427539	2	0	1	0	0	1
6689	427545	2	0	0	0	0	0
6689	427547	2	0	0	0	0	0
6689	427565	2	0	1	0	0	1
6689	427567	2	0	2	0	0	2
6689	427568	2	0	2	0	0	2
6689	427573	2	0	1	0	0	1
6689	427578	2	0	3	0	0	3
6689	427579	2	1	0	0	0	1
6689	427580	2	0	1	0	1	2
6689	427581	2	0	1	0	0	1
6689	427583	2	0	1	0	0	1
6689	427589	2	1	1	0	0	2
6689	427593	2	1	1	0	0	2
6689	427595	2	1	4	0	0	5
6689	427600	2	1	1	0	0	2
6689	427602	2	0	2	0	0	2
6689	427608	2	0	0	0	0	0
6689	427614	2	0	0	0	1	1
6689	427618	2	0	0	0	0	0
6689	427624	2	0	1	0	0	1
6689	427638	2	1	0	0	0	1
6689	427642	2	0	2	0	0	2
6689	427644	2	0	2	0	0	2
6689	427645	2	0	2	0	0	2
6689	427653	2	0	3	0	0	3
6689	427660	2	0	1	0	0	1
6689	427677	2	1	2	0	0	3
6689	427705	2	0	1	0	0	1
6689	427707	2	1	0	0	0	1
6689	427710	2	0	0	0	0	0
6689	427712	2	2	2	0	0	4
6689	427727	2	1	3	0	0	4
6689	427743	2	0	0	0	0	0
6689	427751	2	0	0	0	1	1
6689	427754	2	0	1	0	0	1
6689	427775	2	0	1	0	0	1
6689	427780	2	0	0	0	0	0
6689	194514	1	0	2	0	0	2
6689	203777	1	0	0	0	0	0
6689	203842	1	0	0	0	0	0
6689	206212	1	0	1	0	0	1
6689	207824	1	0	1	0	0	1
6689	210759	1	0	0	0	0	0
6689	210772	1	0	1	0	0	1
6689	219991	1	1	1	0	0	2
6689	284687	1	0	1	0	0	1
6689	284695	1	0	1	0	0	1
6689	427530	1	1	1	0	0	2
6689	427540	1	0	1	0	0	1
6689	427576	1	1	2	0	0	3
6689	427617	1	0	0	0	0	0
6689	427623	1	0	1	0	0	1
6689	427627	1	0	0	0	0	0
6689	427628	1	1	2	0	1	4
6689	427630	1	0	3	0	0	3
6689	427685	1	1	1	0	0	2
6689	427693	1	0	1	0	0	1
6689	427695	1	0	0	0	0	0
6689	427699	1	0	2	0	0	2
6689	427702	1	0	1	0	0	1
6689	427703	1	1	0	0	0	1
6689	427722	1	0	0	0	0	0
6689	427734	1	0	0	0	0	0
6689	427767	1	1	0	0	0	1
13125	83942	47	4	7	3	6	20
13125	84985	38	2	9	1	1	13
13125	104383	30	1	6	1	0	8
13125	79803	29	3	7	1	6	17
13125	51758	26	5	5	0	2	12
13125	67287	26	2	0	0	0	2
13125	187598	25	2	3	0	8	13
13125	68901	25	0	4	0	0	4
13125	286578	24	0	3	0	0	3
13125	51266	24	3	2	0	0	5
13125	100598	23	5	10	0	1	16
13125	286569	22	2	1	1	0	4
13125	286571	22	0	1	2	0	3
13125	71414	22	0	1	2	0	3
13125	198188	21	1	6	1	3	11
13125	55132	21	4	5	0	2	11
13125	286563	20	0	6	1	1	8
13125	286579	20	1	6	1	3	11
13125	51380	20	1	6	1	3	11
13125	594636	20	0	6	1	1	8
13125	594659	20	1	0	0	1	2
13125	594760	20	1	6	1	3	11
13125	61966	20	0	6	1	1	8
13125	594642	18	1	5	0	0	6
13125	78725	16	0	1	0	1	2
13125	106805	15	2	3	0	0	5
13125	188349	14	3	5	0	3	11
13125	594696	13	3	2	0	2	7
13125	594699	13	0	1	0	0	1
13125	106618	12	0	1	0	0	1
13125	594646	12	2	2	0	0	4
13125	84166	12	0	3	0	1	4
13125	105783	11	0	2	0	1	3
13125	190775	11	1	3	0	1	5
13125	219492	11	0	2	0	1	3
13125	594631	11	3	3	0	0	6
13125	63768	11	0	2	0	0	2
13125	188026	10	1	2	0	0	3
13125	188581	10	0	1	0	0	1
13125	190266	10	2	3	0	2	7
13125	286576	10	0	1	0	0	1
13125	51644	10	2	8	1	2	13
13125	59747	10	0	1	0	0	1
13125	204168	9	2	5	0	1	8
13125	286584	9	0	1	1	0	2
13125	594698	9	1	1	1	0	3
13125	84378	9	2	5	0	1	8
13125	101632	8	0	2	0	0	2
13125	286583	8	0	2	0	0	2
13125	53308	8	2	3	0	1	6
13125	594613	8	0	3	1	0	4
13125	594669	8	2	3	0	1	6
13125	594681	8	3	3	0	0	6
13125	594728	8	2	0	0	0	2
13125	73958	8	1	3	0	0	4
13125	98106	8	1	2	0	0	3
13125	100988	7	1	2	0	0	3
13125	208169	7	2	1	0	0	3
13125	286581	7	1	2	0	0	3
13125	50226	7	0	1	0	2	3
13125	594662	7	3	1	0	0	4
13125	594722	7	2	1	0	0	3
13125	594734	7	1	3	1	0	5
13125	594775	7	2	4	0	0	6
13125	65797	7	0	4	0	0	4
13125	186086	6	1	4	0	0	5
13125	189944	6	1	2	0	0	3
13125	220719	6	0	2	0	0	2
13125	286574	6	2	3	0	1	6
13125	286580	6	1	4	0	0	5
13125	286582	6	1	3	0	0	4
13125	50795	6	2	3	0	1	6
13125	56149	6	1	3	0	0	4
13125	594630	6	3	2	0	0	5
13125	594640	6	0	1	0	0	1
13125	594655	6	3	4	0	0	7
13125	594667	6	0	4	0	0	4
13125	594668	6	0	1	0	1	2
13125	594671	6	2	1	0	0	3
13125	594689	6	1	0	0	0	1
13125	594753	6	1	3	0	0	4
13125	594766	6	1	2	0	0	3
13125	594767	6	0	4	0	0	4
13125	594769	6	0	3	1	0	4
13125	594771	6	3	2	0	0	5
13125	594772	6	3	2	0	0	5
13125	90609	6	1	4	0	0	5
13125	95768	6	0	2	0	1	3
13125	97865	6	0	0	1	3	4
13125	108317	5	2	2	0	3	7
13125	286568	5	1	2	0	0	3
13125	286570	5	1	2	0	0	3
13125	594635	5	1	1	0	0	2
13125	594676	5	3	5	0	0	8
13125	594692	5	1	0	0	0	1
13125	594695	5	2	3	1	0	6
13125	594700	5	0	2	0	0	2
13125	594705	5	1	2	1	1	5
13125	594718	5	0	0	0	0	0
13125	594720	5	1	1	0	0	2
13125	594725	5	1	3	0	0	4
13125	594742	5	2	1	0	2	5
13125	594747	5	0	2	0	0	2
13125	594750	5	0	3	0	0	3
13125	594777	5	1	3	0	0	4
13125	594778	5	0	4	0	1	5
13125	80680	5	1	2	0	0	3
13125	85631	5	0	3	0	0	3
13125	89243	5	1	1	0	0	2
13125	94604	5	1	3	0	0	4
13125	97653	5	0	1	0	0	1
13125	183437	4	1	1	0	0	2
13125	189295	4	0	1	0	0	1
13125	191832	4	3	1	0	0	4
13125	286572	4	3	1	0	0	4
13125	286575	4	0	0	0	0	0
13125	286577	4	0	3	0	1	4
13125	594607	4	0	0	0	0	0
13125	594614	4	1	2	0	0	3
13125	594620	4	0	0	0	0	0
13125	594624	4	0	0	0	0	0
13125	594625	4	2	2	0	0	4
13125	594633	4	1	1	0	0	2
13125	594641	4	1	1	0	0	2
13125	594647	4	1	1	0	0	2
13125	594652	4	0	3	0	1	4
13125	594654	4	0	3	0	0	3
13125	594658	4	1	1	0	0	2
13125	594661	4	0	0	0	0	0
13125	594678	4	1	0	0	0	1
13125	594691	4	1	0	0	0	1
13125	594703	4	1	1	0	0	2
13125	594704	4	1	2	0	0	3
13125	594707	4	0	1	0	0	1
13125	594708	4	0	1	0	0	1
13125	594713	4	1	0	1	0	2
13125	594715	4	1	1	0	0	2
13125	594723	4	3	1	0	0	4
13125	594727	4	0	3	0	0	3
13125	594729	4	0	0	0	0	0
13125	594735	4	0	3	0	0	3
13125	594739	4	1	1	0	0	2
13125	594741	4	1	1	0	1	3
13125	594744	4	1	1	0	2	4
13125	594751	4	1	1	0	1	3
13125	594764	4	0	2	0	0	2
13125	594765	4	1	3	0	1	5
13125	594768	4	0	2	1	0	3
13125	594773	4	1	2	0	0	3
13125	64292	4	3	1	0	0	4
13125	74182	4	0	0	0	0	0
13125	79581	4	0	3	0	1	4
13125	85617	4	1	0	0	0	1
13125	93711	4	0	2	0	1	3
13125	96363	4	0	1	0	0	1
13125	193380	3	0	1	0	0	1
13125	194610	3	0	0	0	0	0
13125	195540	3	0	0	0	0	0
13125	196935	3	1	1	0	0	2
13125	204084	3	1	2	1	0	4
13125	286562	3	0	1	0	0	1
13125	592788	3	1	2	0	0	3
13125	592789	3	0	2	0	0	2
13125	592791	3	1	1	0	0	2
13125	594608	3	0	1	0	0	1
13125	594612	3	1	1	0	0	2
13125	594617	3	0	1	0	0	1
13125	594621	3	0	1	0	0	1
13125	594622	3	1	3	0	0	4
13125	594623	3	0	2	0	0	2
13125	594634	3	1	0	0	0	1
13125	594638	3	2	1	0	0	3
13125	594645	3	2	0	0	0	2
13125	594663	3	0	2	0	0	2
13125	594664	3	0	0	0	1	1
13125	594665	3	0	1	0	0	1
13125	594673	3	0	2	0	0	2
13125	594675	3	1	3	0	0	4
13125	594679	3	0	1	0	0	1
13125	594680	3	1	2	0	0	3
13125	594684	3	0	3	0	0	3
13125	594686	3	1	2	0	0	3
13125	594690	3	0	1	0	0	1
13125	594693	3	1	1	0	0	2
13125	594694	3	0	3	0	0	3
13125	594701	3	0	1	1	0	2
13125	594702	3	2	1	0	0	3
13125	594706	3	1	1	0	0	2
13125	594711	3	1	4	2	0	7
13125	594716	3	0	0	1	0	1
13125	594730	3	0	1	0	1	2
13125	594733	3	0	2	0	0	2
13125	594746	3	1	1	0	0	2
13125	594748	3	1	1	0	1	3
13125	594754	3	0	1	0	0	1
13125	594755	3	0	1	0	0	1
13125	594757	3	0	1	0	0	1
13125	594758	3	1	3	0	0	4
13125	594759	3	1	0	0	0	1
13125	594762	3	0	1	0	0	1
13125	594770	3	0	0	0	0	0
13125	594774	3	0	4	0	0	4
13125	61181	3	0	1	0	1	2
13125	64151	3	1	3	0	0	4
13125	67223	3	1	2	0	0	3
13125	68759	3	0	1	0	0	1
13125	84649	3	0	2	0	1	3
13125	92256	3	0	1	0	0	1
13125	103574	2	0	0	0	0	0
13125	108534	2	1	0	0	0	1
13125	182091	2	0	1	0	1	2
13125	215017	2	0	2	0	0	2
13125	286566	2	0	3	0	0	3
13125	286567	2	2	1	0	0	3
13125	51419	2	0	1	0	0	1
13125	57118	2	2	0	0	0	2
13125	594610	2	2	1	0	0	3
13125	594611	2	0	1	0	1	2
13125	594618	2	1	2	1	0	4
13125	594619	2	0	3	0	0	3
13125	594626	2	0	0	0	0	0
13125	594628	2	0	1	0	1	2
13125	594629	2	0	1	0	1	2
13125	594632	2	0	0	1	0	1
13125	594637	2	1	0	0	0	1
13125	594639	2	0	2	0	0	2
13125	594643	2	0	0	0	1	1
13125	594644	2	0	0	0	0	0
13125	594648	2	1	2	0	0	3
13125	594650	2	0	1	0	0	1
13125	594656	2	2	1	0	0	3
13125	594657	2	0	2	0	0	2
13125	594660	2	0	0	0	0	0
13125	594674	2	0	3	0	0	3
13125	594677	2	0	1	0	0	1
13125	594683	2	1	2	0	0	3
13125	594687	2	0	0	0	0	0
13125	594697	2	0	0	0	0	0
13125	594710	2	1	2	0	0	3
13125	594712	2	0	2	0	0	2
13125	594714	2	0	1	0	0	1
13125	594717	2	0	0	0	0	0
13125	594719	2	2	1	0	0	3
13125	594721	2	1	1	0	0	2
13125	594731	2	0	1	0	0	1
13125	594732	2	0	4	0	0	4
13125	594737	2	1	1	0	0	2
13125	594740	2	0	1	0	0	1
13125	594743	2	0	2	0	0	2
13125	594745	2	0	1	0	0	1
13125	594749	2	1	0	1	0	2
13125	594752	2	0	0	0	1	1
13125	594761	2	0	1	0	1	2
13125	594763	2	1	1	0	1	3
13125	594776	2	0	1	0	0	1
13125	594779	2	2	2	0	0	4
13125	64915	2	0	2	0	0	2
13125	72546	2	0	1	0	0	1
13125	83467	2	0	1	0	0	1
13125	90445	2	0	1	0	0	1
13125	91692	2	0	2	0	0	2
13125	92906	2	0	1	0	0	1
13125	96496	2	0	0	0	0	0
13125	186664	1	1	0	0	0	1
13125	191268	1	1	1	0	0	2
13125	195825	1	2	1	0	0	3
13125	214528	1	0	0	0	0	0
13125	220223	1	0	2	0	0	2
13125	286564	1	0	1	0	0	1
13125	286565	1	1	0	0	0	1
13125	286573	1	0	1	0	0	1
13125	592787	1	1	1	0	0	2
13125	592790	1	1	1	0	0	2
13125	592792	1	0	1	0	0	1
13125	594606	1	0	0	0	0	0
13125	594609	1	0	1	0	0	1
13125	594615	1	0	0	0	0	0
13125	594616	1	0	1	0	1	2
13125	594627	1	0	2	0	0	2
13125	594649	1	0	0	1	0	1
13125	594651	1	0	0	2	0	2
13125	594653	1	0	1	0	0	1
13125	594666	1	0	2	0	0	2
13125	594670	1	0	1	0	1	2
13125	594672	1	0	2	0	1	3
13125	594682	1	0	2	0	0	2
13125	594685	1	0	1	0	0	1
13125	594688	1	2	0	0	0	2
13125	594709	1	0	1	0	0	1
13125	594724	1	1	1	0	0	2
13125	594726	1	0	1	0	0	1
13125	594736	1	0	3	0	0	3
13125	594738	1	0	2	0	0	2
13125	594756	1	1	2	0	0	3
13125	71483	1	0	1	0	0	1
13125	73244	1	1	2	1	0	4
13125	79305	1	1	0	0	0	1
18737	61729	38	1	5	1	0	7
18737	94834	32	3	2	2	2	9
18737	107876	30	0	2	0	2	4
18737	68464	29	2	3	0	1	6
18737	288126	28	1	5	1	0	7
18737	210630	22	1	7	3	0	11
18737	288133	22	2	5	0	0	7
18737	372659	19	1	6	4	0	11
18737	66585	17	2	3	1	2	8
18737	372658	16	1	3	0	0	4
18737	372679	16	0	2	1	1	4
18737	70341	15	0	0	0	2	2
18737	72923	15	0	4	0	0	4
18737	372671	14	1	0	1	0	2
18737	91743	14	1	0	1	0	2
18737	199054	13	3	0	1	0	4
18737	288136	13	2	0	1	0	3
18737	74359	13	2	0	1	0	3
18737	372696	11	1	0	3	0	4
18737	104154	10	3	2	0	1	6
18737	216995	10	3	2	0	1	6
18737	288147	10	3	2	0	1	6
18737	372720	10	3	2	0	1	6
18737	64694	10	1	4	0	0	5
18737	199828	9	1	1	1	0	3
18737	372663	9	0	1	0	0	1
18737	372668	9	1	2	0	1	4
18737	372680	9	0	3	1	0	4
18737	372689	9	0	2	0	1	3
18737	68007	9	2	1	1	0	4
18737	184969	8	0	7	0	0	7
18737	199585	8	1	0	0	0	1
18737	372669	8	2	3	0	0	5
18737	372724	8	2	1	0	0	3
18737	372731	8	0	2	0	0	2
18737	372750	8	1	0	0	1	2
18737	75434	8	1	0	0	0	1
18737	100310	7	1	1	1	0	3
18737	102973	7	0	1	0	0	1
18737	183237	7	0	1	0	0	1
18737	192359	7	0	1	0	0	1
18737	192498	7	2	1	0	1	4
18737	192582	7	2	2	0	0	4
18737	193763	7	3	2	0	0	5
18737	219008	7	1	1	0	1	3
18737	288130	7	0	1	0	0	1
18737	288134	7	0	1	0	0	1
18737	288140	7	2	1	0	0	3
18737	372660	7	0	0	0	1	1
18737	372667	7	2	5	0	0	7
18737	372721	7	1	3	0	0	4
18737	372733	7	0	1	0	1	2
18737	372736	7	0	0	0	1	1
18737	372743	7	0	1	0	0	1
18737	71227	7	0	1	0	0	1
18737	72679	7	2	1	0	0	3
18737	182731	6	0	3	0	0	3
18737	183409	6	0	0	0	0	0
18737	193297	6	3	0	0	0	3
18737	193584	6	1	1	0	0	2
18737	194155	6	1	1	0	0	2
18737	198677	6	2	3	1	2	8
18737	204992	6	2	3	0	0	5
18737	208004	6	0	2	1	0	3
18737	209325	6	2	3	0	0	5
18737	216685	6	1	0	0	0	1
18737	218784	6	1	1	0	0	2
18737	288125	6	0	1	0	0	1
18737	288128	6	1	2	1	0	4
18737	372635	6	2	1	0	0	3
18737	372670	6	2	3	0	1	6
18737	372678	6	1	1	0	0	2
18737	372707	6	1	1	0	0	2
18737	372716	6	0	0	0	0	0
18737	372730	6	2	0	0	0	2
18737	372742	6	0	2	0	0	2
18737	372752	6	0	2	0	0	2
18737	372755	6	0	1	0	0	1
18737	372759	6	1	0	0	0	1
18737	57203	6	1	2	1	0	4
18737	91877	6	0	2	0	0	2
18737	101009	5	2	1	0	1	4
18737	102808	5	0	0	0	0	0
18737	190419	5	0	2	0	1	3
18737	192188	5	0	1	0	0	1
18737	195255	5	0	1	0	1	2
18737	196084	5	2	1	0	0	3
18737	206526	5	5	2	0	0	7
18737	208934	5	1	0	0	0	1
18737	209552	5	0	0	0	1	1
18737	209678	5	0	5	1	0	6
18737	218074	5	0	0	0	0	0
18737	288129	5	0	2	0	0	2
18737	288137	5	1	1	0	0	2
18737	288146	5	2	1	0	1	4
18737	288149	5	0	3	0	0	3
18737	372655	5	0	1	0	0	1
18737	372666	5	1	0	0	0	1
18737	372672	5	3	2	0	0	5
18737	372685	5	2	2	0	0	4
18737	372690	5	1	0	0	0	1
18737	372694	5	0	1	0	0	1
18737	372703	5	3	2	0	0	5
18737	372705	5	2	1	0	0	3
18737	372714	5	1	0	0	0	1
18737	372715	5	1	0	0	1	2
18737	372723	5	0	0	0	0	0
18737	372732	5	0	1	0	2	3
18737	372737	5	0	3	0	2	5
18737	59655	5	1	1	0	0	2
18737	68734	5	0	3	0	0	3
18737	97883	5	0	2	0	0	2
18737	105846	4	1	1	0	0	2
18737	185877	4	0	1	0	0	1
18737	185916	4	0	0	0	0	0
18737	186058	4	0	3	0	0	3
18737	199242	4	2	3	0	0	5
18737	200651	4	1	1	0	0	2
18737	201222	4	2	1	0	0	3
18737	203337	4	2	0	0	0	2
18737	204432	4	2	1	0	2	5
18737	205897	4	0	1	0	0	1
18737	206070	4	0	2	0	0	2
18737	210454	4	0	0	0	1	1
18737	217355	4	0	0	0	0	0
18737	217673	4	1	0	0	0	1
18737	288144	4	1	3	2	0	6
18737	288148	4	0	0	0	0	0
18737	288150	4	1	2	0	0	3
18737	372636	4	0	3	0	0	3
18737	372638	4	1	1	0	0	2
18737	372641	4	1	2	0	1	4
18737	372644	4	0	0	0	0	0
18737	372646	4	1	1	0	1	3
18737	372648	4	2	3	1	0	6
18737	372653	4	0	1	0	0	1
18737	372664	4	0	2	0	0	2
18737	372673	4	1	2	0	0	3
18737	372674	4	1	2	0	1	4
18737	372681	4	0	1	0	0	1
18737	372683	4	1	0	0	1	2
18737	372687	4	0	1	0	1	2
18737	372692	4	1	3	0	1	5
18737	372697	4	1	2	0	0	3
18737	372699	4	2	3	0	0	5
18737	372702	4	1	0	0	0	1
18737	372712	4	1	0	0	0	1
18737	372728	4	1	1	0	0	2
18737	372735	4	0	1	0	0	1
18737	372741	4	3	2	0	0	5
18737	372747	4	1	0	0	0	1
18737	372753	4	1	0	0	0	1
18737	372757	4	1	1	0	0	2
18737	56270	4	0	0	0	0	0
18737	80549	4	1	3	2	0	6
18737	183846	3	3	0	0	0	3
18737	186971	3	0	1	0	0	1
18737	187115	3	2	0	0	0	2
18737	189062	3	1	0	0	0	1
18737	191585	3	1	1	0	0	2
18737	192413	3	0	1	0	1	2
18737	192433	3	0	0	0	0	0
18737	192791	3	0	0	0	0	0
18737	192818	3	1	1	0	0	2
18737	193870	3	1	0	0	0	1
18737	194287	3	1	1	0	0	2
18737	194312	3	1	0	0	0	1
18737	195790	3	0	0	0	0	0
18737	199859	3	0	0	0	0	0
18737	200816	3	0	0	0	0	0
18737	202017	3	0	1	0	0	1
18737	206404	3	0	0	0	0	0
18737	206643	3	1	0	0	1	2
18737	207111	3	0	0	0	0	0
18737	207589	3	2	2	0	0	4
18737	208846	3	0	0	0	0	0
18737	210435	3	2	0	0	1	3
18737	214093	3	1	1	0	0	2
18737	214371	3	1	1	0	0	2
18737	215959	3	0	0	0	0	0
18737	217393	3	1	1	0	0	2
18737	217851	3	1	0	1	0	2
18737	288135	3	2	1	0	0	3
18737	288138	3	0	0	0	0	0
18737	288139	3	0	1	0	0	1
18737	288142	3	2	0	0	0	2
18737	288145	3	1	4	0	0	5
18737	288151	3	1	1	0	0	2
18737	372637	3	0	0	0	0	0
18737	372639	3	0	1	0	0	1
18737	372640	3	1	0	1	0	2
18737	372649	3	1	1	1	2	5
18737	372656	3	1	0	0	0	1
18737	372675	3	0	1	0	0	1
18737	372684	3	0	2	0	0	2
18737	372688	3	1	3	0	0	4
18737	372704	3	1	1	0	1	3
18737	372706	3	1	0	0	0	1
18737	372708	3	2	0	0	0	2
18737	372709	3	0	0	0	0	0
18737	372713	3	1	1	0	2	4
18737	372718	3	0	0	0	2	2
18737	372719	3	0	0	0	0	0
18737	372722	3	1	2	0	0	3
18737	372727	3	1	0	1	0	2
18737	372729	3	0	0	0	0	0
18737	372738	3	1	0	0	1	2
18737	372739	3	1	0	0	0	1
18737	372740	3	1	3	0	1	5
18737	372744	3	0	0	0	0	0
18737	372746	3	1	1	0	0	2
18737	372748	3	0	0	0	0	0
18737	372749	3	1	1	0	0	2
18737	372751	3	0	0	0	0	0
18737	372758	3	1	0	0	0	1
18737	54156	3	1	4	0	0	5
18737	55145	3	1	2	3	1	7
18737	76544	3	2	0	0	0	2
18737	88956	3	2	1	0	0	3
18737	97704	3	1	1	0	0	2
18737	185612	2	0	0	0	0	0
18737	188486	2	0	0	0	1	1
18737	193306	2	0	1	0	0	1
18737	193686	2	0	1	0	0	1
18737	194515	2	0	1	0	0	1
18737	198721	2	0	1	0	0	1
18737	201211	2	0	1	0	0	1
18737	207176	2	0	0	0	0	0
18737	207479	2	0	0	0	0	0
18737	210735	2	0	0	0	0	0
18737	212350	2	2	0	0	0	2
18737	214362	2	2	0	0	0	2
18737	215701	2	0	0	0	0	0
18737	215761	2	0	0	0	1	1
18737	218607	2	0	2	0	1	3
18737	288131	2	0	0	0	0	0
18737	288132	2	0	1	0	0	1
18737	288141	2	0	0	0	0	0
18737	288143	2	0	0	0	0	0
18737	372634	2	1	1	0	0	2
18737	372642	2	2	1	3	0	6
18737	372645	2	1	2	0	0	3
18737	372647	2	1	0	0	1	2
18737	372650	2	0	0	0	1	1
18737	372651	2	1	1	0	0	2
18737	372652	2	1	3	0	0	4
18737	372654	2	0	1	0	0	1
18737	372657	2	1	1	0	0	2
18737	372661	2	2	1	0	0	3
18737	372662	2	2	2	0	0	4
18737	372682	2	0	1	0	0	1
18737	372686	2	0	4	0	0	4
18737	372691	2	0	0	0	0	0
18737	372698	2	0	0	0	0	0
18737	372700	2	0	1	0	0	1
18737	372701	2	0	1	0	0	1
18737	372710	2	0	2	0	0	2
18737	372711	2	0	1	0	0	1
18737	372717	2	2	1	0	0	3
18737	372725	2	2	0	0	0	2
18737	372726	2	0	0	0	0	0
18737	372745	2	0	1	0	0	1
18737	372754	2	0	0	0	0	0
18737	372756	2	0	1	0	0	1
18737	57675	2	1	1	0	1	3
18737	87812	2	0	1	0	0	1
18737	186272	1	0	0	0	0	0
18737	186937	1	0	0	0	0	0
18737	188948	1	0	0	0	0	0
18737	189636	1	0	0	0	0	0
18737	190080	1	0	0	0	0	0
18737	191061	1	0	0	0	0	0
18737	191244	1	1	0	0	0	1
18737	192854	1	0	1	0	0	1
18737	193977	1	0	0	0	1	1
18737	195627	1	0	0	0	0	0
18737	197887	1	0	0	0	0	0
18737	200277	1	0	0	0	0	0
18737	200296	1	0	0	0	0	0
18737	205322	1	0	2	0	0	2
18737	212448	1	1	1	0	0	2
18737	214038	1	0	1	0	0	1
18737	218818	1	0	0	0	0	0
18737	288127	1	0	1	0	0	1
18737	372631	1	0	0	0	0	0
18737	372632	1	0	0	0	0	0
18737	372633	1	1	0	0	0	1
18737	372643	1	0	1	0	1	2
18737	372665	1	0	2	0	0	2
18737	372676	1	0	0	0	1	1
18737	372677	1	0	1	0	2	3
18737	372693	1	0	1	0	0	1
18737	372695	1	1	1	0	0	2
18737	372734	1	0	4	0	0	4
18737	63464	1	0	0	0	0	0
18737	79307	1	0	1	0	0	1
18737	85181	1	1	2	0	0	3
27847	199049	42	1	1	1	0	3
27847	290503	42	1	1	1	0	3
27847	74396	41	1	1	1	0	3
27847	98390	27	3	4	2	1	10
27847	61732	25	1	3	0	0	4
27847	204773	19	1	5	1	1	8
27847	474701	18	1	0	0	1	2
27847	72952	18	1	1	0	1	3
27847	184093	15	1	0	0	0	1
27847	199527	15	1	1	2	1	5
27847	100315	14	1	0	0	0	1
27847	104165	14	3	3	0	1	7
27847	199829	14	2	0	0	0	2
27847	216991	14	3	3	0	1	7
27847	290494	14	0	2	0	0	2
27847	290513	14	3	3	0	1	7
27847	474717	14	3	3	0	1	7
27847	61774	14	0	2	0	0	2
27847	75439	14	1	1	2	1	5
27847	102809	13	1	1	0	0	2
27847	210241	13	2	3	0	1	6
27847	217391	13	2	3	0	0	5
27847	290520	13	3	1	0	1	5
27847	63490	13	1	1	0	1	3
27847	97725	13	3	1	0	1	5
27847	195018	12	0	1	1	0	2
27847	290501	12	0	2	2	0	4
27847	474664	12	0	0	0	1	1
27847	474666	12	1	0	0	1	2
27847	474738	12	4	0	2	0	6
27847	91769	12	1	0	0	1	2
27847	192689	11	1	4	0	0	5
27847	290509	11	1	4	0	0	5
27847	474624	11	2	1	0	0	3
27847	474684	11	4	5	0	1	10
27847	53053	11	1	0	0	0	1
27847	65961	11	1	4	0	0	5
27847	194115	10	1	1	0	1	3
27847	474667	10	2	1	0	0	3
27847	474683	10	7	0	0	0	7
27847	474696	10	1	0	0	0	1
27847	474722	10	1	0	0	0	1
27847	474731	10	2	2	1	1	6
27847	474673	9	2	1	0	1	4
27847	474694	9	1	4	0	0	5
27847	474736	9	0	0	0	0	0
27847	101040	8	2	0	0	0	2
27847	186059	8	2	1	0	1	4
27847	186210	8	0	2	0	1	3
27847	209313	8	1	2	0	0	3
27847	219007	8	4	1	0	2	7
27847	221424	8	1	0	0	1	2
27847	290506	8	2	0	0	0	2
27847	474648	8	0	0	0	0	0
27847	474654	8	2	3	0	2	7
27847	474665	8	0	0	0	0	0
27847	474719	8	1	2	0	1	4
27847	474741	8	2	1	0	0	3
27847	55164	8	0	1	0	0	1
27847	68010	8	4	3	0	0	7
27847	183818	7	2	0	0	0	2
27847	195167	7	5	3	1	0	9
27847	218888	7	0	0	0	1	1
27847	290496	7	0	2	0	0	2
27847	290497	7	0	1	1	1	3
27847	290514	7	3	1	0	0	4
27847	290519	7	0	1	0	0	1
27847	474649	7	1	1	0	0	2
27847	474691	7	1	0	0	0	1
27847	474700	7	1	2	0	0	3
27847	474704	7	0	1	0	0	1
27847	474711	7	2	0	0	0	2
27847	474740	7	2	2	0	0	4
27847	56299	7	3	1	0	0	4
27847	89853	7	0	1	1	3	5
27847	97917	7	0	1	1	1	3
27847	183236	6	1	0	0	0	1
27847	206947	6	3	1	0	1	5
27847	207588	6	1	1	0	1	3
27847	209730	6	3	1	0	0	4
27847	210734	6	2	0	0	0	2
27847	290502	6	1	0	0	0	1
27847	290515	6	0	1	0	0	1
27847	290516	6	0	0	1	0	1
27847	474618	6	2	1	0	0	3
27847	474631	6	1	1	0	0	2
27847	474638	6	0	2	0	2	4
27847	474669	6	1	4	0	1	6
27847	474674	6	1	0	0	0	1
27847	474685	6	2	1	0	0	3
27847	474697	6	1	1	0	0	2
27847	474712	6	1	0	0	0	1
27847	474724	6	0	2	0	0	2
27847	474729	6	1	2	0	0	3
27847	474734	6	6	3	0	1	10
27847	71235	6	1	0	0	0	1
27847	78976	6	0	1	0	0	1
27847	102981	5	0	3	0	0	3
27847	107946	5	1	0	2	0	3
27847	185451	5	0	0	0	0	0
27847	188947	5	0	1	0	0	1
27847	190418	5	0	1	0	0	1
27847	192578	5	2	1	0	0	3
27847	192790	5	0	0	0	2	2
27847	194286	5	2	2	0	0	4
27847	201208	5	2	3	0	1	6
27847	204431	5	1	0	0	1	2
27847	204995	5	0	2	0	0	2
27847	205462	5	1	1	0	1	3
27847	206525	5	1	2	0	0	3
27847	208390	5	3	4	0	0	7
27847	218783	5	2	0	0	0	2
27847	290498	5	0	3	0	0	3
27847	290510	5	1	1	0	0	2
27847	474619	5	1	0	0	0	1
27847	474622	5	1	0	1	0	2
27847	474629	5	1	1	0	1	3
27847	474636	5	1	0	0	0	1
27847	474652	5	1	1	0	0	2
27847	474653	5	2	2	0	0	4
27847	474658	5	0	1	0	1	2
27847	474662	5	4	1	0	2	7
27847	474663	5	2	1	0	3	6
27847	474676	5	3	3	0	0	6
27847	474677	5	1	1	0	1	3
27847	474678	5	1	0	0	0	1
27847	474695	5	1	0	0	0	1
27847	474709	5	1	1	0	0	2
27847	474713	5	2	0	0	0	2
27847	474715	5	1	1	0	2	4
27847	474716	5	1	0	0	0	1
27847	474721	5	3	2	0	2	7
27847	474727	5	4	0	0	0	4
27847	474735	5	3	3	0	1	7
27847	474743	5	0	0	0	0	0
27847	474744	5	1	2	0	0	3
27847	474746	5	0	1	0	1	2
27847	84003	5	2	2	0	1	5
27847	182727	4	1	0	0	0	1
27847	184499	4	1	0	0	0	1
27847	184882	4	2	1	0	0	3
27847	189637	4	1	1	0	0	2
27847	192189	4	0	1	0	0	1
27847	193583	4	1	0	0	0	1
27847	198379	4	2	0	0	0	2
27847	200652	4	0	3	0	0	3
27847	200815	4	1	0	0	0	1
27847	201221	4	1	1	0	0	2
27847	205312	4	3	1	0	2	6
27847	206069	4	1	1	0	0	2
27847	206642	4	0	1	0	0	1
27847	211985	4	0	0	0	0	0
27847	216025	4	0	0	0	0	0
27847	216669	4	0	0	0	0	0
27847	217849	4	2	2	0	0	4
27847	218817	4	1	0	0	0	1
27847	221423	4	1	0	0	0	1
27847	290504	4	1	0	0	0	1
27847	290512	4	2	1	0	0	3
27847	290518	4	0	0	0	2	2
27847	474620	4	1	1	0	0	2
27847	474627	4	2	1	1	0	4
27847	474633	4	2	3	0	0	5
27847	474639	4	1	0	0	1	2
27847	474640	4	1	0	0	0	1
27847	474655	4	1	0	0	0	1
27847	474656	4	1	1	0	0	2
27847	474680	4	1	1	0	0	2
27847	474682	4	1	0	0	1	2
27847	474688	4	3	0	0	0	3
27847	474698	4	1	1	0	0	2
27847	474705	4	0	1	0	1	2
27847	474725	4	2	1	0	0	3
27847	474726	4	1	1	0	0	2
27847	474728	4	0	1	0	2	3
27847	474730	4	0	0	0	0	0
27847	474737	4	1	0	2	0	3
27847	474739	4	0	0	0	0	0
27847	474745	4	0	0	0	0	0
27847	54185	4	2	1	0	0	3
27847	68736	4	0	0	0	2	2
27847	76658	4	1	0	0	0	1
27847	82169	4	0	1	0	0	1
27847	183843	3	1	0	0	0	1
27847	185613	3	0	1	0	0	1
27847	186271	3	3	2	0	0	5
27847	190615	3	0	1	0	0	1
27847	192817	3	2	2	0	0	4
27847	193305	3	1	0	0	0	1
27847	194250	3	1	0	0	0	1
27847	197886	3	0	1	0	0	1
27847	200399	3	1	3	0	0	4
27847	201213	3	2	1	0	0	3
27847	201275	3	1	0	0	0	1
27847	203336	3	1	1	0	0	2
27847	205895	3	2	0	0	0	2
27847	207267	3	1	0	0	0	1
27847	207998	3	1	1	0	0	2
27847	211883	3	1	0	0	0	1
27847	214142	3	1	0	0	0	1
27847	215698	3	1	0	0	2	3
27847	215759	3	2	0	0	0	2
27847	290495	3	1	0	0	0	1
27847	290499	3	0	1	0	0	1
27847	290511	3	1	0	0	0	1
27847	474628	3	1	1	1	0	3
27847	474632	3	1	0	0	0	1
27847	474635	3	0	1	1	0	2
27847	474637	3	1	1	0	0	2
27847	474641	3	1	1	0	0	2
27847	474643	3	0	0	0	0	0
27847	474646	3	0	1	0	1	2
27847	474650	3	0	1	0	0	1
27847	474651	3	0	0	0	0	0
27847	474657	3	0	0	0	0	0
27847	474659	3	0	1	1	0	2
27847	474668	3	1	0	0	0	1
27847	474671	3	2	0	0	0	2
27847	474672	3	0	3	0	0	3
27847	474681	3	1	0	0	2	3
27847	474687	3	0	1	0	0	1
27847	474689	3	0	0	0	0	0
27847	474690	3	0	0	0	1	1
27847	474699	3	3	4	0	0	7
27847	474703	3	1	0	0	0	1
27847	474706	3	1	1	0	0	2
27847	474707	3	3	0	0	0	3
27847	474708	3	2	1	0	2	5
27847	474710	3	0	0	1	0	1
27847	474714	3	1	0	0	0	1
27847	474720	3	1	0	0	0	1
27847	474733	3	0	1	0	0	1
27847	57676	3	1	1	0	0	2
27847	70164	3	1	0	0	0	1
27847	79313	3	1	0	0	0	1
27847	84412	3	0	1	0	0	1
27847	186941	2	0	0	0	1	1
27847	188484	2	1	0	0	0	1
27847	191050	2	1	0	0	0	1
27847	192414	2	1	2	0	0	3
27847	192853	2	1	0	0	0	1
27847	193685	2	1	0	0	0	1
27847	194304	2	0	1	0	0	1
27847	205009	2	1	0	0	0	1
27847	207110	2	0	0	0	0	0
27847	212449	2	0	0	0	0	0
27847	214326	2	2	1	0	0	3
27847	214364	2	0	1	0	0	1
27847	214370	2	3	1	0	0	4
27847	217354	2	0	0	0	0	0
27847	290500	2	0	0	0	1	1
27847	290505	2	0	0	0	0	0
27847	290508	2	1	0	0	0	1
27847	290517	2	0	0	0	0	0
27847	474617	2	0	1	0	0	1
27847	474621	2	1	1	0	0	2
27847	474623	2	1	0	0	0	1
27847	474625	2	0	2	0	0	2
27847	474626	2	1	1	1	0	3
27847	474630	2	1	1	0	0	2
27847	474642	2	1	0	0	1	2
27847	474647	2	0	0	0	0	0
27847	474661	2	0	2	0	0	2
27847	474679	2	1	2	0	0	3
27847	474686	2	0	1	0	0	1
27847	474692	2	0	1	0	0	1
27847	474693	2	1	0	0	0	1
27847	474702	2	0	0	0	0	0
27847	474718	2	1	0	0	0	1
27847	474723	2	0	0	0	0	0
27847	474732	2	1	0	0	0	1
27847	474742	2	2	1	0	0	3
27847	79595	2	0	0	0	0	0
27847	87817	2	0	0	0	1	1
27847	98496	2	0	0	0	0	0
27847	185582	1	0	0	0	0	0
27847	186970	1	1	1	0	0	2
27847	190079	1	0	0	0	0	0
27847	191241	1	0	0	0	0	0
27847	193976	1	0	0	0	0	0
27847	203112	1	0	0	0	0	0
27847	207175	1	2	0	0	0	2
27847	207477	1	0	0	0	0	0
27847	216519	1	0	0	0	0	0
27847	290507	1	3	0	0	0	3
27847	474634	1	0	1	0	1	2
27847	474644	1	0	0	0	0	0
27847	474645	1	1	0	0	0	1
27847	474660	1	2	3	1	0	6
27847	474670	1	0	0	0	0	0
27847	474675	1	0	0	0	0	0
27847	474747	1	1	0	0	2	3
27847	85183	1	1	2	1	0	4
52900	92672	41	12	1	6	10	29
52900	495998	33	6	2	1	4	13
52900	55199	31	9	3	3	1	16
52900	496058	29	1	3	0	4	8
52900	63879	29	4	2	0	3	9
52900	297179	27	5	3	2	8	18
52900	99813	27	5	3	2	8	18
52900	85702	26	5	5	4	3	17
52900	496115	22	2	1	2	3	8
52900	62852	21	4	4	1	2	11
52900	103929	20	0	1	0	2	3
52900	187389	20	2	2	0	1	5
52900	69146	20	2	2	0	1	5
52900	73025	20	1	2	0	0	3
52900	297162	19	3	2	1	11	17
52900	56117	19	3	2	1	11	17
52900	297178	18	2	0	1	4	7
52900	204754	17	1	1	0	3	5
52900	297158	17	4	1	4	1	10
52900	297164	17	1	1	0	3	5
52900	496119	17	1	1	0	3	5
52900	88651	17	1	1	0	3	5
52900	91548	17	4	1	4	1	10
52900	84026	16	2	0	2	1	5
52900	88355	16	3	0	1	5	9
52900	297168	15	1	2	0	2	5
52900	297173	15	4	2	0	1	7
52900	495915	15	3	2	0	3	8
52900	496066	15	3	1	4	1	9
52900	496113	15	3	0	1	5	9
52900	297169	14	3	1	0	2	6
52900	297166	13	1	1	0	5	7
52900	496040	13	2	1	0	0	3
52900	73258	13	2	0	1	3	6
52900	297174	12	1	2	0	2	5
52900	49441	12	1	2	0	2	5
52900	496116	12	3	0	0	0	3
52900	65347	12	0	0	0	2	2
52900	68645	12	4	2	2	1	9
52900	297175	11	7	0	0	1	8
52900	495971	11	2	0	0	5	7
52900	495992	11	3	0	0	1	4
52900	496050	11	3	2	0	1	6
52900	496117	11	4	0	0	2	6
52900	56010	11	7	0	0	1	8
52900	67680	11	2	4	0	3	9
52900	68996	11	1	2	0	1	4
52900	70467	11	2	1	0	0	3
52900	496062	10	1	0	0	2	3
52900	197336	9	1	3	1	1	6
52900	297160	9	1	3	1	1	6
52900	297161	9	1	3	1	1	6
52900	495977	9	1	2	0	0	3
52900	496051	9	3	1	0	0	4
52900	72759	9	1	3	1	1	6
52900	72846	9	1	3	1	1	6
52900	191823	8	4	0	0	2	6
52900	297170	8	4	0	0	2	6
52900	495926	8	1	1	0	1	3
52900	496013	8	2	0	0	0	2
52900	496033	8	0	2	0	6	8
52900	496087	8	2	2	1	2	7
52900	496096	8	4	0	2	1	7
52900	60962	8	2	2	0	3	7
52900	64576	8	4	0	0	2	6
52900	92811	8	1	2	0	4	7
52900	189213	7	0	0	0	1	1
52900	495923	7	4	0	1	1	6
52900	496053	7	1	0	0	2	3
52900	50293	7	2	1	0	1	4
52900	78531	7	3	3	0	2	8
52900	106174	6	1	0	2	0	3
52900	219356	6	1	0	2	0	3
52900	495907	6	1	0	0	0	1
52900	495933	6	1	0	1	2	4
52900	495986	6	0	0	0	0	0
52900	496000	6	0	1	0	0	1
52900	496088	6	3	0	0	0	3
52900	496098	6	1	5	0	1	7
52900	496104	6	2	2	0	0	4
52900	496106	6	0	2	0	1	3
52900	496108	6	3	1	1	2	7
52900	183384	5	0	0	0	2	2
52900	187913	5	1	0	0	0	1
52900	297157	5	2	0	0	1	3
52900	495909	5	0	1	0	1	2
52900	495970	5	2	2	0	2	6
52900	495974	5	0	0	0	1	1
52900	495996	5	2	0	0	0	2
52900	496002	5	0	0	0	2	2
52900	496004	5	2	1	0	0	3
52900	496016	5	0	1	0	1	2
52900	496023	5	2	0	0	2	4
52900	496041	5	3	3	0	0	6
52900	496049	5	1	2	0	1	4
52900	496064	5	2	0	0	4	6
52900	496068	5	0	0	0	2	2
52900	496076	5	2	2	0	1	5
52900	496083	5	1	1	0	1	3
52900	496097	5	4	1	0	0	5
52900	496114	5	1	3	0	2	6
52900	496118	5	0	0	1	3	4
52900	74677	5	0	0	0	1	1
52900	77916	5	2	0	0	1	3
52900	194937	4	2	1	0	0	3
52900	495919	4	3	1	0	0	4
52900	495937	4	5	1	1	1	8
52900	495939	4	0	0	0	0	0
52900	495954	4	0	0	0	0	0
52900	495959	4	2	0	0	1	3
52900	495972	4	1	2	0	1	4
52900	495982	4	0	0	1	0	1
52900	496010	4	1	0	1	3	5
52900	496011	4	1	1	0	2	4
52900	496028	4	0	0	0	1	1
52900	496030	4	0	0	0	1	1
52900	496037	4	4	1	0	2	7
52900	496047	4	0	2	0	1	3
52900	496059	4	1	1	0	2	4
52900	496071	4	1	3	0	1	5
52900	496073	4	1	0	1	1	3
52900	496075	4	5	2	0	0	7
52900	496078	4	3	0	0	0	3
52900	496085	4	1	0	0	1	2
52900	496086	4	0	1	0	1	2
52900	496089	4	2	0	0	2	4
52900	496090	4	2	0	0	4	6
52900	496093	4	0	0	0	0	0
52900	496094	4	3	0	0	0	3
52900	496095	4	3	0	0	2	5
52900	496103	4	2	0	0	0	2
52900	496107	4	1	1	0	1	3
52900	496109	4	2	2	0	1	5
52900	496111	4	2	0	0	0	2
52900	496112	4	0	1	0	0	1
52900	83924	4	4	1	0	2	7
52900	92473	4	0	0	0	1	1
52900	193622	3	0	2	0	1	3
52900	297159	3	0	1	0	1	2
52900	297180	3	1	0	0	0	1
52900	391415	3	1	1	0	1	3
52900	495904	3	3	0	1	0	4
52900	495912	3	1	0	0	0	1
52900	495913	3	1	1	0	0	2
52900	495920	3	0	1	0	1	2
52900	495921	3	1	1	0	0	2
52900	495929	3	3	0	0	0	3
52900	495932	3	3	2	1	1	7
52900	495935	3	1	0	1	1	3
52900	495942	3	1	1	0	1	3
52900	495943	3	0	0	0	1	1
52900	495951	3	1	0	0	1	2
52900	495953	3	0	3	0	0	3
52900	495956	3	2	2	0	0	4
52900	495976	3	0	1	0	1	2
52900	495978	3	0	0	0	1	1
52900	495981	3	2	0	0	1	3
52900	495987	3	1	1	0	1	3
52900	495989	3	1	0	0	1	2
52900	495993	3	2	0	1	0	3
52900	495997	3	1	0	0	1	2
52900	495999	3	1	0	1	1	3
52900	496001	3	0	1	0	0	1
52900	496005	3	1	0	0	1	2
52900	496012	3	4	0	0	0	4
52900	496024	3	1	1	0	0	2
52900	496031	3	0	0	0	1	1
52900	496038	3	0	0	0	0	0
52900	496043	3	2	1	0	0	3
52900	496052	3	1	0	1	1	3
52900	496054	3	0	0	0	2	2
52900	496055	3	1	2	0	5	8
52900	496074	3	2	0	0	1	3
52900	496079	3	0	3	0	1	4
52900	496080	3	1	2	0	3	6
52900	496081	3	4	1	0	3	8
52900	496084	3	2	0	0	0	2
52900	496099	3	3	0	1	2	6
52900	496100	3	2	0	1	2	5
52900	496102	3	0	0	0	0	0
52900	496110	3	3	0	1	0	4
52900	182000	2	3	0	0	0	3
52900	391440	2	1	1	0	1	3
52900	495900	2	2	0	0	0	2
52900	495905	2	3	1	0	0	4
52900	495918	2	1	0	0	0	1
52900	495922	2	2	1	1	2	6
52900	495925	2	0	0	0	0	0
52900	495928	2	1	0	0	2	3
52900	495936	2	0	1	0	0	1
52900	495940	2	0	0	0	1	1
52900	495949	2	2	2	0	0	4
52900	495952	2	0	0	0	0	0
52900	495963	2	0	1	0	1	2
52900	495967	2	1	1	0	1	3
52900	495968	2	2	0	0	0	2
52900	495969	2	1	0	0	1	2
52900	495979	2	1	0	0	0	1
52900	495984	2	1	1	0	0	2
52900	495985	2	1	1	0	0	2
52900	495990	2	0	1	0	0	1
52900	495991	2	2	0	0	0	2
52900	495995	2	1	1	0	0	2
52900	496007	2	1	0	0	0	1
52900	496008	2	2	0	1	1	4
52900	496009	2	0	0	0	0	0
52900	496014	2	0	0	0	2	2
52900	496015	2	0	0	0	2	2
52900	496017	2	0	0	0	0	0
52900	496020	2	0	2	0	0	2
52900	496025	2	0	0	0	0	0
52900	496026	2	1	0	0	1	2
52900	496032	2	1	0	0	0	1
52900	496039	2	0	0	0	0	0
52900	496045	2	1	0	1	0	2
52900	496046	2	3	0	0	0	3
52900	496056	2	1	1	0	3	5
52900	496060	2	1	0	0	1	2
52900	496063	2	0	0	0	1	1
52900	496065	2	0	0	0	0	0
52900	496069	2	0	0	0	0	0
52900	496070	2	2	0	0	0	2
52900	496072	2	1	0	0	0	1
52900	496077	2	0	1	0	1	2
52900	496091	2	2	0	0	0	2
52900	496101	2	1	0	0	0	1
52900	496105	2	1	0	0	0	1
52900	196129	1	1	1	0	0	2
52900	205937	1	0	0	0	0	0
52900	208677	1	0	0	0	0	0
52900	391414	1	0	0	0	0	0
52900	391435	1	0	0	0	0	0
52900	495901	1	0	0	0	0	0
52900	495902	1	2	0	0	0	2
52900	495903	1	2	0	0	0	2
52900	495906	1	0	0	0	1	1
52900	495908	1	2	0	0	0	2
52900	495910	1	0	0	0	0	0
52900	495911	1	0	0	0	1	1
52900	495914	1	2	1	0	0	3
52900	495916	1	0	1	0	1	2
52900	495917	1	1	1	0	1	3
52900	495924	1	0	0	0	0	0
52900	495927	1	1	0	0	0	1
52900	495930	1	0	0	0	0	0
52900	495931	1	1	0	0	0	1
52900	495934	1	0	0	0	0	0
52900	495938	1	0	0	0	1	1
52900	495941	1	0	0	0	0	0
52900	495944	1	0	0	0	0	0
52900	495945	1	1	0	0	0	1
52900	495946	1	1	0	0	0	1
52900	495947	1	0	1	0	1	2
52900	495948	1	1	1	0	1	3
52900	495950	1	0	0	0	2	2
52900	495955	1	0	0	0	0	0
52900	495957	1	0	1	0	0	1
52900	495958	1	1	0	0	0	1
52900	495960	1	0	0	0	1	1
52900	495961	1	1	0	0	0	1
52900	495962	1	0	0	0	0	0
52900	495964	1	1	0	0	0	1
52900	495965	1	0	0	0	2	2
52900	495966	1	1	0	0	0	1
52900	495973	1	0	0	0	1	1
52900	495975	1	0	0	0	1	1
52900	495980	1	0	1	0	1	2
52900	495983	1	1	0	0	0	1
52900	495988	1	0	0	0	0	0
52900	495994	1	0	0	0	1	1
52900	496003	1	0	0	0	1	1
52900	496006	1	1	0	0	0	1
52900	496018	1	0	0	0	1	1
52900	496019	1	1	0	0	0	1
52900	496021	1	0	0	0	0	0
52900	496022	1	0	0	0	0	0
52900	496027	1	0	0	0	2	2
52900	496029	1	0	0	0	1	1
52900	496034	1	0	0	0	0	0
52900	496035	1	0	1	0	1	2
52900	496036	1	2	0	0	0	2
52900	496042	1	1	0	0	0	1
52900	496044	1	1	0	0	2	3
52900	496048	1	1	0	0	0	1
52900	496057	1	0	1	0	1	2
52900	496061	1	1	0	0	0	1
52900	496067	1	1	1	0	1	3
52900	496082	1	0	1	0	3	4
52900	496092	1	0	0	0	0	0
75597	556997	26	1	0	0	0	1
75597	557026	26	2	1	1	1	5
75597	557102	21	0	3	2	0	5
75597	556923	20	2	0	3	1	6
75597	557052	20	2	0	0	0	2
75597	557024	19	1	0	2	0	3
75597	557080	17	1	1	0	0	2
75597	556963	16	0	0	0	0	0
75597	557117	16	0	1	0	2	3
75597	556945	15	0	0	1	1	2
75597	557029	15	2	0	0	1	3
75597	557051	14	2	1	0	0	3
75597	556919	13	2	1	1	0	4
75597	556995	13	0	0	0	0	0
75597	556889	12	1	0	3	1	5
75597	556935	12	1	0	0	0	1
75597	557040	12	0	0	0	1	1
75597	557078	12	1	0	1	1	3
75597	557096	12	0	0	0	2	2
75597	557115	12	1	0	1	2	4
75597	557118	12	3	0	0	0	3
75597	556937	11	0	0	0	0	0
75597	556941	11	1	0	0	1	2
75597	556959	11	1	0	1	1	3
75597	557005	11	1	0	0	2	3
75597	557111	11	1	0	1	3	5
75597	557121	11	3	0	2	2	7
75597	556944	10	1	0	0	1	2
75597	556968	10	3	2	0	0	5
75597	557076	10	1	0	1	1	3
75597	557087	10	3	0	1	0	4
75597	557090	10	0	0	0	0	0
75597	557120	10	0	0	0	1	1
75597	557138	10	3	0	1	1	5
75597	556895	9	5	0	1	1	7
75597	556922	9	0	0	0	0	0
75597	556947	9	1	1	1	0	3
75597	557008	9	2	0	0	0	2
75597	557022	9	1	2	1	0	4
75597	557032	9	0	0	1	1	2
75597	557095	9	3	0	1	0	4
75597	557130	9	0	0	0	0	0
75597	556879	8	0	0	0	0	0
75597	556885	8	1	0	0	0	1
75597	556900	8	0	0	0	0	0
75597	556909	8	3	0	2	0	5
75597	556940	8	0	0	0	0	0
75597	556950	8	2	1	2	0	5
75597	556996	8	0	0	1	0	1
75597	557041	8	3	0	1	0	4
75597	557055	8	0	0	0	0	0
75597	557067	8	0	0	0	0	0
75597	557089	8	1	0	0	0	1
75597	557114	8	0	0	0	0	0
75597	556887	7	0	0	1	1	2
75597	556915	7	1	0	0	1	2
75597	556924	7	1	0	0	0	1
75597	556958	7	0	0	0	0	0
75597	556966	7	2	0	0	0	2
75597	556967	7	1	0	0	0	1
75597	556969	7	0	0	1	0	1
75597	556992	7	0	0	0	0	0
75597	557001	7	3	0	0	0	3
75597	557002	7	0	1	0	0	1
75597	557004	7	1	0	0	0	1
75597	557037	7	1	4	2	0	7
75597	557058	7	0	0	1	0	1
75597	557099	7	0	0	0	0	0
75597	557106	7	1	0	0	0	1
75597	557129	7	2	0	0	0	2
75597	557131	7	1	0	1	1	3
75597	556888	6	1	0	1	1	3
75597	556894	6	2	0	0	1	3
75597	556920	6	0	0	1	0	1
75597	556927	6	1	0	0	0	1
75597	556952	6	1	0	0	0	1
75597	556974	6	2	0	1	1	4
75597	556975	6	2	0	1	0	3
75597	556998	6	0	0	0	0	0
75597	557009	6	0	0	0	0	0
75597	557013	6	0	0	0	0	0
75597	557047	6	2	0	2	0	4
75597	557049	6	0	0	0	0	0
75597	557057	6	0	1	0	1	2
75597	557075	6	1	0	0	1	2
75597	557112	6	1	0	1	0	2
75597	557113	6	0	0	0	0	0
75597	557123	6	0	0	0	0	0
75597	557127	6	1	0	0	0	1
75597	557140	6	1	0	0	0	1
75597	205072	5	0	0	0	0	0
75597	556877	5	1	0	1	0	2
75597	556891	5	1	0	0	2	3
75597	556902	5	0	0	1	1	2
75597	556904	5	1	1	0	0	2
75597	556913	5	0	0	0	0	0
75597	556916	5	0	0	0	0	0
75597	556936	5	0	0	0	0	0
75597	556939	5	3	0	0	0	3
75597	556943	5	1	1	0	0	2
75597	556948	5	1	0	0	0	1
75597	556951	5	0	0	0	1	1
75597	556993	5	0	0	1	1	2
75597	556999	5	2	0	0	1	3
75597	557003	5	0	2	0	0	2
75597	557011	5	0	0	0	0	0
75597	557016	5	0	0	0	0	0
75597	557028	5	1	0	0	1	2
75597	557034	5	3	0	2	1	6
75597	557061	5	0	0	0	1	1
75597	557065	5	1	1	0	0	2
75597	557066	5	1	0	0	0	1
75597	557072	5	4	0	0	0	4
75597	557086	5	1	0	0	1	2
75597	557091	5	0	0	0	0	0
75597	557092	5	1	0	0	0	1
75597	557097	5	0	0	0	0	0
75597	557101	5	0	0	0	0	0
75597	557116	5	0	0	0	1	1
75597	281878	4	0	0	0	0	0
75597	556870	4	1	0	2	1	4
75597	556872	4	0	2	0	1	3
75597	556876	4	0	0	0	0	0
75597	556880	4	0	0	0	0	0
75597	556883	4	1	1	2	2	6
75597	556892	4	0	2	0	0	2
75597	556893	4	3	1	0	2	6
75597	556901	4	0	0	0	0	0
75597	556903	4	0	0	0	0	0
75597	556906	4	2	0	0	0	2
75597	556917	4	2	0	1	0	3
75597	556918	4	0	0	0	0	0
75597	556921	4	0	0	0	0	0
75597	556979	4	0	0	0	0	0
75597	556994	4	0	0	0	0	0
75597	557015	4	0	1	0	3	4
75597	557018	4	1	0	1	1	3
75597	557025	4	1	1	0	0	2
75597	557027	4	0	0	0	0	0
75597	557031	4	1	0	0	0	1
75597	557036	4	1	0	0	0	1
75597	557039	4	2	0	0	0	2
75597	557042	4	1	1	0	1	3
75597	557046	4	0	0	0	0	0
75597	557048	4	2	0	0	0	2
75597	557050	4	0	0	0	0	0
75597	557054	4	0	0	0	0	0
75597	557062	4	0	0	0	0	0
75597	557063	4	0	0	0	1	1
75597	557079	4	1	0	0	0	1
75597	557081	4	0	0	0	0	0
75597	557088	4	0	1	0	0	1
75597	557098	4	1	1	1	0	3
75597	557107	4	0	0	0	0	0
75597	557109	4	0	0	0	0	0
75597	557119	4	3	1	1	0	5
75597	557125	4	1	0	0	0	1
75597	557126	4	0	1	0	1	2
75597	557133	4	1	0	0	0	1
75597	557134	4	1	0	0	0	1
75597	557137	4	0	0	0	0	0
75597	557139	4	0	1	0	0	1
75597	281879	3	0	1	0	0	1
75597	556863	3	1	0	1	0	2
75597	556865	3	1	0	0	0	1
75597	556868	3	1	0	1	0	2
75597	556869	3	0	0	1	1	2
75597	556874	3	1	0	0	0	1
75597	556878	3	1	0	0	0	1
75597	556881	3	1	0	0	0	1
75597	556897	3	1	0	0	0	1
75597	556898	3	1	1	0	0	2
75597	556899	3	1	0	1	0	2
75597	556930	3	0	0	0	0	0
75597	556931	3	0	0	1	1	2
75597	556932	3	0	0	1	0	1
75597	556949	3	0	0	0	0	0
75597	556953	3	1	0	1	1	3
75597	556955	3	0	0	0	0	0
75597	556956	3	0	2	0	0	2
75597	556960	3	0	0	1	0	1
75597	556961	3	0	0	0	0	0
75597	556972	3	0	0	0	0	0
75597	556973	3	0	0	0	0	0
75597	556976	3	1	0	0	1	2
75597	556978	3	0	0	1	0	1
75597	556985	3	0	0	0	0	0
75597	556986	3	0	0	0	0	0
75597	556988	3	1	0	0	0	1
75597	556989	3	1	0	0	0	1
75597	556990	3	0	0	0	0	0
75597	557033	3	2	0	0	0	2
75597	557038	3	2	0	2	1	5
75597	557045	3	0	0	2	1	3
75597	557056	3	0	0	0	0	0
75597	557059	3	0	0	0	0	0
75597	557060	3	0	0	0	0	0
75597	557068	3	1	0	0	0	1
75597	557074	3	0	0	0	0	0
75597	557083	3	2	0	0	1	3
75597	557085	3	2	0	0	0	2
75597	557093	3	1	1	1	1	4
75597	557103	3	1	0	0	0	1
75597	557108	3	0	0	0	0	0
75597	557122	3	0	0	0	1	1
75597	557128	3	0	0	0	0	0
75597	557136	3	3	1	0	0	4
75597	556859	2	0	0	0	0	0
75597	556864	2	1	0	0	0	1
75597	556867	2	0	0	0	0	0
75597	556873	2	0	0	1	0	1
75597	556875	2	0	0	0	0	0
75597	556882	2	0	0	0	0	0
75597	556890	2	1	0	0	0	1
75597	556896	2	1	0	0	0	1
75597	556905	2	1	0	0	1	2
75597	556907	2	0	0	0	0	0
75597	556910	2	0	0	0	1	1
75597	556911	2	0	0	0	0	0
75597	556912	2	2	0	0	0	2
75597	556926	2	1	1	0	0	2
75597	556938	2	0	0	0	0	0
75597	556942	2	0	0	0	0	0
75597	556954	2	0	0	1	0	1
75597	556957	2	0	0	0	0	0
75597	556965	2	0	0	0	0	0
75597	556977	2	0	1	0	0	1
75597	556980	2	1	0	0	0	1
75597	556983	2	0	0	0	0	0
75597	556984	2	0	0	0	0	0
75597	556987	2	1	0	0	0	1
75597	556991	2	1	0	1	0	2
75597	557006	2	0	0	0	0	0
75597	557007	2	0	0	0	0	0
75597	557010	2	0	0	0	0	0
75597	557014	2	0	0	0	0	0
75597	557017	2	1	0	0	0	1
75597	557019	2	1	0	0	0	1
75597	557020	2	0	0	0	0	0
75597	557021	2	0	0	0	0	0
75597	557030	2	0	0	0	0	0
75597	557043	2	1	1	1	0	3
75597	557053	2	0	0	1	0	1
75597	557064	2	0	0	0	0	0
75597	557069	2	0	0	0	1	1
75597	557070	2	0	0	0	1	1
75597	557073	2	1	0	0	0	1
75597	557077	2	0	1	0	0	1
75597	557082	2	0	0	0	1	1
75597	557100	2	0	0	0	0	0
75597	557104	2	0	0	0	0	0
75597	557105	2	0	0	0	0	0
75597	557124	2	0	0	0	1	1
75597	557132	2	0	0	1	0	1
75597	557135	2	0	1	1	0	2
75597	556860	1	0	0	0	0	0
75597	556861	1	0	0	0	0	0
75597	556862	1	0	0	0	0	0
75597	556866	1	0	0	0	0	0
75597	556871	1	0	0	1	0	1
75597	556884	1	1	0	0	0	1
75597	556886	1	2	0	0	0	2
75597	556908	1	0	0	0	1	1
75597	556914	1	0	0	1	0	1
75597	556925	1	0	0	0	0	0
75597	556928	1	0	0	0	0	0
75597	556929	1	0	0	0	0	0
75597	556933	1	0	0	0	0	0
75597	556934	1	0	0	0	0	0
75597	556946	1	0	0	1	0	1
75597	556962	1	0	0	0	0	0
75597	556964	1	0	0	0	1	1
75597	556970	1	0	0	0	0	0
75597	556971	1	0	0	0	0	0
75597	556981	1	0	0	1	0	1
75597	556982	1	0	0	0	0	0
75597	557000	1	0	0	0	0	0
75597	557023	1	1	0	0	1	2
75597	557035	1	1	0	0	0	1
75597	557044	1	1	0	0	0	1
75597	557071	1	0	0	0	0	0
75597	557084	1	0	0	0	0	0
75597	557094	1	0	0	0	0	0
75597	557110	1	0	0	0	0	0
36941	293083	80	8	7	0	10	25
36941	96026	62	8	9	6	4	27
36941	293081	47	5	5	3	5	18
36941	473763	47	0	5	0	0	5
36941	83211	47	0	5	0	0	5
36941	85016	38	7	3	2	1	13
36941	99963	37	3	3	0	2	8
36941	213669	35	1	5	2	3	11
36941	473790	35	2	0	2	4	8
36941	99060	35	1	5	2	3	11
36941	473785	34	6	5	3	4	18
36941	187459	33	2	4	5	3	14
36941	293082	33	3	2	0	3	8
36941	69114	33	2	4	5	3	14
36941	80775	32	3	2	0	3	8
36941	195873	31	4	3	0	1	8
36941	473795	29	4	3	0	1	8
36941	91465	29	3	0	0	4	7
36941	107659	27	1	0	2	4	7
36941	63333	27	2	5	0	1	8
36941	181954	26	8	6	2	3	19
36941	220456	26	1	0	2	4	7
36941	473739	26	2	5	0	1	8
36941	49417	26	8	6	2	3	19
36941	187564	24	1	3	1	2	7
36941	189988	24	1	3	1	2	7
36941	473746	24	6	5	2	3	16
36941	473762	24	1	3	1	2	7
36941	58200	24	5	2	0	1	8
36941	107024	23	1	1	2	2	6
36941	220930	23	1	1	2	2	6
36941	293069	23	2	1	1	1	5
36941	473792	23	1	1	2	2	6
36941	58869	23	1	3	1	2	7
36941	80259	23	2	1	1	1	5
36941	473789	22	1	3	1	2	7
36941	70009	22	2	1	0	1	4
36941	200970	21	0	8	1	1	10
36941	473791	21	4	8	0	5	17
36941	91796	21	4	8	0	5	17
36941	63040	20	1	4	1	1	7
36941	71858	20	0	4	0	1	5
36941	75887	20	0	3	0	0	3
36941	75888	20	0	3	0	0	3
36941	473796	19	2	2	0	2	6
36941	84018	19	4	5	4	2	15
36941	107534	18	2	8	1	3	14
36941	195365	18	0	1	0	0	1
36941	473765	17	1	2	0	1	4
36941	473793	17	3	2	0	3	8
36941	293065	16	3	1	0	0	4
36941	473695	16	6	7	3	3	19
36941	66716	16	2	1	1	2	6
36941	92925	16	0	2	0	0	2
36941	103537	15	0	1	0	1	2
36941	104405	15	5	4	0	2	11
36941	217304	15	5	4	0	2	11
36941	473767	15	0	5	0	0	5
36941	473794	15	5	4	0	2	11
36941	56946	15	3	1	0	0	4
36941	100706	14	2	1	1	1	5
36941	109001	14	1	4	0	1	6
36941	293068	14	6	0	1	2	9
36941	293071	14	2	1	1	1	5
36941	473764	14	2	1	1	1	5
36941	473773	14	0	3	0	2	5
36941	473784	14	2	7	1	3	13
36941	65157	14	6	0	1	2	9
36941	75678	14	1	4	0	1	6
36941	473779	13	1	1	0	0	2
36941	473781	13	2	1	0	0	3
36941	61536	13	0	3	1	1	5
36941	89189	13	4	2	1	0	7
36941	293075	12	1	2	0	1	4
36941	473705	12	2	3	0	0	5
36941	473759	12	1	1	0	1	3
36941	53873	12	1	2	0	1	4
36941	68011	12	0	1	0	1	2
36941	473676	11	0	0	0	0	0
36941	473770	11	2	5	0	2	9
36941	53385	11	2	5	0	2	9
36941	293074	10	1	1	1	2	5
36941	473664	10	1	4	0	0	5
36941	55637	10	4	1	0	2	7
36941	56327	10	3	0	1	0	4
36941	63309	10	1	1	1	2	5
36941	106040	9	1	2	0	0	3
36941	219513	9	1	2	0	0	3
36941	473728	9	0	0	0	0	0
36941	473752	9	0	0	0	0	0
36941	57469	9	2	3	0	1	6
36941	92781	9	0	5	1	2	8
36941	188583	8	1	4	0	1	6
36941	293079	8	1	4	0	1	6
36941	473663	8	0	2	1	1	4
36941	473699	8	0	3	0	1	4
36941	473716	8	1	3	0	0	4
36941	50017	8	1	0	1	0	2
36941	59847	8	1	4	0	1	6
36941	67753	8	1	3	0	0	4
36941	68987	8	1	1	1	0	3
36941	89670	8	1	1	0	0	2
36941	90104	8	2	1	0	2	5
36941	96667	8	1	2	0	1	4
36941	102588	7	1	3	1	1	6
36941	103631	7	1	0	1	2	4
36941	191852	7	0	1	1	0	2
36941	193377	7	1	0	0	0	1
36941	293080	7	0	1	1	0	2
36941	473690	7	1	0	0	2	3
36941	473696	7	1	0	0	0	1
36941	473734	7	3	0	0	3	6
36941	473787	7	4	1	0	2	7
36941	53145	7	3	2	1	1	7
36941	64470	7	0	1	1	0	2
36941	77144	7	0	2	0	0	2
36941	85295	7	1	2	0	0	3
36941	89593	7	1	0	0	0	1
36941	97951	7	1	0	1	1	3
36941	202203	6	1	0	0	1	2
36941	293072	6	0	5	0	0	5
36941	473684	6	0	2	0	0	2
36941	473686	6	1	0	0	2	3
36941	473689	6	2	3	3	0	8
36941	473711	6	0	2	0	1	3
36941	473783	6	4	2	1	1	8
36941	53602	6	1	1	1	0	3
36941	85623	6	0	5	0	0	5
36941	86298	6	1	1	1	0	3
36941	99848	6	0	0	0	1	1
36941	184532	5	0	1	0	0	1
36941	207154	5	0	1	0	0	1
36941	217971	5	0	1	0	1	2
36941	293066	5	1	2	0	3	6
36941	293067	5	0	0	0	0	0
36941	473668	5	1	0	0	0	1
36941	473692	5	0	3	0	1	4
36941	473698	5	1	1	1	1	4
36941	473701	5	1	1	1	1	4
36941	473709	5	1	1	4	0	6
36941	473712	5	1	1	0	1	3
36941	473713	5	1	2	0	0	3
36941	473715	5	0	0	0	0	0
36941	473740	5	2	0	0	0	2
36941	473750	5	2	1	0	0	3
36941	473768	5	1	0	0	0	1
36941	473782	5	0	3	1	1	5
36941	67894	5	1	3	0	0	4
36941	79362	5	0	5	1	0	6
36941	80151	5	0	0	0	0	0
36941	85835	5	1	2	0	1	4
36941	88138	5	1	2	0	1	4
36941	90290	5	0	3	1	0	4
36941	96398	5	0	1	0	1	2
36941	97163	5	0	2	0	1	3
36941	98958	5	0	1	1	0	2
36941	99197	5	0	1	0	0	1
36941	106577	4	0	1	0	0	1
36941	107745	4	1	0	0	0	1
36941	107954	4	1	1	0	1	3
36941	293073	4	0	2	0	1	3
36941	293078	4	0	1	0	1	2
36941	473665	4	1	2	0	2	5
36941	473678	4	1	0	0	1	2
36941	473679	4	0	2	0	0	2
36941	473681	4	0	1	1	1	3
36941	473682	4	1	0	0	0	1
36941	473693	4	1	1	0	1	3
36941	473714	4	0	1	0	0	1
36941	473717	4	1	0	1	0	2
36941	473722	4	0	0	1	0	1
36941	473726	4	1	2	0	1	4
36941	473738	4	0	2	0	0	2
36941	473745	4	2	2	0	0	4
36941	473748	4	1	0	0	1	2
36941	473753	4	0	2	0	1	3
36941	473754	4	2	2	0	1	5
36941	473755	4	1	0	0	0	1
36941	473761	4	1	1	0	0	2
36941	473766	4	0	1	0	0	1
36941	473769	4	1	2	0	1	4
36941	473771	4	1	1	1	0	3
36941	473776	4	1	2	0	0	3
36941	473780	4	0	1	0	1	2
36941	49935	4	2	1	0	0	3
36941	66831	4	0	1	0	0	1
36941	70782	4	0	2	0	1	3
36941	71444	4	0	1	0	1	2
36941	72550	4	1	3	0	2	6
36941	74676	4	1	1	0	0	2
36941	97033	4	0	1	0	0	1
36941	103811	3	1	1	0	0	2
36941	217112	3	0	0	0	0	0
36941	473667	3	1	0	0	1	2
36941	473669	3	0	1	0	1	2
36941	473683	3	0	1	0	1	2
36941	473687	3	0	1	0	0	1
36941	473697	3	0	0	0	0	0
36941	473700	3	0	3	0	0	3
36941	473702	3	0	1	0	0	1
36941	473706	3	0	1	0	1	2
36941	473707	3	1	1	0	0	2
36941	473718	3	0	1	2	0	3
36941	473719	3	3	3	1	1	8
36941	473721	3	1	2	0	0	3
36941	473723	3	1	1	2	1	5
36941	473725	3	1	2	0	0	3
36941	473729	3	1	2	0	0	3
36941	473732	3	1	1	0	0	2
36941	473733	3	0	1	0	0	1
36941	473736	3	1	0	0	0	1
36941	473741	3	1	1	0	0	2
36941	473742	3	1	0	0	0	1
36941	473743	3	1	2	0	0	3
36941	473747	3	0	0	0	0	0
36941	473756	3	0	1	0	1	2
36941	473758	3	0	0	0	1	1
36941	473772	3	1	0	1	0	2
36941	473775	3	0	0	0	0	0
36941	473778	3	1	2	0	0	3
36941	473786	3	1	0	0	1	2
36941	473788	3	0	0	0	2	2
36941	50458	3	1	2	0	0	3
36941	53144	3	0	4	0	0	4
36941	59547	3	0	1	0	1	2
36941	60930	3	0	1	0	0	1
36941	64691	3	0	0	0	0	0
36941	67963	3	0	0	0	0	0
36941	68223	3	1	1	0	0	2
36941	77999	3	0	0	0	1	1
36941	88528	3	1	0	0	0	1
36941	88587	3	2	2	0	0	4
36941	96354	3	0	0	0	1	1
36941	197556	2	0	0	0	0	0
36941	215788	2	0	0	0	0	0
36941	293070	2	1	1	0	0	2
36941	473666	2	0	0	0	0	0
36941	473670	2	0	0	0	0	0
36941	473673	2	2	1	2	4	9
36941	473675	2	0	0	0	0	0
36941	473677	2	0	0	0	0	0
36941	473685	2	3	2	0	0	5
36941	473688	2	0	2	0	0	2
36941	473691	2	1	1	0	1	3
36941	473694	2	0	2	0	1	3
36941	473703	2	0	2	0	1	3
36941	473710	2	1	1	0	1	3
36941	473720	2	3	2	0	0	5
36941	473724	2	0	1	0	0	1
36941	473730	2	1	1	0	0	2
36941	473731	2	0	0	0	0	0
36941	473735	2	1	1	0	1	3
36941	473737	2	1	2	0	1	4
36941	473749	2	0	1	0	0	1
36941	473751	2	1	0	0	0	1
36941	473774	2	0	1	0	0	1
36941	473777	2	0	1	0	0	1
36941	57196	2	0	0	0	0	0
36941	57630	2	0	0	0	0	0
36941	68311	2	1	0	1	2	4
36941	191108	1	0	0	0	0	0
36941	293076	1	0	2	1	0	3
36941	293077	1	0	1	0	1	2
36941	473671	1	0	1	0	0	1
36941	473672	1	1	0	0	0	1
36941	473674	1	0	1	0	0	1
36941	473680	1	0	0	0	0	0
36941	473704	1	0	0	0	1	1
36941	473708	1	0	0	0	0	0
36941	473727	1	0	1	0	1	2
36941	473744	1	0	0	0	1	1
36941	473757	1	0	0	0	0	0
36941	473760	1	0	1	0	0	1
36941	60897	1	0	0	0	1	1
36941	63721	1	0	1	0	1	2
36941	63738	1	0	0	0	0	0
36941	67795	1	1	0	0	0	1
36941	69641	1	0	1	0	0	1
36941	96442	1	0	1	2	0	3
78868	199039	32	0	0	3	5	8
78868	193791	15	0	0	0	2	2
78868	466925	12	0	0	2	2	4
78868	467023	12	2	1	1	1	5
78868	219247	11	0	0	0	0	0
78868	466956	10	2	2	0	1	5
78868	467071	10	2	1	0	1	4
78868	467077	10	3	0	0	2	5
78868	467113	10	0	0	1	1	2
78868	202082	9	1	1	0	1	3
78868	466923	9	0	2	2	0	4
78868	466924	9	2	2	1	0	5
78868	466957	9	1	1	2	2	6
78868	467078	9	7	1	1	0	9
78868	467105	9	3	0	0	0	3
78868	193091	8	3	0	0	1	4
78868	467017	8	1	0	3	3	7
78868	467019	8	1	1	1	2	5
78868	467030	8	0	1	2	2	5
78868	467102	8	1	1	1	0	3
78868	195019	7	0	0	1	1	2
78868	209876	7	2	0	0	1	3
78868	211820	7	1	0	0	1	2
78868	467035	7	1	0	0	2	3
78868	467043	7	0	0	0	0	0
78868	467044	7	3	0	0	1	4
78868	467045	7	1	2	1	1	5
78868	467057	7	0	1	0	0	1
78868	467100	7	2	1	3	1	7
78868	467129	7	0	0	0	0	0
78868	192651	6	2	0	0	0	2
78868	192932	6	0	0	0	0	0
78868	211556	6	2	1	1	2	6
78868	215390	6	3	1	0	1	5
78868	221004	6	1	1	1	0	3
78868	466903	6	1	0	2	2	5
78868	466904	6	0	0	0	0	0
78868	466920	6	2	1	0	0	3
78868	466926	6	1	0	0	0	1
78868	466931	6	1	1	0	0	2
78868	466948	6	1	5	0	0	6
78868	466950	6	0	1	0	3	4
78868	466954	6	2	0	0	1	3
78868	466980	6	0	3	1	5	9
78868	466985	6	1	0	0	1	2
78868	466990	6	1	0	0	1	2
78868	466992	6	0	0	0	0	0
78868	467025	6	0	1	0	1	2
78868	467034	6	1	0	1	1	3
78868	467039	6	2	0	0	0	2
78868	467040	6	1	0	0	1	2
78868	467052	6	0	0	0	0	0
78868	467075	6	0	0	0	1	1
78868	467106	6	0	1	2	2	5
78868	467107	6	1	2	2	0	5
78868	186280	5	2	1	0	1	4
78868	466890	5	0	0	2	0	2
78868	466895	5	0	0	0	1	1
78868	466896	5	1	0	1	0	2
78868	466901	5	0	0	0	1	1
78868	466911	5	0	0	0	0	0
78868	466929	5	1	0	1	2	4
78868	466943	5	1	0	1	0	2
78868	466951	5	0	0	0	0	0
78868	466955	5	2	0	0	0	2
78868	466958	5	2	0	0	1	3
78868	466959	5	0	0	0	1	1
78868	466983	5	0	1	0	0	1
78868	467006	5	2	0	0	0	2
78868	467009	5	0	0	0	2	2
78868	467021	5	1	0	0	0	1
78868	467031	5	0	1	0	1	2
78868	467053	5	0	0	0	1	1
78868	467055	5	1	0	2	1	4
78868	467079	5	1	1	0	1	3
78868	467104	5	0	0	1	1	2
78868	467112	5	1	1	1	0	3
78868	467120	5	1	0	0	0	1
78868	467127	5	0	0	0	0	0
78868	183953	4	0	1	0	1	2
78868	187953	4	0	1	0	0	1
78868	189657	4	0	0	0	0	0
78868	201244	4	0	0	0	0	0
78868	466887	4	2	1	0	1	4
78868	466900	4	1	0	0	5	6
78868	466905	4	0	0	0	2	2
78868	466909	4	1	0	0	0	1
78868	466919	4	1	0	1	2	4
78868	466921	4	1	1	0	0	2
78868	466922	4	0	0	0	1	1
78868	466928	4	0	0	0	2	2
78868	466933	4	0	0	1	0	1
78868	466938	4	0	0	0	0	0
78868	466940	4	0	0	1	1	2
78868	466942	4	0	1	1	0	2
78868	466949	4	1	0	0	1	2
78868	466960	4	1	0	0	0	1
78868	466972	4	0	2	0	0	2
78868	466995	4	0	0	0	1	1
78868	467008	4	0	0	0	0	0
78868	467018	4	0	0	0	1	1
78868	467020	4	1	0	0	0	1
78868	467022	4	0	0	0	3	3
78868	467028	4	1	0	0	0	1
78868	467036	4	1	0	0	1	2
78868	467037	4	0	0	0	1	1
78868	467046	4	1	0	0	0	1
78868	467059	4	0	0	1	0	1
78868	467060	4	1	1	0	0	2
78868	467062	4	1	0	0	3	4
78868	467065	4	1	1	0	0	2
78868	467081	4	1	0	0	1	2
78868	467083	4	0	0	0	1	1
78868	467089	4	1	0	0	1	2
78868	467092	4	2	2	0	0	4
78868	467096	4	2	1	0	0	3
78868	467110	4	0	0	0	3	3
78868	467111	4	1	2	0	0	3
78868	467122	4	0	0	0	1	1
78868	467123	4	0	0	1	0	1
78868	467124	4	1	0	0	1	2
78868	205619	3	0	0	0	0	0
78868	466892	3	0	1	1	0	2
78868	466894	3	1	0	0	2	3
78868	466897	3	1	0	0	0	1
78868	466906	3	0	0	0	1	1
78868	466907	3	0	2	2	0	4
78868	466910	3	0	0	1	2	3
78868	466913	3	2	0	2	0	4
78868	466915	3	0	0	0	0	0
78868	466916	3	1	1	1	1	4
78868	466927	3	1	1	1	1	4
78868	466932	3	0	0	0	3	3
78868	466935	3	0	0	1	0	1
78868	466936	3	1	1	1	3	6
78868	466937	3	0	0	1	1	2
78868	466939	3	1	0	1	0	2
78868	466941	3	1	0	0	1	2
78868	466944	3	0	1	0	1	2
78868	466946	3	0	1	0	2	3
78868	466947	3	1	0	0	0	1
78868	466961	3	3	1	0	1	5
78868	466963	3	0	0	0	0	0
78868	466968	3	0	1	0	2	3
78868	466969	3	0	0	0	1	1
78868	466973	3	1	1	0	0	2
78868	466974	3	0	0	0	0	0
78868	466976	3	0	1	0	0	1
78868	466977	3	1	0	0	0	1
78868	466978	3	0	2	0	1	3
78868	466981	3	2	1	0	0	3
78868	466988	3	0	0	0	0	0
78868	466989	3	0	0	0	0	0
78868	466999	3	0	0	0	1	1
78868	467000	3	0	0	0	0	0
78868	467010	3	0	0	0	0	0
78868	467014	3	0	0	1	0	1
78868	467024	3	0	1	0	0	1
78868	467033	3	0	0	0	1	1
78868	467041	3	0	1	1	1	3
78868	467042	3	1	1	0	0	2
78868	467048	3	1	1	0	0	2
78868	467049	3	2	0	0	0	2
78868	467050	3	1	0	0	0	1
78868	467056	3	1	0	0	0	1
78868	467058	3	1	0	0	0	1
78868	467063	3	0	0	1	1	2
78868	467066	3	1	1	0	0	2
78868	467068	3	1	0	1	0	2
78868	467072	3	1	0	0	0	1
78868	467073	3	0	0	0	0	0
78868	467074	3	0	0	1	0	1
78868	467076	3	0	0	0	1	1
78868	467080	3	0	0	1	1	2
78868	467082	3	0	0	1	3	4
78868	467084	3	0	0	0	0	0
78868	467088	3	1	0	0	0	1
78868	467094	3	1	0	0	0	1
78868	467095	3	1	1	0	0	2
78868	467103	3	1	0	1	2	4
78868	467117	3	1	0	0	1	2
78868	467119	3	2	0	0	3	5
78868	467131	3	0	0	1	4	5
78868	467133	3	0	0	0	1	1
78868	191624	2	0	1	1	0	2
78868	193748	2	0	1	0	0	1
78868	193750	2	0	0	0	0	0
78868	203368	2	2	0	0	0	2
78868	209451	2	0	0	0	1	1
78868	216376	2	1	1	0	0	2
78868	466891	2	1	0	0	0	1
78868	466898	2	0	0	0	1	1
78868	466908	2	0	0	0	1	1
78868	466912	2	0	0	1	1	2
78868	466914	2	1	0	0	0	1
78868	466917	2	1	0	0	0	1
78868	466918	2	0	0	0	0	0
78868	466934	2	0	0	0	1	1
78868	466953	2	0	2	0	1	3
78868	466962	2	0	0	0	0	0
78868	466964	2	0	0	0	0	0
78868	466965	2	1	0	0	0	1
78868	466966	2	0	0	0	2	2
78868	466967	2	0	2	0	1	3
78868	466970	2	0	0	0	1	1
78868	466971	2	0	1	0	1	2
78868	466975	2	0	0	0	0	0
78868	466979	2	0	0	0	0	0
78868	466984	2	0	0	0	1	1
78868	466987	2	0	0	0	0	0
78868	466991	2	0	0	0	1	1
78868	466994	2	1	0	1	1	3
78868	466996	2	1	0	0	0	1
78868	466997	2	0	1	0	1	2
78868	466998	2	0	0	1	1	2
78868	467001	2	2	0	1	0	3
78868	467002	2	0	0	0	1	1
78868	467003	2	1	0	0	1	2
78868	467004	2	0	0	0	1	1
78868	467011	2	1	0	1	0	2
78868	467013	2	2	0	1	0	3
78868	467016	2	0	0	0	0	0
78868	467029	2	1	0	0	0	1
78868	467032	2	0	0	0	0	0
78868	467038	2	0	1	2	0	3
78868	467047	2	1	0	0	1	2
78868	467051	2	1	0	0	0	1
78868	467064	2	1	0	0	0	1
78868	467070	2	0	0	0	0	0
78868	467087	2	0	0	0	0	0
78868	467093	2	0	0	0	0	0
78868	467097	2	0	0	0	0	0
78868	467098	2	1	0	1	0	2
78868	467099	2	0	0	0	0	0
78868	467101	2	1	0	0	0	1
78868	467109	2	0	0	0	0	0
78868	467114	2	0	0	0	0	0
78868	467115	2	0	0	0	1	1
78868	467116	2	1	0	0	0	1
78868	467121	2	0	0	0	1	1
78868	467125	2	0	0	0	0	0
78868	467126	2	0	0	0	1	1
78868	467128	2	2	0	0	0	2
78868	467130	2	1	0	0	0	1
78868	467134	2	0	0	0	0	0
78868	185555	1	0	0	0	0	0
78868	192468	1	0	0	0	1	1
78868	202928	1	0	0	1	0	1
78868	210511	1	0	0	0	0	0
78868	211233	1	0	0	0	1	1
78868	218663	1	1	0	0	0	1
78868	466888	1	0	0	1	0	1
78868	466889	1	0	0	0	1	1
78868	466893	1	0	0	0	0	0
78868	466899	1	0	0	0	0	0
78868	466902	1	1	0	0	0	1
78868	466930	1	0	0	0	0	0
78868	466945	1	1	0	0	0	1
78868	466952	1	1	0	0	0	1
78868	466982	1	0	0	1	0	1
78868	466986	1	0	0	0	0	0
78868	466993	1	0	0	0	1	1
78868	467005	1	0	0	0	0	0
78868	467007	1	0	0	0	1	1
78868	467012	1	2	1	0	0	3
78868	467015	1	0	0	0	1	1
78868	467026	1	0	0	0	2	2
78868	467027	1	1	0	0	0	1
78868	467054	1	1	0	0	1	2
78868	467061	1	0	0	0	0	0
78868	467067	1	0	0	0	0	0
78868	467069	1	1	0	0	2	3
78868	467085	1	0	0	0	1	1
78868	467086	1	1	0	1	0	2
78868	467090	1	1	0	0	1	2
78868	467091	1	0	0	0	0	0
78868	467108	1	0	0	0	0	0
78868	467118	1	0	0	0	0	0
78868	467132	1	0	0	0	0	0
78868	467135	1	2	0	0	2	4
78868	467136	1	1	0	0	1	2
10435	198973	33	3	2	0	0	5
10435	285731	33	3	2	0	0	5
10435	590026	17	0	2	0	0	2
10435	590014	15	0	0	0	1	1
10435	285728	14	0	4	0	2	6
10435	590066	13	0	0	1	0	1
10435	212317	11	0	3	0	0	3
10435	590003	11	0	3	0	0	3
10435	590041	11	3	3	1	1	8
10435	590002	10	2	3	0	0	5
10435	590025	10	2	1	1	0	4
10435	590076	9	0	2	0	1	3
10435	195109	8	0	3	0	0	3
10435	285737	8	1	2	0	1	4
10435	590006	8	0	2	0	1	3
10435	590037	8	0	2	0	1	3
10435	590111	8	1	2	0	1	4
10435	590181	8	1	4	0	0	5
10435	186038	7	3	3	0	0	6
10435	210959	7	1	4	0	0	5
10435	590018	7	3	5	1	2	11
10435	590027	7	2	0	0	1	3
10435	590036	7	1	4	0	0	5
10435	590086	7	0	0	0	0	0
10435	590124	7	1	1	0	0	2
10435	590132	7	1	1	0	1	3
10435	590149	7	3	4	1	0	8
10435	590176	7	1	1	0	0	2
10435	216814	6	0	0	1	0	1
10435	589997	6	1	4	0	3	8
10435	590022	6	2	0	0	0	2
10435	590028	6	4	0	0	0	4
10435	590042	6	1	0	0	1	2
10435	590063	6	0	1	0	0	1
10435	590091	6	0	1	0	0	1
10435	590116	6	4	1	0	1	6
10435	590156	6	0	3	0	0	3
10435	193567	5	1	0	0	1	2
10435	198243	5	2	1	0	0	3
10435	199222	5	2	1	0	0	3
10435	203025	5	0	3	0	0	3
10435	211819	5	0	0	0	0	0
10435	214304	5	0	1	0	1	2
10435	214431	5	2	0	0	1	3
10435	221674	5	1	2	1	0	4
10435	285732	5	1	0	0	0	1
10435	285739	5	3	3	2	0	8
10435	285743	5	0	0	0	0	0
10435	590001	5	0	1	0	0	1
10435	590015	5	3	1	0	0	4
10435	590017	5	1	4	1	0	6
10435	590024	5	0	2	0	0	2
10435	590029	5	2	2	0	0	4
10435	590033	5	0	4	0	0	4
10435	590064	5	0	1	0	1	2
10435	590065	5	2	1	0	0	3
10435	590083	5	1	2	0	1	4
10435	590084	5	0	3	0	0	3
10435	590085	5	0	0	0	0	0
10435	590110	5	0	1	0	1	2
10435	590113	5	1	1	0	0	2
10435	590119	5	0	1	0	0	1
10435	590130	5	2	3	0	0	5
10435	590139	5	1	2	0	0	3
10435	590154	5	1	0	0	0	1
10435	590159	5	5	0	2	0	7
10435	590163	5	0	0	0	0	0
10435	590171	5	0	0	0	0	0
10435	590177	5	0	2	0	0	2
10435	590178	5	0	0	0	0	0
10435	590180	5	2	3	0	0	5
10435	189325	4	0	0	0	0	0
10435	198368	4	0	2	0	0	2
10435	202695	4	0	1	0	1	2
10435	203159	4	0	0	0	0	0
10435	204529	4	1	1	0	0	2
10435	206898	4	0	1	0	0	1
10435	208144	4	1	0	0	0	1
10435	212334	4	1	2	0	0	3
10435	285734	4	0	0	0	0	0
10435	285736	4	0	1	0	0	1
10435	285742	4	0	0	0	0	0
10435	590005	4	3	2	0	0	5
10435	590008	4	1	0	0	0	1
10435	590011	4	2	2	0	0	4
10435	590012	4	0	1	0	1	2
10435	590013	4	0	1	0	1	2
10435	590023	4	3	2	0	0	5
10435	590030	4	0	5	0	0	5
10435	590032	4	2	1	0	1	4
10435	590034	4	0	2	0	0	2
10435	590040	4	0	0	0	0	0
10435	590043	4	0	0	0	0	0
10435	590044	4	0	0	0	0	0
10435	590046	4	3	2	2	0	7
10435	590049	4	1	2	0	0	3
10435	590050	4	1	2	0	0	3
10435	590058	4	1	2	0	0	3
10435	590059	4	2	2	0	0	4
10435	590071	4	1	2	0	0	3
10435	590072	4	0	0	0	0	0
10435	590080	4	0	0	0	0	0
10435	590087	4	0	1	0	0	1
10435	590090	4	0	1	0	1	2
10435	590101	4	1	1	1	0	3
10435	590107	4	0	3	0	1	4
10435	590112	4	1	4	0	0	5
10435	590121	4	1	1	0	0	2
10435	590127	4	2	3	0	0	5
10435	590128	4	1	0	1	0	2
10435	590129	4	1	3	0	0	4
10435	590131	4	0	0	0	1	1
10435	590133	4	1	0	0	1	2
10435	590150	4	0	0	0	1	1
10435	590155	4	0	0	0	0	0
10435	590161	4	0	4	0	0	4
10435	590170	4	1	1	0	1	3
10435	185209	3	0	0	0	0	0
10435	191331	3	1	1	0	0	2
10435	193190	3	0	0	1	0	1
10435	193199	3	0	2	0	0	2
10435	193848	3	0	0	0	0	0
10435	206852	3	0	0	0	1	1
10435	207333	3	1	0	0	0	1
10435	208349	3	1	1	0	0	2
10435	209207	3	0	2	0	0	2
10435	212446	3	0	1	0	0	1
10435	214358	3	0	4	0	1	5
10435	221092	3	0	1	1	0	2
10435	285726	3	1	1	0	1	3
10435	285727	3	2	0	0	0	2
10435	285729	3	0	0	0	0	0
10435	285733	3	1	2	0	1	4
10435	285735	3	0	1	0	0	1
10435	590004	3	0	1	0	1	2
10435	590010	3	1	1	0	1	3
10435	590019	3	0	1	0	0	1
10435	590021	3	0	0	0	0	0
10435	590035	3	0	4	0	0	4
10435	590038	3	0	1	0	0	1
10435	590039	3	1	3	0	0	4
10435	590045	3	1	1	0	0	2
10435	590047	3	0	1	1	0	2
10435	590052	3	0	0	0	0	0
10435	590055	3	0	2	0	1	3
10435	590057	3	0	2	0	0	2
10435	590067	3	3	0	0	0	3
10435	590068	3	1	3	0	1	5
10435	590069	3	0	0	0	0	0
10435	590070	3	1	0	0	0	1
10435	590073	3	1	0	0	0	1
10435	590074	3	0	0	0	1	1
10435	590079	3	1	0	0	1	2
10435	590088	3	0	3	1	0	4
10435	590092	3	1	1	0	0	2
10435	590093	3	1	0	0	0	1
10435	590096	3	1	0	0	0	1
10435	590102	3	1	1	0	0	2
10435	590105	3	1	1	0	0	2
10435	590115	3	2	1	0	0	3
10435	590122	3	0	0	0	0	0
10435	590123	3	0	0	0	0	0
10435	590126	3	1	3	0	2	6
10435	590134	3	0	0	0	0	0
10435	590136	3	0	2	0	0	2
10435	590140	3	1	5	0	0	6
10435	590142	3	1	1	0	0	2
10435	590144	3	0	1	0	0	1
10435	590148	3	0	0	0	0	0
10435	590151	3	0	2	0	1	3
10435	590153	3	0	3	0	0	3
10435	590162	3	1	1	0	0	2
10435	590164	3	1	0	0	0	1
10435	590165	3	1	1	0	1	3
10435	590168	3	1	0	0	0	1
10435	590169	3	2	1	0	0	3
10435	590183	3	0	3	0	0	3
10435	590184	3	0	1	0	0	1
10435	590185	3	0	2	0	0	2
10435	182327	2	0	2	0	0	2
10435	185463	2	0	1	0	0	1
10435	188444	2	0	2	0	0	2
10435	190089	2	0	0	0	0	0
10435	194393	2	0	1	0	0	1
10435	196533	2	0	1	0	0	1
10435	200065	2	0	0	0	0	0
10435	204981	2	0	2	0	0	2
10435	205535	2	0	1	0	0	1
10435	206216	2	0	1	0	1	2
10435	207730	2	1	0	0	0	1
10435	210409	2	0	0	0	0	0
10435	211640	2	2	0	0	0	2
10435	211644	2	2	0	0	0	2
10435	217701	2	0	0	0	0	0
10435	218762	2	0	0	0	0	0
10435	285740	2	0	0	0	0	0
10435	285741	2	0	2	0	0	2
10435	589998	2	0	1	0	0	1
10435	590000	2	0	1	0	0	1
10435	590007	2	0	0	0	0	0
10435	590009	2	1	1	0	0	2
10435	590016	2	1	1	0	0	2
10435	590020	2	2	1	0	0	3
10435	590048	2	0	2	0	0	2
10435	590051	2	1	0	0	0	1
10435	590056	2	1	1	0	0	2
10435	590061	2	0	0	0	0	0
10435	590062	2	0	0	0	1	1
10435	590078	2	0	0	0	1	1
10435	590094	2	1	3	0	1	5
10435	590097	2	1	1	0	0	2
10435	590098	2	0	1	0	0	1
10435	590099	2	0	0	0	0	0
10435	590103	2	1	1	0	0	2
10435	590104	2	0	1	0	0	1
10435	590106	2	0	1	0	0	1
10435	590108	2	1	1	0	0	2
10435	590117	2	0	1	0	0	1
10435	590120	2	1	1	0	0	2
10435	590135	2	0	0	0	1	1
10435	590137	2	0	0	0	0	0
10435	590138	2	0	0	0	0	0
10435	590141	2	0	1	0	0	1
10435	590145	2	1	0	0	0	1
10435	590146	2	0	0	0	0	0
10435	590147	2	1	0	0	0	1
10435	590152	2	0	1	0	0	1
10435	590157	2	0	3	0	0	3
10435	590158	2	2	1	0	0	3
10435	590160	2	0	0	0	0	0
10435	590166	2	1	1	0	0	2
10435	590167	2	1	0	0	0	1
10435	590172	2	0	0	0	0	0
10435	590173	2	0	0	0	0	0
10435	590175	2	0	1	0	0	1
10435	590179	2	1	2	0	0	3
10435	182686	1	0	1	0	0	1
10435	186578	1	0	0	0	0	0
10435	188927	1	0	0	0	0	0
10435	192795	1	0	0	0	0	0
10435	199161	1	0	0	0	0	0
10435	199254	1	0	0	0	0	0
10435	203779	1	0	0	0	0	0
10435	206616	1	0	0	0	0	0
10435	207550	1	0	1	0	0	1
10435	210760	1	0	0	0	0	0
10435	210769	1	0	1	0	0	1
10435	211190	1	0	0	0	0	0
10435	211688	1	0	0	0	0	0
10435	211895	1	0	0	0	0	0
10435	285730	1	0	1	0	0	1
10435	285738	1	0	3	0	0	3
10435	589999	1	0	0	0	0	0
10435	590031	1	0	0	0	0	0
10435	590053	1	1	1	0	0	2
10435	590054	1	0	0	0	0	0
10435	590060	1	0	1	0	0	1
10435	590075	1	1	1	0	0	2
10435	590077	1	0	1	0	0	1
10435	590081	1	2	2	0	0	4
10435	590082	1	1	0	0	0	1
10435	590089	1	0	0	0	0	0
10435	590095	1	1	0	0	0	1
10435	590100	1	0	1	0	0	1
10435	590109	1	2	2	0	0	4
10435	590114	1	0	0	0	0	0
10435	590118	1	0	0	0	0	0
10435	590125	1	0	2	0	0	2
10435	590143	1	0	1	1	0	2
10435	590174	1	0	1	0	0	1
10435	590182	1	0	1	0	0	1
34764	191442	67	5	4	3	3	15
34764	214021	51	6	8	1	0	15
34764	212819	26	3	3	4	0	10
34764	292503	26	3	3	4	0	10
34764	292501	21	7	4	7	1	19
34764	292505	18	1	0	2	0	3
34764	399407	18	2	3	2	2	9
34764	399411	18	2	4	0	0	6
34764	399438	18	1	8	0	1	10
34764	200734	17	1	1	2	0	4
34764	292516	17	3	0	3	0	6
34764	399476	17	0	1	2	5	8
34764	185422	16	2	4	1	0	7
34764	186718	16	1	2	1	0	4
34764	189124	16	2	4	1	0	7
34764	399445	16	2	4	1	0	7
34764	185986	14	2	5	1	0	8
34764	201089	14	3	1	1	0	5
34764	292499	14	3	6	1	0	10
34764	399366	14	0	1	2	3	6
34764	399404	14	2	5	1	0	8
34764	292496	13	2	0	1	0	3
34764	399448	13	1	0	0	0	1
34764	186015	11	0	1	3	0	4
34764	399431	11	2	3	1	1	7
34764	399464	11	2	0	0	1	3
34764	399488	11	1	2	1	1	5
34764	292500	10	1	4	0	0	5
34764	399387	10	1	3	1	1	6
34764	399416	10	3	0	0	0	3
34764	399487	10	1	0	0	0	1
34764	184548	9	1	1	0	0	2
34764	209548	9	2	3	1	0	6
34764	211677	9	1	1	0	0	2
34764	214708	9	2	1	3	0	6
34764	217044	9	1	3	4	0	8
34764	220587	9	1	4	3	0	8
34764	292498	9	1	1	0	0	2
34764	292510	9	3	0	0	0	3
34764	292511	9	1	0	0	0	1
34764	292514	9	1	3	4	0	8
34764	399383	9	1	3	0	0	4
34764	399385	9	0	1	0	0	1
34764	399409	9	0	0	0	0	0
34764	399425	9	1	1	0	2	4
34764	399427	9	0	1	1	0	2
34764	399452	9	2	2	1	1	6
34764	399454	9	2	1	4	1	8
34764	399458	9	4	2	0	1	7
34764	188252	8	3	1	1	0	5
34764	399365	8	4	1	1	1	7
34764	399390	8	1	2	0	0	3
34764	399391	8	0	1	0	0	1
34764	399426	8	3	0	0	0	3
34764	399429	8	0	1	0	0	1
34764	399460	8	1	0	0	1	2
34764	399467	8	1	3	0	0	4
34764	399468	8	2	1	0	0	3
34764	183401	7	0	2	0	0	2
34764	190379	7	1	0	1	0	2
34764	190562	7	0	1	0	0	1
34764	212919	7	0	0	0	0	0
34764	292502	7	0	1	0	0	1
34764	292504	7	0	2	1	0	3
34764	292507	7	1	0	0	0	1
34764	292508	7	1	1	0	0	2
34764	292509	7	2	4	0	0	6
34764	399367	7	0	1	1	0	2
34764	399388	7	1	1	0	0	2
34764	399395	7	2	2	0	0	4
34764	399397	7	2	0	0	0	2
34764	399398	7	1	1	0	0	2
34764	399405	7	0	0	0	0	0
34764	399421	7	1	2	0	0	3
34764	399428	7	0	1	1	0	2
34764	399436	7	0	3	0	0	3
34764	399442	7	0	0	1	0	1
34764	399446	7	1	0	0	0	1
34764	399471	7	0	2	0	0	2
34764	185268	6	1	0	0	0	1
34764	190971	6	1	1	0	0	2
34764	193127	6	0	3	0	0	3
34764	199691	6	1	1	1	0	3
34764	204825	6	0	3	1	0	4
34764	218099	6	2	1	1	0	4
34764	218616	6	0	0	0	0	0
34764	220111	6	1	2	2	0	5
34764	292515	6	1	0	0	0	1
34764	399372	6	0	1	0	0	1
34764	399375	6	1	1	0	1	3
34764	399392	6	2	3	1	0	6
34764	399406	6	2	2	1	0	5
34764	399418	6	0	4	0	0	4
34764	399424	6	0	0	0	0	0
34764	399450	6	0	0	0	0	0
34764	399459	6	0	2	0	1	3
34764	399472	6	3	3	1	1	8
34764	399489	6	1	2	3	0	6
34764	182357	5	4	0	1	0	5
34764	185806	5	0	1	0	0	1
34764	189662	5	0	1	0	0	1
34764	190965	5	0	0	1	0	1
34764	191342	5	1	1	0	0	2
34764	192206	5	1	0	2	0	3
34764	194017	5	0	1	0	0	1
34764	200131	5	0	0	0	0	0
34764	202275	5	1	1	0	0	2
34764	205310	5	1	2	0	0	3
34764	206699	5	0	0	0	0	0
34764	207422	5	2	1	0	0	3
34764	209048	5	0	1	0	0	1
34764	213330	5	0	2	0	0	2
34764	216623	5	0	1	0	0	1
34764	399364	5	0	1	0	0	1
34764	399376	5	1	2	0	1	4
34764	399384	5	1	2	0	0	3
34764	399386	5	1	2	0	0	3
34764	399393	5	2	0	0	0	2
34764	399394	5	1	1	2	0	4
34764	399403	5	3	1	0	0	4
34764	399414	5	2	1	0	0	3
34764	399417	5	0	0	0	0	0
34764	399422	5	1	0	0	0	1
34764	399430	5	1	3	0	0	4
34764	399440	5	2	1	0	0	3
34764	399447	5	3	5	0	1	9
34764	399449	5	1	2	0	0	3
34764	399451	5	0	0	0	0	0
34764	399463	5	3	0	1	0	4
34764	399466	5	0	0	0	0	0
34764	399469	5	1	0	1	1	3
34764	399478	5	0	1	0	0	1
34764	189627	4	1	2	0	0	3
34764	190451	4	0	2	0	1	3
34764	190491	4	0	1	0	0	1
34764	198022	4	0	1	0	0	1
34764	198179	4	1	1	0	0	2
34764	198251	4	1	2	1	0	4
34764	199150	4	0	0	0	0	0
34764	200391	4	0	2	0	0	2
34764	201233	4	0	1	0	1	2
34764	201571	4	2	1	0	0	3
34764	203395	4	0	1	0	1	2
34764	204987	4	1	0	0	0	1
34764	204994	4	1	2	0	1	4
34764	207309	4	0	1	0	0	1
34764	210063	4	1	2	0	0	3
34764	210406	4	0	3	0	1	4
34764	213535	4	1	1	0	0	2
34764	213931	4	2	0	0	0	2
34764	216017	4	1	1	0	0	2
34764	216344	4	0	1	0	0	1
34764	217951	4	0	0	1	0	1
34764	218820	4	0	0	0	0	0
34764	218944	4	1	0	0	0	1
34764	220495	4	0	2	1	0	3
34764	292497	4	0	0	0	0	0
34764	292506	4	3	1	1	0	5
34764	292513	4	2	1	0	0	3
34764	399356	4	0	2	0	0	2
34764	399357	4	1	0	0	0	1
34764	399378	4	0	0	4	0	4
34764	399381	4	0	1	0	0	1
34764	399382	4	1	1	0	1	3
34764	399389	4	1	1	0	1	3
34764	399400	4	1	0	0	0	1
34764	399402	4	1	3	2	0	6
34764	399413	4	1	3	0	1	5
34764	399434	4	0	1	0	0	1
34764	399439	4	0	0	0	3	3
34764	399444	4	1	1	0	0	2
34764	399455	4	0	0	0	0	0
34764	399456	4	1	2	1	1	5
34764	399462	4	1	0	0	1	2
34764	399473	4	0	1	0	0	1
34764	399474	4	1	2	0	0	3
34764	399475	4	1	0	0	0	1
34764	399477	4	3	0	2	0	5
34764	399480	4	3	2	0	1	6
34764	399481	4	0	1	0	0	1
34764	399484	4	1	1	0	0	2
34764	399490	4	2	0	0	0	2
34764	185349	3	0	2	0	0	2
34764	185438	3	0	1	0	0	1
34764	185938	3	1	0	0	0	1
34764	187101	3	0	2	0	0	2
34764	187191	3	0	0	0	0	0
34764	195861	3	1	0	0	1	2
34764	196367	3	1	2	1	0	4
34764	199791	3	0	1	1	0	2
34764	200071	3	0	1	1	0	2
34764	207400	3	0	1	1	0	2
34764	207569	3	1	1	0	0	2
34764	210765	3	0	1	0	0	1
34764	213847	3	1	0	0	0	1
34764	214115	3	0	1	1	0	2
34764	214919	3	0	0	1	0	1
34764	218258	3	1	2	0	0	3
34764	220352	3	1	2	0	0	3
34764	292512	3	2	0	0	0	2
34764	399350	3	0	1	0	0	1
34764	399355	3	0	1	0	0	1
34764	399360	3	0	1	0	0	1
34764	399361	3	1	2	0	0	3
34764	399362	3	1	0	0	0	1
34764	399368	3	1	0	0	0	1
34764	399370	3	1	2	0	0	3
34764	399373	3	2	1	1	0	4
34764	399374	3	0	4	1	0	5
34764	399380	3	0	0	0	0	0
34764	399396	3	0	2	0	0	2
34764	399399	3	1	0	0	0	1
34764	399408	3	0	1	0	0	1
34764	399412	3	3	3	0	0	6
34764	399423	3	0	1	0	1	2
34764	399432	3	2	2	0	0	4
34764	399433	3	1	2	0	0	3
34764	399435	3	0	1	0	0	1
34764	399437	3	0	1	0	0	1
34764	399443	3	0	0	0	0	0
34764	399461	3	1	0	0	0	1
34764	399465	3	0	0	1	0	1
34764	399470	3	0	0	0	0	0
34764	399479	3	1	3	0	0	4
34764	399483	3	1	1	0	0	2
34764	399485	3	1	1	0	3	5
34764	399486	3	0	1	0	0	1
34764	181930	2	1	2	2	0	5
34764	186688	2	1	0	0	0	1
34764	189647	2	1	0	0	0	1
34764	190652	2	1	1	0	0	2
34764	191416	2	0	0	0	0	0
34764	192812	2	0	0	0	0	0
34764	195919	2	0	0	0	0	0
34764	199101	2	0	1	0	0	1
34764	199960	2	0	1	0	0	1
34764	201261	2	0	1	0	0	1
34764	203194	2	0	0	0	0	0
34764	205007	2	1	1	0	0	2
34764	207633	2	0	1	0	0	1
34764	207819	2	1	0	0	0	1
34764	212933	2	0	1	0	0	1
34764	214720	2	0	2	0	0	2
34764	217375	2	0	0	0	0	0
34764	221927	2	1	0	0	0	1
34764	399351	2	0	0	0	0	0
34764	399353	2	0	0	0	0	0
34764	399358	2	0	1	0	1	2
34764	399359	2	0	1	0	0	1
34764	399363	2	1	1	0	0	2
34764	399371	2	0	2	0	0	2
34764	399410	2	0	0	0	0	0
34764	399415	2	0	0	0	0	0
34764	399419	2	1	0	0	0	1
34764	399420	2	0	0	0	1	1
34764	399441	2	0	1	0	0	1
34764	399453	2	0	2	0	1	3
34764	399457	2	1	0	0	0	1
34764	399482	2	0	1	0	0	1
34764	192062	1	0	0	0	0	0
34764	201308	1	0	0	0	0	0
34764	216234	1	1	0	1	0	2
34764	216605	1	0	0	0	0	0
34764	399349	1	0	2	0	0	2
34764	399352	1	0	1	0	0	1
34764	399354	1	0	0	0	0	0
34764	399369	1	0	1	0	1	2
34764	399377	1	1	0	0	1	2
34764	399379	1	1	0	0	0	1
34764	399401	1	1	0	0	0	1
23579	198998	47	6	5	2	11	24
23579	289579	47	6	5	2	11	24
23579	219426	31	0	0	2	0	2
23579	617009	31	1	4	4	1	10
23579	200799	30	1	2	1	6	10
23579	289593	30	1	2	1	6	10
23579	616978	27	2	9	0	3	14
23579	616990	22	0	1	0	0	1
23579	289591	18	1	4	0	2	7
23579	617024	18	1	0	0	0	1
23579	214758	17	3	4	0	4	11
23579	289586	17	3	2	0	0	5
23579	289594	17	3	4	0	4	11
23579	188858	16	1	0	0	1	2
23579	289597	16	1	0	0	1	2
23579	203053	15	0	1	2	1	4
23579	212217	15	2	2	3	3	10
23579	213256	15	0	1	1	1	3
23579	616958	15	2	2	3	3	10
23579	617004	15	0	1	2	1	4
23579	617020	15	3	4	0	4	11
23579	616960	14	5	2	1	2	10
23579	289583	13	3	1	1	2	7
23579	616951	12	2	0	0	0	2
23579	616984	12	1	3	1	4	9
23579	617001	12	1	0	1	0	2
23579	216102	11	1	3	0	3	7
23579	616904	11	3	0	0	0	3
23579	616985	11	1	2	0	0	3
23579	617026	11	0	0	0	0	0
23579	197105	10	1	0	0	0	1
23579	289596	10	1	3	0	3	7
23579	616921	10	3	3	0	1	7
23579	616974	10	0	1	0	1	2
23579	617032	10	1	3	0	3	7
23579	617035	10	3	0	0	4	7
23579	189887	9	1	0	1	3	5
23579	192676	9	3	0	1	3	7
23579	289587	9	2	1	0	0	3
23579	617014	9	2	0	2	1	5
23579	617027	9	2	0	0	2	4
23579	187998	8	1	1	0	2	4
23579	220998	8	2	0	1	5	8
23579	289565	8	3	0	1	3	7
23579	616914	8	3	4	0	1	8
23579	616936	8	1	0	0	1	2
23579	616940	8	2	2	0	2	6
23579	617002	8	1	1	1	0	3
23579	617008	8	2	1	1	1	5
23579	617018	8	3	2	0	1	6
23579	183389	7	1	0	0	1	2
23579	184858	7	1	3	0	5	9
23579	195030	7	1	2	0	3	6
23579	209365	7	1	0	0	0	1
23579	289567	7	2	0	0	0	2
23579	289581	7	2	1	0	3	6
23579	289592	7	1	3	0	5	9
23579	289595	7	3	0	1	0	4
23579	616966	7	2	1	0	2	5
23579	616969	7	0	0	0	1	1
23579	616975	7	1	2	1	0	4
23579	617023	7	1	3	0	3	7
23579	617028	7	1	0	0	1	2
23579	187726	6	0	0	0	0	0
23579	191172	6	0	0	0	0	0
23579	197481	6	2	2	0	2	6
23579	198227	6	0	2	1	3	6
23579	206521	6	3	0	1	0	4
23579	289562	6	2	2	0	2	6
23579	289569	6	1	0	0	0	1
23579	289578	6	1	1	1	1	4
23579	616912	6	3	1	0	1	5
23579	616917	6	0	1	1	0	2
23579	616946	6	2	0	0	2	4
23579	616981	6	2	3	0	1	6
23579	616988	6	1	1	0	4	6
23579	616989	6	2	0	0	0	2
23579	617012	6	1	1	0	5	7
23579	193555	5	1	1	0	3	5
23579	194755	5	1	0	0	1	2
23579	196126	5	0	0	0	0	0
23579	197241	5	0	1	0	0	1
23579	199888	5	1	2	0	0	3
23579	201851	5	2	0	0	1	3
23579	206979	5	0	0	0	1	1
23579	211854	5	1	2	0	1	4
23579	216900	5	0	1	0	1	2
23579	218375	5	1	0	0	0	1
23579	220673	5	0	1	0	2	3
23579	289566	5	0	0	0	1	1
23579	289571	5	1	0	0	0	1
23579	289572	5	0	0	0	3	3
23579	289590	5	1	0	0	1	2
23579	616908	5	0	1	0	1	2
23579	616915	5	0	1	0	2	3
23579	616919	5	1	1	1	0	3
23579	616935	5	1	1	0	0	2
23579	616945	5	1	1	0	0	2
23579	616955	5	0	2	0	3	5
23579	616967	5	0	1	0	0	1
23579	616973	5	1	1	0	3	5
23579	616976	5	0	0	0	0	0
23579	616998	5	0	0	0	3	3
23579	617000	5	1	1	0	2	4
23579	617006	5	0	3	0	2	5
23579	617011	5	1	3	1	2	7
23579	617016	5	3	3	0	1	7
23579	617017	5	3	0	0	5	8
23579	617021	5	1	0	0	0	1
23579	617022	5	0	0	0	0	0
23579	617029	5	2	0	0	0	2
23579	617033	5	0	0	0	2	2
23579	184394	4	0	0	0	0	0
23579	186793	4	1	2	0	1	4
23579	189652	4	0	3	0	2	5
23579	191619	4	0	2	0	0	2
23579	192739	4	0	0	0	3	3
23579	199778	4	0	2	0	3	5
23579	205972	4	3	2	1	0	6
23579	206541	4	1	1	0	0	2
23579	206846	4	0	1	0	0	1
23579	207459	4	0	1	0	1	2
23579	207917	4	0	1	0	1	2
23579	212328	4	3	0	0	0	3
23579	216695	4	2	1	1	1	5
23579	289561	4	1	0	0	2	3
23579	289570	4	2	1	0	4	7
23579	289575	4	0	0	1	0	1
23579	289580	4	0	1	0	1	2
23579	289585	4	1	1	0	1	3
23579	289588	4	1	0	0	0	1
23579	616906	4	0	0	0	0	0
23579	616907	4	0	3	0	0	3
23579	616913	4	1	2	0	0	3
23579	616916	4	3	1	0	0	4
23579	616922	4	0	2	0	0	2
23579	616924	4	1	0	2	0	3
23579	616930	4	1	1	0	1	3
23579	616931	4	0	1	1	0	2
23579	616933	4	0	1	0	0	1
23579	616934	4	1	0	0	0	1
23579	616942	4	0	0	0	0	0
23579	616943	4	0	0	0	2	2
23579	616947	4	0	0	1	3	4
23579	616952	4	0	2	0	5	7
23579	616956	4	1	1	0	1	3
23579	616962	4	1	2	0	2	5
23579	616968	4	0	4	0	1	5
23579	616970	4	0	2	0	2	4
23579	616972	4	2	3	0	2	7
23579	616977	4	1	0	0	0	1
23579	616979	4	0	1	0	1	2
23579	616983	4	2	0	1	0	3
23579	616987	4	3	1	0	0	4
23579	616991	4	0	1	0	2	3
23579	616992	4	4	2	1	0	7
23579	616993	4	2	0	0	0	2
23579	616995	4	1	0	1	0	2
23579	617005	4	2	0	2	1	5
23579	617007	4	0	3	0	3	6
23579	617013	4	1	1	0	1	3
23579	617015	4	1	3	0	1	5
23579	617030	4	0	0	0	0	0
23579	617034	4	3	1	0	1	5
23579	617036	4	0	0	0	1	1
23579	182726	3	0	1	0	0	1
23579	184264	3	0	0	0	1	1
23579	184265	3	0	0	0	1	1
23579	185444	3	0	1	0	2	3
23579	185601	3	1	0	0	1	2
23579	185602	3	1	0	0	1	2
23579	187894	3	0	0	0	1	1
23579	190942	3	0	0	0	1	1
23579	192778	3	0	3	0	0	3
23579	195232	3	1	0	0	2	3
23579	195736	3	1	0	1	2	4
23579	197185	3	1	1	0	1	3
23579	198124	3	1	0	0	0	1
23579	199985	3	1	0	0	0	1
23579	205185	3	0	3	0	1	4
23579	205631	3	1	0	0	0	1
23579	209370	3	0	0	0	0	0
23579	211684	3	1	0	0	0	1
23579	213970	3	1	1	0	2	4
23579	218796	3	1	0	1	1	3
23579	289563	3	1	1	0	1	3
23579	289564	3	3	0	2	3	8
23579	289568	3	1	0	0	0	1
23579	289573	3	1	1	0	1	3
23579	289574	3	0	1	0	1	2
23579	289577	3	0	0	0	0	0
23579	289589	3	0	1	0	0	1
23579	289598	3	0	0	0	0	0
23579	289599	3	0	0	0	0	0
23579	616905	3	2	0	0	0	2
23579	616910	3	1	1	0	2	4
23579	616918	3	1	1	0	0	2
23579	616920	3	1	0	0	0	1
23579	616923	3	0	1	0	0	1
23579	616925	3	0	1	0	0	1
23579	616926	3	0	1	0	0	1
23579	616932	3	1	0	0	0	1
23579	616937	3	0	0	0	2	2
23579	616938	3	0	1	0	0	1
23579	616939	3	1	0	0	0	1
23579	616949	3	1	0	0	1	2
23579	616950	3	0	0	0	2	2
23579	616953	3	0	0	0	0	0
23579	616971	3	1	0	0	1	2
23579	616982	3	1	0	0	1	2
23579	616996	3	2	1	0	0	3
23579	616997	3	0	3	0	1	4
23579	616999	3	0	1	0	1	2
23579	617003	3	1	1	0	0	2
23579	617010	3	2	0	0	0	2
23579	617019	3	2	1	2	1	6
23579	617025	3	0	0	0	1	1
23579	617031	3	1	1	1	1	4
23579	182996	2	0	2	1	2	5
23579	189590	2	0	0	0	0	0
23579	191131	2	2	0	0	1	3
23579	191226	2	0	1	0	1	2
23579	193058	2	0	1	1	2	4
23579	194284	2	0	2	0	0	2
23579	201990	2	0	1	0	2	3
23579	203271	2	1	2	0	0	3
23579	205430	2	1	1	0	2	4
23579	207916	2	0	2	0	1	3
23579	209818	2	0	1	0	0	1
23579	212508	2	0	0	0	0	0
23579	215271	2	1	1	1	1	4
23579	215330	2	0	1	0	1	2
23579	221552	2	0	0	0	4	4
23579	289582	2	0	2	0	1	3
23579	289584	2	0	2	1	2	5
23579	616903	2	1	1	1	0	3
23579	616909	2	2	2	0	1	5
23579	616911	2	0	0	0	0	0
23579	616927	2	1	1	0	1	3
23579	616928	2	1	0	0	0	1
23579	616941	2	1	0	0	0	1
23579	616944	2	1	2	0	0	3
23579	616948	2	0	1	0	2	3
23579	616957	2	1	2	0	1	4
23579	616959	2	2	0	0	0	2
23579	616963	2	0	3	0	0	3
23579	616965	2	0	2	0	1	3
23579	616994	2	0	0	0	1	1
23579	182654	1	0	0	0	0	0
23579	186542	1	0	1	0	1	2
23579	190737	1	0	0	0	0	0
23579	193690	1	0	0	0	1	1
23579	194973	1	0	0	0	1	1
23579	205324	1	0	0	0	0	0
23579	208748	1	1	1	0	0	2
23579	212001	1	0	0	0	0	0
23579	218039	1	0	1	0	1	2
23579	289576	1	0	0	0	0	0
23579	616929	1	1	0	0	1	2
23579	616954	1	1	0	0	1	2
23579	616961	1	2	0	0	1	3
23579	616964	1	1	0	0	1	2
23579	616980	1	1	1	0	1	3
23579	616986	1	1	0	0	0	1
34262	191444	29	2	5	2	5	14
34262	198351	24	2	6	2	6	16
34262	292351	24	1	6	1	4	12
34262	73663	24	2	6	2	6	16
34262	197297	23	0	0	2	0	2
34262	292347	23	0	0	2	0	2
34262	89335	23	0	0	2	0	2
34262	478235	22	0	0	2	0	2
34262	204779	21	2	4	2	1	9
34262	292348	21	0	5	3	4	12
34262	62207	21	0	5	3	4	12
34262	478226	20	2	2	1	2	7
34262	478233	20	4	2	1	7	14
34262	478234	20	4	2	1	7	14
34262	478249	20	2	4	2	1	9
34262	292346	19	9	3	0	3	15
34262	478228	19	2	2	0	0	4
34262	478334	19	1	3	1	0	5
34262	52479	19	9	3	0	3	15
34262	184600	18	2	0	0	0	2
34262	198175	18	0	1	0	0	1
34262	199407	18	2	4	0	3	9
34262	292355	18	1	2	3	4	10
34262	478243	18	2	5	2	3	12
34262	478244	18	0	1	0	0	1
34262	478326	18	1	5	4	3	13
34262	87257	18	1	2	3	4	10
34262	198106	17	0	0	0	1	1
34262	478239	17	1	4	2	2	9
34262	478245	17	1	2	3	4	10
34262	181938	16	1	4	2	2	9
34262	181939	16	1	4	2	2	9
34262	220509	16	1	6	1	4	12
34262	478232	16	0	0	0	1	1
34262	478236	16	1	6	1	4	12
34262	478212	15	2	2	2	4	10
34262	478213	15	2	2	2	4	10
34262	292342	14	1	0	0	2	3
34262	292353	14	1	2	0	1	4
34262	478238	14	1	2	0	1	4
34262	478247	14	0	0	1	0	1
34262	478286	14	0	1	2	1	4
34262	192707	13	1	8	2	5	16
34262	292356	13	1	8	2	5	16
34262	478215	13	2	0	0	0	2
34262	478225	13	1	4	1	1	7
34262	478242	13	1	8	2	5	16
34262	65973	13	1	8	2	5	16
34262	184621	12	0	0	0	2	2
34262	205293	12	2	4	1	0	7
34262	217206	12	4	2	0	2	8
34262	478322	12	1	2	1	2	6
34262	478339	12	1	2	0	2	5
34262	184752	11	1	3	0	9	13
34262	292354	11	1	3	0	9	13
34262	292360	11	0	2	1	1	4
34262	478209	11	0	2	0	2	4
34262	478320	11	5	0	0	2	7
34262	478338	11	2	4	0	4	10
34262	54210	11	1	3	0	9	13
34262	56320	11	0	2	1	1	4
34262	97160	11	0	2	0	2	4
34262	478210	10	1	3	2	0	6
34262	478240	10	3	2	1	1	7
34262	478256	10	0	0	0	1	1
34262	59269	10	3	1	0	2	6
34262	190573	9	0	1	0	2	3
34262	205251	9	2	0	1	0	3
34262	214452	9	0	0	0	0	0
34262	292352	9	0	1	0	0	1
34262	478223	9	2	4	0	0	6
34262	478241	9	1	3	0	9	13
34262	478306	9	1	2	0	2	5
34262	478344	9	0	2	0	1	3
34262	70779	9	0	1	0	0	1
34262	192577	8	0	0	0	0	0
34262	203899	8	2	1	0	1	4
34262	478218	8	1	1	0	0	2
34262	478316	8	2	1	1	0	4
34262	478318	8	1	3	0	2	6
34262	199780	7	1	1	1	0	3
34262	203030	7	3	3	1	2	9
34262	292358	7	0	4	1	1	6
34262	478216	7	1	1	1	0	3
34262	478217	7	1	0	0	0	1
34262	478219	7	3	0	0	2	5
34262	478220	7	2	1	0	2	5
34262	478255	7	2	4	1	0	7
34262	478285	7	4	1	1	0	6
34262	478294	7	1	0	0	1	2
34262	478297	7	1	0	1	2	4
34262	478302	7	2	1	0	1	4
34262	478304	7	1	3	1	0	5
34262	478305	7	0	0	0	0	0
34262	478310	7	1	1	0	2	4
34262	478345	7	2	0	0	1	3
34262	73846	7	1	2	0	1	4
34262	93218	7	0	4	1	1	6
34262	183518	6	1	0	0	2	3
34262	191689	6	0	3	0	3	6
34262	192211	6	0	0	0	0	0
34262	194347	6	1	0	0	0	1
34262	214587	6	1	1	1	0	3
34262	220033	6	2	2	1	1	6
34262	292337	6	0	4	0	1	5
34262	292361	6	1	0	0	0	1
34262	478205	6	2	0	0	0	2
34262	478230	6	1	1	5	1	8
34262	478231	6	0	0	0	0	0
34262	478252	6	0	0	1	3	4
34262	478254	6	4	4	2	2	12
34262	478257	6	2	2	0	0	4
34262	478261	6	4	1	1	1	7
34262	478263	6	1	1	0	1	3
34262	478274	6	0	2	0	1	3
34262	478282	6	1	1	1	0	3
34262	478298	6	0	1	0	0	1
34262	94524	6	0	4	0	1	5
34262	184592	5	0	0	0	0	0
34262	189721	5	1	0	1	0	2
34262	190486	5	2	1	0	0	3
34262	193697	5	1	3	0	2	6
34262	201237	5	0	1	0	1	2
34262	202232	5	0	0	0	0	0
34262	203147	5	2	0	0	0	2
34262	214255	5	0	0	0	2	2
34262	215402	5	1	0	0	0	1
34262	292339	5	0	1	0	2	3
34262	478222	5	1	0	1	1	3
34262	478250	5	2	0	0	0	2
34262	478251	5	0	1	0	1	2
34262	478259	5	2	0	0	0	2
34262	478260	5	0	0	0	1	1
34262	478265	5	1	0	0	1	2
34262	478266	5	3	0	0	0	3
34262	478296	5	1	1	0	2	4
34262	478299	5	2	1	0	0	3
34262	478301	5	2	0	1	0	3
34262	478303	5	1	1	0	1	3
34262	478307	5	1	0	0	1	2
34262	478308	5	1	1	0	1	3
34262	478309	5	1	0	0	4	5
34262	478323	5	2	0	0	1	3
34262	478324	5	3	1	0	1	5
34262	478325	5	1	0	0	2	3
34262	478328	5	1	0	0	5	6
34262	478333	5	2	5	0	3	10
34262	478336	5	1	0	0	0	1
34262	69664	5	0	1	0	2	3
34262	75075	5	1	0	1	1	3
34262	193593	4	1	0	0	1	2
34262	197478	4	0	2	1	0	3
34262	198165	4	0	0	0	0	0
34262	199104	4	2	0	0	1	3
34262	206907	4	3	0	0	0	3
34262	209050	4	1	0	0	0	1
34262	210071	4	0	1	1	0	2
34262	210307	4	1	1	0	3	5
34262	211221	4	1	0	0	0	1
34262	212897	4	1	0	0	1	2
34262	214123	4	0	0	0	3	3
34262	292338	4	0	2	1	0	3
34262	292349	4	1	1	0	1	3
34262	292363	4	0	2	0	0	2
34262	478206	4	0	3	0	0	3
34262	478208	4	1	0	0	0	1
34262	478214	4	1	2	0	0	3
34262	478221	4	0	2	0	3	5
34262	478227	4	0	0	0	1	1
34262	478248	4	0	0	0	1	1
34262	478253	4	0	2	1	0	3
34262	478262	4	0	2	0	3	5
34262	478268	4	2	3	1	0	6
34262	478269	4	1	0	0	1	2
34262	478270	4	0	0	0	0	0
34262	478275	4	1	1	0	0	2
34262	478276	4	2	0	0	1	3
34262	478278	4	0	0	0	0	0
34262	478280	4	0	1	0	0	1
34262	478283	4	1	0	0	0	1
34262	478284	4	0	0	0	0	0
34262	478287	4	1	1	0	2	4
34262	478288	4	0	0	0	2	2
34262	478289	4	1	0	0	2	3
34262	478290	4	0	1	0	2	3
34262	478291	4	0	1	0	0	1
34262	478293	4	2	2	1	0	5
34262	478317	4	2	2	0	1	5
34262	478319	4	2	0	0	0	2
34262	478321	4	0	1	1	0	2
34262	478332	4	1	0	0	0	1
34262	478337	4	1	0	0	1	2
34262	478340	4	0	0	0	0	0
34262	478341	4	0	0	0	2	2
34262	478343	4	2	0	0	0	2
34262	71240	4	1	1	0	1	3
34262	72747	4	0	2	1	0	3
34262	72839	4	0	2	1	0	3
34262	187007	3	0	0	0	2	2
34262	191004	3	2	0	0	0	2
34262	191583	3	0	1	0	1	2
34262	196063	3	0	0	0	0	0
34262	199183	3	0	1	0	0	1
34262	203081	3	0	0	0	1	1
34262	203751	3	1	0	0	0	1
34262	204925	3	0	0	0	0	0
34262	204940	3	0	1	0	1	2
34262	215822	3	0	1	0	1	2
34262	292340	3	0	2	0	0	2
34262	292345	3	0	1	0	1	2
34262	292350	3	0	1	0	1	2
34262	292357	3	0	0	0	1	1
34262	292359	3	1	0	0	0	1
34262	292365	3	1	0	0	0	1
34262	478211	3	0	4	1	0	5
34262	478271	3	3	0	0	2	5
34262	478281	3	2	0	0	2	4
34262	478295	3	0	0	0	0	0
34262	478311	3	1	0	0	2	3
34262	478312	3	2	1	1	2	6
34262	478315	3	1	0	0	2	3
34262	478329	3	0	1	0	0	1
34262	478330	3	1	2	1	0	4
34262	478335	3	2	2	0	0	4
34262	83823	3	1	0	0	0	1
34262	84702	3	0	1	0	1	2
34262	185381	2	0	0	0	0	0
34262	185892	2	0	0	0	0	0
34262	190525	2	0	0	0	0	0
34262	195647	2	0	0	0	0	0
34262	201389	2	2	1	0	0	3
34262	207256	2	1	0	0	0	1
34262	207481	2	0	0	0	2	2
34262	210527	2	0	0	0	0	0
34262	213911	2	1	1	0	1	3
34262	217160	2	0	0	0	0	0
34262	292341	2	0	1	0	4	5
34262	478207	2	0	2	0	0	2
34262	478224	2	0	2	0	0	2
34262	478229	2	0	1	0	1	2
34262	478267	2	0	0	0	0	0
34262	478272	2	1	0	0	0	1
34262	478273	2	0	2	0	0	2
34262	478279	2	0	1	0	1	2
34262	478292	2	0	2	3	0	5
34262	478300	2	0	0	0	0	0
34262	478314	2	0	1	0	7	8
34262	478331	2	1	1	0	1	3
34262	478342	2	1	0	0	1	2
34262	63508	2	0	0	0	0	0
34262	64453	2	0	1	0	4	5
34262	195690	1	0	0	0	0	0
34262	200042	1	0	0	0	1	1
34262	203188	1	0	0	0	0	0
34262	206503	1	0	0	0	0	0
34262	210756	1	0	1	0	0	1
34262	211983	1	1	4	1	3	9
34262	292362	1	0	0	0	1	1
34262	292364	1	0	0	0	0	0
34262	292366	1	0	1	0	0	1
34262	478258	1	0	2	0	2	4
34262	478264	1	0	3	0	7	10
34262	478277	1	0	0	0	0	0
34262	478313	1	0	0	0	1	1
34262	478327	1	0	3	0	0	3
34262	70168	1	0	0	0	0	0
31625	63830	39	0	0	0	1	1
31625	203221	32	1	1	1	0	3
31625	203222	32	1	1	1	0	3
31625	210624	27	2	6	2	7	17
31625	187424	25	2	0	1	6	9
31625	78510	25	3	4	1	1	9
31625	278616	23	3	3	0	5	11
31625	57442	23	3	3	0	5	11
31625	578826	23	3	3	0	5	11
31625	69098	23	1	1	1	5	8
31625	278607	20	5	2	1	1	9
31625	52465	20	5	2	1	1	9
31625	188409	17	1	2	0	1	4
31625	188856	17	0	1	0	1	2
31625	278605	17	0	0	1	0	1
31625	97930	17	0	0	1	0	1
31625	278642	16	0	1	0	1	2
31625	59820	16	0	1	0	1	2
31625	578832	13	2	2	2	2	8
31625	103164	12	1	3	1	1	6
31625	186039	12	0	2	0	1	3
31625	216230	12	1	2	1	1	5
31625	278641	12	1	3	1	1	6
31625	535265	12	1	3	0	2	6
31625	535270	12	1	4	0	2	7
31625	535278	12	1	2	1	1	5
31625	212211	11	3	2	0	2	7
31625	577764	11	3	2	0	2	7
31625	578782	11	3	2	0	2	7
31625	578823	11	1	3	0	2	6
31625	183909	10	0	0	0	0	0
31625	197372	10	2	3	0	2	7
31625	212332	10	2	0	0	3	5
31625	220530	10	0	0	0	2	2
31625	278610	10	2	3	0	2	7
31625	578806	10	2	0	0	1	3
31625	72743	10	2	3	0	2	7
31625	105314	9	3	1	1	2	7
31625	188016	9	2	4	0	2	8
31625	214443	9	0	2	0	0	2
31625	217383	9	1	0	0	0	1
31625	221755	9	1	3	0	1	5
31625	278595	9	3	1	1	2	7
31625	51272	9	2	0	0	0	2
31625	578784	9	2	1	1	1	5
31625	578786	9	1	0	0	1	2
31625	578827	9	3	4	0	3	10
31625	211070	8	0	1	0	2	3
31625	278594	8	3	1	2	2	8
31625	278602	8	2	0	0	0	2
31625	278633	8	2	0	0	0	2
31625	535276	8	0	0	2	3	5
31625	535277	8	0	1	0	3	4
31625	577759	8	0	1	0	0	1
31625	578771	8	3	2	0	0	5
31625	578789	8	1	0	0	1	2
31625	578794	8	0	0	0	2	2
31625	83364	8	3	1	2	2	8
31625	87735	8	2	0	0	0	2
31625	183201	7	0	1	0	1	2
31625	183330	7	1	3	2	4	10
31625	184841	7	0	2	0	1	3
31625	187493	7	1	1	1	0	3
31625	278601	7	0	3	0	1	4
31625	278628	7	2	0	0	3	5
31625	278629	7	0	1	0	1	2
31625	278634	7	0	2	0	1	3
31625	535267	7	1	3	2	4	10
31625	535268	7	0	1	0	0	1
31625	535275	7	0	1	0	1	2
31625	54203	7	0	2	0	1	3
31625	577769	7	1	0	0	2	3
31625	578775	7	1	0	0	2	3
31625	578781	7	0	1	0	1	2
31625	578785	7	2	1	0	0	3
31625	578796	7	0	1	1	0	2
31625	578813	7	3	1	1	1	6
31625	578814	7	0	0	1	2	3
31625	578816	7	2	0	0	1	3
31625	578822	7	1	1	0	1	3
31625	578829	7	0	0	0	0	0
31625	70776	7	0	3	0	1	4
31625	91954	7	0	1	0	1	2
31625	185682	6	1	0	0	2	3
31625	197248	6	5	4	0	1	10
31625	201693	6	0	1	0	0	1
31625	207976	6	0	2	0	1	3
31625	216798	6	1	2	0	2	5
31625	278596	6	1	1	0	0	2
31625	278606	6	0	2	1	0	3
31625	278624	6	0	2	0	1	3
31625	278630	6	1	0	0	1	2
31625	278635	6	2	2	0	2	6
31625	535266	6	0	0	1	0	1
31625	53865	6	1	0	0	1	2
31625	577757	6	0	0	0	1	1
31625	577762	6	2	1	0	3	6
31625	578791	6	2	3	0	0	5
31625	578800	6	1	0	0	1	2
31625	578807	6	2	1	0	3	6
31625	578812	6	0	1	0	0	1
31625	71116	6	2	2	0	2	6
31625	80752	6	0	2	1	0	3
31625	84689	6	0	2	0	1	3
31625	184278	5	1	2	0	0	3
31625	193527	5	1	4	1	1	7
31625	206519	5	2	2	0	2	6
31625	206834	5	0	2	0	0	2
31625	278598	5	0	0	0	0	0
31625	278612	5	0	2	0	3	5
31625	278626	5	0	1	0	0	1
31625	535279	5	2	1	0	1	4
31625	577765	5	1	1	0	1	3
31625	577768	5	1	1	0	1	3
31625	578777	5	2	0	0	1	3
31625	578783	5	1	2	0	0	3
31625	578787	5	0	1	1	0	2
31625	578803	5	2	5	0	0	7
31625	578809	5	1	2	0	1	4
31625	578818	5	1	1	0	0	2
31625	578820	5	1	0	0	0	1
31625	578831	5	1	0	0	1	2
31625	79315	5	0	0	0	0	0
31625	101058	4	1	1	1	3	6
31625	184960	4	0	1	1	0	2
31625	186993	4	1	1	0	0	2
31625	188437	4	1	1	0	1	3
31625	192777	4	2	1	0	0	3
31625	194810	4	1	1	0	0	2
31625	196969	4	1	0	0	0	1
31625	200544	4	1	2	0	1	4
31625	201772	4	0	1	0	1	2
31625	202656	4	1	2	0	0	3
31625	203045	4	0	2	0	3	5
31625	218041	4	0	1	0	4	5
31625	220663	4	1	0	0	0	1
31625	278599	4	0	1	0	0	1
31625	278613	4	1	1	1	3	6
31625	278615	4	0	1	0	1	2
31625	535264	4	0	1	1	1	3
31625	535271	4	0	1	0	0	1
31625	577753	4	1	1	0	1	3
31625	578770	4	1	2	0	0	3
31625	578773	4	0	0	0	3	3
31625	578774	4	0	1	0	1	2
31625	578788	4	1	1	0	3	5
31625	578793	4	0	1	0	0	1
31625	578795	4	1	2	0	1	4
31625	578798	4	0	2	0	3	5
31625	578828	4	0	0	1	1	2
31625	64167	4	1	0	0	0	1
31625	71540	4	0	1	0	0	1
31625	94607	4	0	1	0	2	3
31625	189150	3	0	0	0	1	1
31625	192780	3	1	0	0	0	1
31625	193678	3	0	0	1	0	1
31625	195701	3	0	1	0	2	3
31625	199875	3	1	0	0	0	1
31625	200089	3	0	0	0	0	0
31625	203229	3	1	2	0	1	4
31625	203850	3	0	3	0	1	4
31625	205965	3	2	0	0	0	2
31625	206998	3	0	1	0	0	1
31625	207913	3	0	0	0	0	0
31625	215318	3	0	3	1	1	5
31625	216393	3	1	1	0	1	3
31625	278597	3	0	1	0	0	1
31625	278603	3	0	0	0	3	3
31625	278618	3	0	0	0	0	0
31625	278619	3	0	0	0	0	0
31625	278620	3	1	2	0	0	3
31625	278621	3	0	1	0	0	1
31625	278625	3	0	0	1	0	1
31625	535269	3	0	1	0	1	2
31625	535273	3	0	0	0	1	1
31625	577755	3	0	2	0	1	3
31625	577756	3	0	0	0	0	0
31625	577758	3	1	2	1	1	5
31625	577766	3	0	0	0	1	1
31625	577767	3	0	2	0	2	4
31625	578763	3	1	2	0	1	4
31625	578764	3	1	1	0	1	3
31625	578765	3	0	2	0	1	3
31625	578766	3	0	1	0	0	1
31625	578769	3	2	1	0	1	4
31625	578776	3	1	2	0	0	3
31625	578779	3	0	0	0	0	0
31625	578797	3	1	0	0	2	3
31625	578799	3	0	2	0	0	2
31625	578801	3	1	2	0	0	3
31625	578802	3	1	2	0	0	3
31625	578804	3	0	0	0	2	2
31625	578805	3	0	0	0	1	1
31625	578808	3	0	0	0	1	1
31625	578810	3	0	0	1	1	2
31625	578819	3	2	1	0	0	3
31625	578830	3	0	1	0	0	1
31625	578833	3	0	3	0	1	4
31625	578835	3	1	2	0	0	3
31625	64427	3	0	0	0	3	3
31625	71006	3	0	1	0	0	1
31625	183990	2	1	2	0	0	3
31625	188467	2	0	1	0	1	2
31625	191029	2	1	0	0	1	2
31625	197167	2	1	1	0	1	3
31625	199988	2	0	1	0	1	2
31625	207171	2	0	0	0	1	1
31625	208712	2	0	0	0	1	1
31625	209619	2	0	1	0	0	1
31625	211869	2	0	3	0	1	4
31625	220211	2	0	1	0	1	2
31625	220802	2	0	0	0	1	1
31625	278600	2	0	0	0	0	0
31625	278604	2	0	2	2	0	4
31625	278608	2	0	1	0	1	2
31625	278611	2	1	1	0	1	3
31625	278614	2	0	2	0	0	2
31625	278617	2	0	0	0	0	0
31625	278623	2	0	0	0	0	0
31625	278636	2	0	0	0	0	0
31625	278638	2	1	0	0	0	1
31625	278640	2	1	1	0	1	3
31625	535272	2	0	0	0	2	2
31625	54724	2	1	1	0	1	3
31625	578768	2	0	0	0	1	1
31625	578772	2	2	0	0	0	2
31625	578778	2	0	1	0	1	2
31625	578780	2	0	0	0	0	0
31625	578790	2	1	0	0	1	2
31625	578792	2	1	1	0	0	2
31625	578821	2	0	0	1	1	2
31625	578824	2	1	0	0	1	2
31625	578825	2	0	1	0	0	1
31625	71289	2	0	0	0	0	0
31625	74965	2	0	0	1	0	1
31625	86010	2	1	1	0	1	3
31625	185603	1	0	1	0	1	2
31625	191219	1	3	0	0	2	5
31625	197180	1	1	2	0	0	3
31625	199971	1	0	1	0	0	1
31625	209644	1	1	0	0	0	1
31625	209819	1	0	1	0	1	2
31625	213378	1	0	1	0	0	1
31625	213471	1	0	0	0	1	1
31625	278609	1	0	1	0	0	1
31625	278622	1	0	0	0	0	0
31625	278627	1	0	1	0	1	2
31625	278631	1	0	0	0	0	0
31625	278632	1	0	0	0	0	0
31625	278637	1	0	0	0	0	0
31625	278639	1	0	0	0	0	0
31625	535274	1	1	1	0	0	2
31625	577754	1	1	2	0	0	3
31625	577760	1	0	1	0	0	1
31625	578762	1	0	0	0	1	1
31625	578767	1	0	0	0	0	0
31625	578811	1	1	0	0	0	1
31625	578815	1	1	4	0	0	5
31625	578817	1	2	1	1	2	6
31625	578834	1	1	0	0	1	2
31625	609640	1	1	0	0	0	1
31625	84099	1	0	2	0	0	2
31625	98464	1	0	1	0	0	1
51047	210649	34	7	13	4	2	26
51047	380129	34	7	13	4	2	26
51047	202325	29	3	3	1	1	8
51047	296716	28	3	3	1	1	8
51047	380092	28	3	3	1	1	8
51047	380111	19	3	9	1	0	13
51047	186107	18	1	1	0	0	2
51047	183994	17	3	10	0	1	14
51047	210234	17	0	3	0	3	6
51047	296733	17	1	1	0	0	2
51047	380107	16	2	1	0	0	3
51047	220818	13	1	3	0	0	4
51047	380138	13	1	1	0	1	3
51047	296734	11	2	1	2	0	5
51047	200560	10	0	2	0	0	2
51047	296732	10	1	1	0	0	2
51047	296737	10	1	1	0	0	2
51047	380219	10	0	1	0	0	1
51047	380122	9	0	2	0	0	2
51047	380150	9	4	4	0	3	11
51047	380170	9	1	1	0	0	2
51047	380196	9	1	2	0	0	3
51047	197339	8	1	1	0	2	4
51047	210963	8	0	1	1	0	2
51047	221848	8	2	1	2	0	5
51047	380121	8	1	1	0	1	3
51047	380159	8	6	3	0	0	9
51047	380194	8	1	4	0	0	5
51047	380198	8	1	1	1	0	3
51047	380200	8	3	1	0	0	4
51047	195268	7	0	3	1	0	4
51047	200617	7	1	6	0	0	7
51047	205879	7	1	2	0	1	4
51047	208307	7	0	0	0	0	0
51047	211610	7	0	0	0	0	0
51047	296720	7	1	1	0	2	4
51047	296721	7	0	2	0	0	2
51047	296729	7	1	1	0	0	2
51047	296747	7	2	1	0	0	3
51047	296748	7	0	1	0	0	1
51047	380188	7	2	4	0	0	6
51047	380197	7	1	2	0	0	3
51047	186034	6	0	2	0	0	2
51047	188206	6	3	2	0	0	5
51047	189903	6	0	1	0	0	1
51047	217068	6	2	4	0	1	7
51047	296724	6	0	1	0	0	1
51047	296728	6	1	0	1	0	2
51047	296738	6	1	1	0	0	2
51047	296749	6	2	1	0	1	4
51047	380103	6	0	2	0	1	3
51047	380142	6	0	1	0	0	1
51047	380145	6	0	0	0	0	0
51047	380158	6	1	2	0	0	3
51047	380175	6	0	0	1	0	1
51047	380179	6	2	2	1	0	5
51047	380180	6	1	1	0	0	2
51047	380189	6	2	2	0	0	4
51047	380193	6	1	1	0	1	3
51047	380195	6	1	4	0	0	5
51047	380202	6	1	5	0	0	6
51047	380218	6	2	1	0	0	3
51047	190722	5	1	2	0	0	3
51047	192440	5	0	0	0	0	0
51047	194732	5	0	1	0	0	1
51047	199905	5	0	3	0	0	3
51047	200439	5	0	2	0	0	2
51047	201848	5	1	0	0	0	1
51047	207374	5	1	1	0	0	2
51047	211410	5	2	1	0	1	4
51047	216429	5	1	1	1	0	3
51047	216707	5	0	2	0	2	4
51047	216757	5	1	0	0	1	2
51047	220155	5	1	2	0	0	3
51047	220249	5	1	3	0	1	5
51047	296742	5	1	2	0	0	3
51047	296744	5	0	2	0	0	2
51047	296746	5	1	2	0	1	4
51047	380089	5	0	2	0	0	2
51047	380116	5	1	0	0	1	2
51047	380118	5	1	2	0	0	3
51047	380140	5	0	0	0	0	0
51047	380152	5	0	0	0	0	0
51047	380164	5	1	0	0	0	1
51047	380168	5	0	1	0	0	1
51047	380169	5	0	0	0	0	0
51047	380171	5	1	0	0	0	1
51047	380172	5	2	0	0	0	2
51047	380178	5	2	3	0	0	5
51047	380184	5	1	0	0	0	1
51047	380185	5	3	1	0	0	4
51047	380203	5	0	2	0	0	2
51047	380210	5	0	2	0	3	5
51047	380211	5	4	2	0	0	6
51047	380215	5	0	2	0	0	2
51047	380222	5	1	2	0	0	3
51047	380223	5	2	3	0	0	5
51047	182721	4	0	0	0	0	0
51047	188989	4	0	0	0	0	0
51047	196056	4	1	1	0	0	2
51047	200233	4	0	0	0	0	0
51047	202033	4	1	2	0	0	3
51047	203056	4	2	4	0	0	6
51047	205385	4	1	0	0	0	1
51047	207051	4	0	1	0	0	1
51047	208166	4	0	2	0	0	2
51047	208369	4	0	2	0	0	2
51047	211794	4	1	0	0	0	1
51047	212975	4	0	1	0	1	2
51047	221601	4	0	3	0	1	4
51047	296717	4	1	3	0	1	5
51047	296719	4	0	2	0	0	2
51047	296722	4	1	1	0	0	2
51047	296741	4	0	1	0	0	1
51047	380095	4	1	1	0	0	2
51047	380096	4	1	1	0	0	2
51047	380098	4	1	0	0	0	1
51047	380101	4	1	2	0	1	4
51047	380105	4	0	1	0	0	1
51047	380110	4	3	1	0	0	4
51047	380120	4	2	1	0	0	3
51047	380124	4	0	1	0	1	2
51047	380130	4	0	2	0	2	4
51047	380131	4	0	4	0	0	4
51047	380133	4	0	2	0	0	2
51047	380135	4	0	1	0	0	1
51047	380139	4	1	2	0	0	3
51047	380143	4	2	4	0	0	6
51047	380148	4	1	1	0	0	2
51047	380149	4	1	1	0	0	2
51047	380154	4	0	1	0	0	1
51047	380155	4	1	1	0	0	2
51047	380157	4	1	1	0	1	3
51047	380160	4	0	1	0	0	1
51047	380161	4	0	1	0	1	2
51047	380162	4	1	0	0	0	1
51047	380174	4	2	3	0	0	5
51047	380181	4	2	1	0	1	4
51047	380182	4	1	1	0	1	3
51047	380187	4	2	2	0	0	4
51047	380190	4	2	2	0	0	4
51047	380191	4	0	0	0	0	0
51047	380199	4	1	2	0	0	3
51047	380204	4	0	2	0	0	2
51047	380205	4	1	0	0	0	1
51047	380214	4	2	2	0	0	4
51047	380216	4	2	3	0	1	6
51047	380220	4	0	0	0	1	1
51047	380225	4	0	2	0	1	3
51047	380227	4	1	2	0	0	3
51047	182723	3	0	2	0	0	2
51047	186666	3	1	1	0	0	2
51047	186815	3	1	2	0	0	3
51047	187066	3	1	0	0	0	1
51047	188435	3	1	1	0	0	2
51047	188462	3	0	2	1	0	3
51047	192405	3	0	0	0	0	0
51047	195752	3	0	1	0	0	1
51047	200100	3	1	1	0	1	3
51047	204443	3	0	0	0	0	0
51047	205239	3	0	1	0	1	2
51047	205504	3	2	2	0	0	4
51047	206048	3	0	2	0	0	2
51047	208725	3	0	1	0	0	1
51047	209374	3	0	0	0	1	1
51047	210332	3	0	2	0	0	2
51047	210551	3	1	0	0	0	1
51047	213380	3	1	2	0	0	3
51047	214726	3	0	1	0	0	1
51047	216781	3	0	2	0	0	2
51047	216960	3	1	3	0	0	4
51047	218426	3	1	0	0	0	1
51047	221506	3	0	0	0	0	0
51047	221517	3	1	2	0	0	3
51047	296731	3	0	2	0	0	2
51047	296735	3	1	1	0	0	2
51047	296736	3	1	0	0	0	1
51047	296750	3	2	3	0	1	6
51047	380085	3	0	3	1	0	4
51047	380090	3	0	0	0	0	0
51047	380091	3	0	1	0	0	1
51047	380094	3	0	0	0	0	0
51047	380097	3	0	0	0	0	0
51047	380100	3	0	2	0	0	2
51047	380108	3	1	3	0	0	4
51047	380109	3	1	2	0	0	3
51047	380112	3	0	2	0	0	2
51047	380119	3	0	2	0	0	2
51047	380127	3	0	1	0	1	2
51047	380128	3	0	0	0	0	0
51047	380134	3	1	1	0	0	2
51047	380137	3	0	3	0	0	3
51047	380153	3	1	1	0	0	2
51047	380156	3	0	1	0	0	1
51047	380165	3	1	1	0	0	2
51047	380166	3	2	2	0	0	4
51047	380167	3	1	1	0	0	2
51047	380177	3	0	1	0	0	1
51047	380183	3	0	0	0	0	0
51047	380192	3	1	1	0	0	2
51047	380206	3	0	1	0	1	2
51047	380212	3	0	1	0	0	1
51047	380217	3	2	3	0	0	5
51047	380221	3	1	0	0	0	1
51047	191238	2	1	2	0	0	3
51047	197036	2	1	1	0	1	3
51047	201286	2	0	2	0	0	2
51047	204938	2	0	0	0	0	0
51047	217298	2	0	1	0	0	1
51047	296718	2	0	0	0	0	0
51047	296725	2	1	1	0	0	2
51047	296726	2	1	3	0	0	4
51047	296730	2	0	1	0	1	2
51047	296739	2	0	3	1	0	4
51047	296740	2	0	2	0	0	2
51047	296743	2	0	1	0	0	1
51047	296745	2	0	0	0	0	0
51047	380086	2	0	0	0	0	0
51047	380087	2	0	3	0	0	3
51047	380099	2	0	1	0	0	1
51047	380106	2	0	2	0	0	2
51047	380113	2	1	1	0	0	2
51047	380114	2	0	2	0	0	2
51047	380115	2	0	0	0	1	1
51047	380132	2	1	1	0	1	3
51047	380136	2	2	3	0	0	5
51047	380144	2	0	2	0	0	2
51047	380151	2	2	0	0	0	2
51047	380163	2	1	1	0	0	2
51047	380173	2	1	0	0	0	1
51047	380176	2	1	3	0	0	4
51047	380186	2	0	2	0	0	2
51047	380201	2	2	1	0	0	3
51047	380207	2	0	1	0	0	1
51047	380208	2	0	0	0	0	0
51047	380209	2	0	0	0	0	0
51047	380213	2	0	2	0	0	2
51047	380224	2	0	1	0	1	2
51047	185647	1	0	1	0	0	1
51047	192454	1	0	1	0	0	1
51047	192781	1	0	0	0	0	0
51047	193308	1	0	1	0	1	2
51047	196413	1	0	0	0	0	0
51047	209369	1	0	1	0	0	1
51047	213472	1	0	1	0	0	1
51047	213481	1	1	1	0	0	2
51047	214230	1	0	0	0	0	0
51047	214396	1	0	2	0	0	2
51047	296723	1	0	2	0	0	2
51047	296727	1	0	1	0	0	1
51047	380088	1	1	1	0	0	2
51047	380093	1	0	0	0	1	1
51047	380102	1	0	2	0	0	2
51047	380104	1	0	0	0	2	2
51047	380117	1	1	2	0	0	3
51047	380123	1	0	1	0	0	1
51047	380125	1	0	1	0	1	2
51047	380126	1	0	1	0	0	1
51047	380141	1	5	4	0	0	9
51047	380146	1	1	1	0	0	2
51047	380147	1	2	0	0	0	2
51047	380226	1	0	0	0	0	0
32943	107851	33	2	2	0	1	5
32943	104232	31	5	3	2	2	12
32943	82444	31	2	6	2	5	15
32943	68977	27	4	4	1	0	9
32943	81151	23	1	6	0	1	8
32943	492885	20	4	5	0	2	11
32943	74916	20	0	4	2	0	6
32943	492890	18	4	4	2	2	12
32943	492884	17	2	3	2	0	7
32943	492880	16	0	3	0	1	4
32943	55396	14	0	0	0	0	0
32943	82015	14	1	2	1	0	4
32943	492816	13	2	2	1	1	6
32943	492982	13	3	0	0	0	3
32943	95552	12	2	2	4	3	11
32943	199821	11	0	2	2	0	4
32943	492813	11	0	6	1	0	7
32943	100935	10	3	0	0	4	7
32943	186014	10	2	1	0	1	4
32943	492828	10	0	1	0	1	2
32943	492856	10	0	3	0	2	5
32943	492911	10	3	4	2	0	9
32943	73262	10	2	3	1	0	6
32943	75188	10	0	2	2	0	4
32943	61950	9	0	3	0	0	3
32943	81302	9	5	0	1	0	6
32943	85286	9	2	2	1	1	6
32943	104568	8	3	0	0	1	4
32943	492857	8	1	1	1	3	6
32943	492953	8	1	1	1	0	3
32943	492969	8	2	3	0	0	5
32943	492974	8	4	0	0	0	4
32943	492983	8	5	0	1	0	6
32943	492991	8	0	0	1	0	1
32943	492820	7	1	1	0	0	2
32943	492842	7	2	0	0	0	2
32943	492846	7	3	2	0	0	5
32943	492871	7	1	0	0	0	1
32943	492908	7	2	4	0	0	6
32943	492946	7	2	2	1	1	6
32943	492965	7	1	2	0	0	3
32943	492976	7	1	2	0	1	4
32943	492980	7	1	0	0	0	1
32943	92683	7	0	0	0	0	0
32943	98579	7	2	0	1	0	3
32943	108402	6	1	1	1	0	3
32943	189946	6	2	1	0	0	3
32943	195104	6	1	2	0	0	3
32943	205270	6	1	1	0	0	2
32943	492818	6	0	1	0	0	1
32943	492823	6	0	1	0	1	2
32943	492824	6	1	2	1	0	4
32943	492829	6	1	0	0	0	1
32943	492835	6	2	1	1	0	4
32943	492849	6	1	1	1	0	3
32943	492866	6	5	0	0	0	5
32943	492892	6	1	0	2	1	4
32943	492894	6	0	1	0	0	1
32943	492895	6	0	0	0	0	0
32943	492903	6	1	2	0	0	3
32943	492904	6	1	0	0	1	2
32943	492920	6	0	2	0	0	2
32943	492922	6	0	0	1	0	1
32943	492925	6	1	4	1	0	6
32943	492941	6	1	3	1	0	5
32943	492945	6	2	0	1	0	3
32943	492956	6	2	1	0	0	3
32943	492961	6	3	0	0	0	3
32943	492972	6	1	1	1	1	4
32943	492984	6	1	2	0	0	3
32943	492989	6	0	1	0	1	2
32943	492998	6	1	1	0	0	2
32943	67597	6	1	1	0	0	2
32943	96222	6	3	1	0	0	4
32943	208024	5	1	1	1	1	4
32943	291940	5	2	1	0	0	3
32943	492817	5	0	0	0	0	0
32943	492833	5	2	2	0	0	4
32943	492837	5	0	0	0	0	0
32943	492843	5	1	2	0	0	3
32943	492852	5	0	0	0	0	0
32943	492853	5	3	1	0	0	4
32943	492854	5	0	0	2	0	2
32943	492861	5	0	2	0	0	2
32943	492865	5	0	0	0	0	0
32943	492872	5	1	1	0	0	2
32943	492882	5	0	3	0	1	4
32943	492906	5	2	0	1	0	3
32943	492913	5	0	0	0	2	2
32943	492914	5	0	0	0	0	0
32943	492915	5	0	2	0	0	2
32943	492916	5	0	0	2	0	2
32943	492924	5	0	0	0	0	0
32943	492940	5	1	0	0	0	1
32943	492943	5	1	2	1	1	5
32943	492949	5	1	0	0	0	1
32943	492966	5	0	1	0	0	1
32943	492977	5	0	1	0	0	1
32943	492979	5	1	0	1	1	3
32943	492985	5	1	0	0	0	1
32943	492993	5	1	1	0	0	2
32943	492994	5	0	1	0	0	1
32943	492995	5	1	2	0	0	3
32943	492999	5	3	1	0	1	5
32943	51668	5	0	0	1	0	1
32943	100317	4	0	0	2	1	3
32943	104228	4	2	1	0	0	3
32943	198528	4	0	1	0	0	1
32943	204486	4	1	0	0	0	1
32943	217059	4	0	1	1	0	2
32943	291938	4	1	1	0	0	2
32943	291943	4	1	1	1	0	3
32943	492812	4	2	2	0	0	4
32943	492814	4	0	1	0	1	2
32943	492822	4	2	1	1	0	4
32943	492825	4	0	2	0	0	2
32943	492826	4	1	0	0	0	1
32943	492832	4	1	1	0	2	4
32943	492838	4	0	0	0	0	0
32943	492840	4	1	2	0	1	4
32943	492844	4	1	0	0	1	2
32943	492845	4	0	0	0	0	0
32943	492848	4	5	1	0	0	6
32943	492850	4	1	1	1	0	3
32943	492860	4	1	0	1	0	2
32943	492862	4	1	0	0	0	1
32943	492873	4	1	1	0	0	2
32943	492876	4	0	0	1	0	1
32943	492877	4	1	1	0	0	2
32943	492878	4	0	3	0	1	4
32943	492879	4	1	1	1	0	3
32943	492883	4	1	0	0	0	1
32943	492893	4	0	1	1	0	2
32943	492899	4	1	0	0	0	1
32943	492901	4	1	0	1	0	2
32943	492910	4	1	0	0	0	1
32943	492917	4	1	1	1	0	3
32943	492926	4	0	0	0	0	0
32943	492929	4	2	0	0	0	2
32943	492935	4	0	1	0	0	1
32943	492938	4	1	1	1	1	4
32943	492939	4	0	2	1	0	3
32943	492955	4	2	2	1	1	6
32943	492957	4	1	0	0	0	1
32943	492963	4	3	1	1	0	5
32943	492967	4	2	2	0	0	4
32943	492973	4	0	1	0	0	1
32943	492987	4	2	1	1	0	4
32943	492990	4	1	2	0	0	3
32943	52473	4	1	1	1	0	3
32943	67805	4	0	1	0	0	1
32943	70497	4	0	2	1	0	3
32943	89003	4	1	1	0	0	2
32943	98850	4	0	0	0	1	1
32943	104439	3	0	3	0	0	3
32943	190408	3	0	0	0	0	0
32943	193600	3	1	2	0	0	3
32943	193897	3	2	0	0	0	2
32943	212634	3	0	1	0	0	1
32943	221590	3	0	1	1	0	2
32943	291941	3	1	1	1	0	3
32943	291942	3	0	0	0	0	0
32943	492809	3	0	2	0	0	2
32943	492810	3	1	0	0	0	1
32943	492811	3	0	1	0	0	1
32943	492815	3	0	2	0	0	2
32943	492819	3	1	0	1	0	2
32943	492821	3	2	1	0	1	4
32943	492827	3	2	0	0	0	2
32943	492830	3	0	1	0	0	1
32943	492834	3	1	0	0	2	3
32943	492836	3	0	0	0	0	0
32943	492847	3	1	1	0	1	3
32943	492851	3	0	0	0	0	0
32943	492863	3	1	0	0	0	1
32943	492868	3	1	1	0	0	2
32943	492869	3	1	0	0	0	1
32943	492875	3	0	0	0	0	0
32943	492888	3	0	0	1	0	1
32943	492891	3	0	2	0	0	2
32943	492896	3	1	0	0	0	1
32943	492898	3	0	1	1	0	2
32943	492907	3	1	3	0	0	4
32943	492912	3	2	0	0	0	2
32943	492923	3	0	0	1	0	1
32943	492928	3	1	0	0	0	1
32943	492933	3	1	0	0	0	1
32943	492934	3	0	0	0	0	0
32943	492937	3	0	0	0	0	0
32943	492944	3	1	0	0	0	1
32943	492947	3	1	1	0	0	2
32943	492951	3	1	2	0	0	3
32943	492952	3	0	0	0	1	1
32943	492954	3	1	2	0	1	4
32943	492960	3	1	2	0	0	3
32943	492962	3	2	0	0	0	2
32943	492968	3	1	0	0	0	1
32943	492970	3	1	0	0	0	1
32943	492971	3	0	1	0	0	1
32943	492975	3	1	1	0	0	2
32943	492981	3	2	0	0	0	2
32943	493000	3	1	1	0	0	2
32943	59060	3	1	1	1	0	3
32943	102986	2	0	0	0	0	0
32943	203210	2	1	1	0	0	2
32943	221069	2	1	0	0	0	1
32943	291933	2	1	0	0	0	1
32943	291935	2	0	0	0	0	0
32943	291939	2	0	0	1	0	1
32943	492858	2	1	0	0	0	1
32943	492859	2	0	0	1	0	1
32943	492864	2	0	0	0	0	0
32943	492874	2	2	0	0	0	2
32943	492881	2	0	0	0	0	0
32943	492886	2	0	0	0	0	0
32943	492887	2	0	0	0	0	0
32943	492889	2	0	0	0	0	0
32943	492897	2	1	0	0	0	1
32943	492900	2	1	0	0	0	1
32943	492905	2	2	0	1	0	3
32943	492921	2	0	1	0	0	1
32943	492927	2	1	0	0	0	1
32943	492930	2	0	0	0	0	0
32943	492932	2	1	0	0	2	3
32943	492936	2	0	2	0	0	2
32943	492942	2	0	0	0	0	0
32943	492948	2	0	1	0	0	1
32943	492950	2	0	0	1	0	1
32943	492958	2	1	1	0	0	2
32943	492959	2	1	0	0	0	1
32943	492964	2	0	3	0	0	3
32943	492978	2	0	0	0	3	3
32943	492986	2	1	2	0	0	3
32943	492988	2	2	3	0	0	5
32943	492992	2	0	1	0	1	2
32943	492997	2	1	1	0	0	2
32943	80482	2	0	0	1	0	1
32943	291934	1	0	1	0	0	1
32943	291936	1	1	0	0	0	1
32943	291937	1	0	0	0	1	1
32943	492831	1	0	0	2	0	2
32943	492839	1	0	0	0	0	0
32943	492841	1	0	0	0	0	0
32943	492855	1	0	0	0	0	0
32943	492867	1	0	0	0	0	0
32943	492870	1	0	0	0	0	0
32943	492902	1	0	0	0	0	0
32943	492909	1	0	1	0	0	1
32943	492918	1	0	0	0	0	0
32943	492919	1	0	1	0	0	1
32943	492931	1	0	0	0	0	0
32943	64439	1	0	1	0	0	1
32943	71999	1	1	0	0	0	1
32943	87828	1	0	0	0	1	1
38302	187249	29	4	8	1	2	15
38302	621926	27	1	3	2	0	6
38302	621927	22	2	5	2	2	11
38302	216970	19	0	0	2	5	7
38302	279508	19	0	0	2	5	7
38302	621945	19	0	0	2	5	7
38302	621856	17	2	0	2	2	6
38302	621933	17	1	4	2	3	10
38302	621936	17	4	3	1	4	12
38302	184576	15	2	1	2	0	5
38302	621938	15	2	0	4	1	7
38302	621973	15	0	2	1	0	3
38302	621934	14	2	3	0	1	6
38302	621935	14	0	3	0	0	3
38302	187668	13	2	2	1	0	5
38302	621771	13	0	5	2	0	7
38302	621816	13	2	2	3	6	13
38302	621823	13	2	5	2	1	10
38302	621846	13	3	1	4	0	8
38302	621862	13	0	1	1	1	3
38302	621864	13	0	1	1	1	3
38302	621951	13	0	3	1	1	5
38302	200573	12	2	3	0	0	5
38302	621892	12	2	0	3	2	7
38302	621954	12	3	0	2	3	8
38302	621970	12	0	0	1	0	1
38302	191658	11	4	5	0	0	9
38302	621836	11	2	2	0	0	4
38302	208946	10	0	1	0	1	2
38302	621810	10	1	3	0	1	5
38302	621813	10	0	1	0	0	1
38302	621826	10	1	1	1	1	4
38302	621937	10	0	1	1	1	3
38302	188059	9	1	1	0	1	3
38302	217775	9	0	0	0	0	0
38302	621900	9	1	0	1	0	2
38302	621931	9	2	1	0	1	4
38302	621955	9	2	1	1	3	7
38302	621971	9	1	4	0	0	5
38302	190973	8	1	3	0	0	4
38302	621811	8	0	0	0	1	1
38302	621891	8	3	3	1	0	7
38302	621916	8	0	2	1	0	3
38302	621928	8	2	1	2	0	5
38302	621930	8	1	1	0	0	2
38302	621940	8	1	4	0	2	7
38302	621966	8	0	0	0	1	1
38302	621968	8	1	2	1	1	5
38302	186012	7	2	3	0	0	5
38302	193431	7	3	1	0	0	4
38302	621787	7	0	5	0	0	5
38302	621884	7	2	1	0	0	3
38302	621893	7	0	2	2	1	5
38302	621898	7	3	1	0	0	4
38302	621906	7	0	5	0	1	6
38302	215790	6	1	1	0	0	2
38302	221682	6	1	1	2	2	6
38302	621790	6	0	2	1	0	3
38302	621792	6	1	0	0	1	2
38302	621798	6	1	0	0	1	2
38302	621799	6	1	0	0	1	2
38302	621800	6	1	0	0	1	2
38302	621817	6	1	1	1	0	3
38302	621827	6	1	0	0	0	1
38302	621833	6	0	4	0	1	5
38302	621840	6	1	2	0	0	3
38302	621847	6	0	2	0	0	2
38302	621861	6	1	1	2	0	4
38302	621876	6	0	0	0	0	0
38302	621885	6	0	2	0	1	3
38302	621886	6	1	5	1	0	7
38302	621888	6	0	3	0	0	3
38302	621907	6	2	1	0	0	3
38302	621919	6	0	0	0	0	0
38302	621922	6	0	2	2	0	4
38302	621924	6	1	2	0	1	4
38302	621925	6	1	1	0	0	2
38302	621952	6	0	0	0	1	1
38302	621953	6	1	4	1	0	6
38302	621964	6	0	0	0	1	1
38302	621967	6	1	2	0	2	5
38302	621972	6	1	1	1	0	3
38302	190165	5	0	3	0	1	4
38302	203354	5	1	2	0	0	3
38302	219662	5	1	0	1	0	2
38302	621777	5	0	1	0	2	3
38302	621802	5	1	1	0	1	3
38302	621821	5	0	0	0	0	0
38302	621822	5	0	2	0	0	2
38302	621831	5	1	0	0	0	1
38302	621835	5	1	0	0	0	1
38302	621839	5	0	1	0	0	1
38302	621860	5	2	1	0	0	3
38302	621871	5	1	0	0	0	1
38302	621879	5	1	1	0	0	2
38302	621883	5	2	5	0	0	7
38302	621887	5	1	0	0	1	2
38302	621899	5	2	0	1	0	3
38302	621903	5	3	1	0	0	4
38302	621913	5	0	5	0	1	6
38302	621921	5	0	1	0	0	1
38302	621957	5	0	1	0	1	2
38302	621959	5	0	0	0	0	0
38302	621960	5	0	3	1	0	4
38302	621963	5	0	2	6	0	8
38302	621965	5	1	1	1	0	3
38302	183447	4	2	0	0	1	3
38302	194013	4	1	2	0	0	3
38302	195898	4	1	2	0	0	3
38302	202097	4	0	2	0	0	2
38302	210433	4	0	0	0	0	0
38302	279504	4	1	3	0	0	4
38302	279505	4	0	1	0	0	1
38302	279506	4	1	1	1	0	3
38302	621782	4	2	0	0	0	2
38302	621785	4	0	2	0	0	2
38302	621788	4	0	1	0	0	1
38302	621805	4	0	1	0	0	1
38302	621808	4	0	2	0	2	4
38302	621809	4	0	1	0	1	2
38302	621830	4	1	1	1	0	3
38302	621837	4	2	0	0	0	2
38302	621841	4	0	1	0	1	2
38302	621852	4	0	1	0	0	1
38302	621853	4	0	0	0	0	0
38302	621854	4	1	1	0	1	3
38302	621872	4	1	1	0	0	2
38302	621875	4	1	1	0	0	2
38302	621877	4	0	0	0	0	0
38302	621878	4	1	0	3	0	4
38302	621894	4	2	1	0	0	3
38302	621908	4	1	1	0	0	2
38302	621909	4	0	0	0	0	0
38302	621911	4	0	0	0	0	0
38302	621917	4	0	1	0	0	1
38302	621920	4	1	0	0	0	1
38302	621929	4	0	1	1	0	2
38302	621943	4	1	4	0	0	5
38302	621950	4	0	1	0	0	1
38302	621969	4	1	1	1	0	3
38302	621974	4	0	0	0	0	0
38302	191708	3	1	0	1	0	2
38302	197262	3	0	0	0	0	0
38302	209721	3	2	1	0	0	3
38302	216257	3	1	0	1	1	3
38302	279507	3	0	1	0	0	1
38302	621763	3	2	1	2	1	6
38302	621772	3	0	0	1	1	2
38302	621791	3	0	0	0	1	1
38302	621803	3	0	1	0	0	1
38302	621806	3	1	2	0	0	3
38302	621807	3	0	1	0	0	1
38302	621818	3	1	1	1	0	3
38302	621819	3	0	2	0	0	2
38302	621825	3	0	0	0	0	0
38302	621828	3	1	0	0	0	1
38302	621829	3	0	2	0	0	2
38302	621832	3	2	0	0	0	2
38302	621834	3	1	1	0	0	2
38302	621844	3	1	1	0	0	2
38302	621845	3	0	0	0	0	0
38302	621849	3	2	1	0	0	3
38302	621850	3	2	4	0	0	6
38302	621851	3	0	1	0	0	1
38302	621855	3	0	0	0	1	1
38302	621858	3	1	0	0	0	1
38302	621865	3	0	1	1	0	2
38302	621866	3	2	1	0	0	3
38302	621867	3	1	0	0	0	1
38302	621868	3	1	0	0	0	1
38302	621870	3	1	1	0	0	2
38302	621880	3	0	0	0	0	0
38302	621882	3	1	2	0	1	4
38302	621896	3	0	0	0	0	0
38302	621897	3	0	0	0	0	0
38302	621901	3	0	1	0	0	1
38302	621902	3	0	4	0	0	4
38302	621904	3	2	1	0	0	3
38302	621905	3	2	1	0	0	3
38302	621912	3	1	0	0	1	2
38302	621914	3	1	2	0	1	4
38302	621918	3	2	0	0	0	2
38302	621923	3	4	0	0	0	4
38302	621941	3	0	1	0	0	1
38302	621942	3	1	0	0	0	1
38302	621944	3	0	1	0	0	1
38302	621946	3	0	0	0	3	3
38302	621948	3	0	1	0	2	3
38302	621962	3	0	0	0	0	0
38302	621978	3	0	0	0	0	0
38302	621980	3	0	0	0	0	0
38302	191947	2	0	0	0	0	0
38302	279509	2	0	0	0	0	0
38302	621766	2	0	1	0	0	1
38302	621775	2	0	0	0	0	0
38302	621778	2	0	1	0	0	1
38302	621780	2	0	2	0	0	2
38302	621781	2	0	1	0	0	1
38302	621786	2	1	0	0	0	1
38302	621789	2	0	0	1	0	1
38302	621801	2	0	1	0	0	1
38302	621804	2	0	1	0	0	1
38302	621812	2	0	0	0	0	0
38302	621814	2	0	1	0	0	1
38302	621820	2	1	1	0	1	3
38302	621843	2	1	1	0	0	2
38302	621848	2	0	2	0	1	3
38302	621857	2	0	0	0	0	0
38302	621869	2	0	1	0	0	1
38302	621873	2	0	1	0	0	1
38302	621874	2	0	0	0	0	0
38302	621889	2	1	2	0	0	3
38302	621890	2	2	1	0	0	3
38302	621915	2	1	1	0	1	3
38302	621932	2	0	0	0	0	0
38302	621939	2	0	2	0	0	2
38302	621949	2	0	0	0	0	0
38302	621956	2	1	0	0	0	1
38302	621958	2	0	1	0	1	2
38302	621961	2	0	1	1	0	2
38302	621975	2	0	0	0	0	0
38302	621976	2	0	0	0	0	0
38302	621977	2	0	0	0	0	0
38302	187479	1	0	0	0	0	0
38302	191279	1	1	0	0	1	2
38302	192848	1	0	1	0	0	1
38302	201917	1	0	0	0	0	0
38302	208530	1	0	0	0	0	0
38302	214900	1	0	0	0	0	0
38302	216578	1	1	0	1	0	2
38302	621764	1	0	0	0	0	0
38302	621765	1	0	1	0	0	1
38302	621767	1	0	0	0	0	0
38302	621768	1	0	0	0	0	0
38302	621769	1	0	1	0	0	1
38302	621770	1	0	0	0	0	0
38302	621773	1	0	1	0	0	1
38302	621774	1	0	0	0	0	0
38302	621776	1	0	0	0	0	0
38302	621779	1	0	0	0	2	2
38302	621783	1	0	0	0	0	0
38302	621784	1	0	0	0	0	0
38302	621815	1	0	1	1	0	2
38302	621824	1	0	0	0	0	0
38302	621838	1	1	4	0	0	5
38302	621842	1	0	1	0	0	1
38302	621859	1	0	0	0	0	0
38302	621881	1	1	3	0	0	4
38302	621895	1	1	2	0	1	4
38302	621947	1	0	1	0	0	1
38302	621979	1	0	0	0	0	0
43367	294867	83	5	14	2	6	27
43367	56788	83	5	14	2	6	27
43367	89496	51	4	13	2	5	24
43367	459740	48	4	14	2	6	26
43367	459755	35	2	12	2	4	20
43367	294868	34	4	0	0	1	5
43367	57533	34	4	0	0	1	5
43367	187544	30	7	4	2	1	14
43367	459759	30	7	4	2	1	14
43367	58878	30	7	4	2	1	14
43367	84021	30	9	9	2	0	20
43367	294866	29	2	1	1	1	5
43367	294872	29	0	4	0	1	5
43367	459749	29	2	1	1	1	5
43367	60811	29	0	4	0	1	5
43367	51279	24	1	0	1	0	2
43367	85960	24	3	2	0	2	7
43367	459719	23	1	2	0	1	4
43367	67341	23	0	5	2	0	7
43367	53193	22	3	6	2	0	11
43367	102138	20	1	9	0	0	10
43367	294869	16	0	8	0	2	10
43367	459763	16	0	8	0	2	10
43367	86487	16	0	8	0	2	10
43367	294860	13	1	5	1	0	7
43367	294871	13	4	2	0	2	8
43367	459764	13	1	5	1	0	7
43367	90895	13	4	2	0	2	8
43367	90896	13	4	2	0	2	8
43367	92805	13	1	5	1	0	7
43367	459742	12	4	1	0	2	7
43367	294849	11	5	4	0	1	10
43367	294863	11	0	1	0	0	1
43367	459728	11	0	2	1	0	3
43367	459762	11	4	2	0	2	8
43367	55186	11	1	4	3	1	9
43367	599505	11	5	4	0	1	10
43367	61987	11	5	4	0	1	10
43367	71547	11	0	1	0	0	1
43367	188923	10	0	3	1	1	5
43367	60031	10	0	3	1	1	5
43367	219290	9	1	1	1	0	3
43367	294862	9	2	7	1	1	11
43367	459748	9	2	1	0	0	3
43367	52261	9	2	7	1	1	11
43367	106101	8	1	1	1	0	3
43367	294848	8	1	5	0	0	6
43367	599493	8	0	0	1	1	2
43367	599519	8	0	0	0	2	2
43367	74006	8	1	7	0	0	8
43367	102378	7	2	2	0	0	4
43367	102894	7	0	1	0	0	1
43367	188402	7	1	5	0	0	6
43367	294859	7	1	5	0	0	6
43367	459707	7	1	1	0	0	2
43367	599526	7	1	0	0	0	1
43367	92265	7	2	2	0	0	4
43367	294855	6	1	1	0	0	2
43367	294861	6	1	2	0	3	6
43367	294865	6	2	3	0	0	5
43367	459670	6	0	2	1	0	3
43367	459676	6	0	4	1	2	7
43367	459721	6	1	1	0	1	3
43367	599498	6	1	2	0	0	3
43367	599503	6	0	2	1	2	5
43367	599512	6	1	2	0	0	3
43367	599522	6	0	3	0	0	3
43367	599524	6	2	3	0	1	6
43367	71639	6	1	1	0	0	2
43367	75117	6	3	2	0	0	5
43367	83840	6	1	2	0	3	6
43367	84313	6	0	1	0	0	1
43367	92467	6	1	4	0	0	5
43367	194941	5	0	1	0	0	1
43367	196801	5	0	2	0	0	2
43367	204459	5	1	2	0	0	3
43367	459682	5	1	1	0	0	2
43367	459699	5	0	2	0	0	2
43367	459700	5	1	1	0	0	2
43367	459711	5	1	1	0	0	2
43367	459723	5	0	4	0	0	4
43367	459741	5	1	6	0	0	7
43367	459751	5	1	1	0	0	2
43367	459752	5	2	3	0	0	5
43367	84447	5	1	2	0	0	3
43367	85162	5	0	0	0	0	0
43367	101499	4	0	3	0	0	3
43367	101758	4	2	3	0	0	5
43367	105329	4	1	2	0	0	3
43367	189544	4	0	1	1	0	2
43367	191252	4	0	1	0	0	1
43367	193628	4	0	1	0	0	1
43367	294850	4	0	1	0	0	1
43367	294852	4	1	2	0	0	3
43367	294853	4	0	1	0	0	1
43367	294856	4	1	1	0	0	2
43367	294857	4	0	1	0	0	1
43367	294858	4	1	1	0	0	2
43367	459684	4	0	0	1	0	1
43367	459686	4	1	3	0	0	4
43367	459735	4	0	0	0	0	0
43367	459738	4	0	1	0	0	1
43367	459750	4	0	1	0	0	1
43367	459753	4	2	0	0	0	2
43367	459754	4	1	1	0	0	2
43367	50984	4	1	1	0	0	2
43367	51924	4	0	0	0	0	0
43367	56353	4	1	1	1	0	3
43367	599489	4	1	1	0	0	2
43367	599499	4	0	2	0	0	2
43367	599501	4	2	2	0	1	5
43367	599502	4	0	1	0	0	1
43367	599507	4	1	1	0	0	2
43367	599510	4	2	1	0	0	3
43367	599514	4	1	1	0	0	2
43367	599520	4	1	1	0	0	2
43367	66627	4	1	2	0	0	3
43367	71494	4	0	1	0	0	1
43367	88750	4	1	2	0	0	3
43367	89776	4	0	1	0	0	1
43367	100916	3	0	3	0	1	4
43367	105268	3	0	1	0	0	1
43367	108320	3	0	3	1	1	5
43367	184306	3	3	1	0	0	4
43367	294864	3	0	1	1	1	3
43367	459677	3	0	2	0	0	2
43367	459681	3	0	2	0	0	2
43367	459688	3	1	1	0	0	2
43367	459691	3	0	1	0	0	1
43367	459692	3	1	1	1	0	3
43367	459693	3	1	1	0	2	4
43367	459695	3	1	0	0	0	1
43367	459696	3	1	1	0	0	2
43367	459706	3	2	1	0	0	3
43367	459708	3	0	1	0	0	1
43367	459709	3	0	0	0	1	1
43367	459710	3	0	0	0	0	0
43367	459717	3	2	1	0	0	3
43367	459722	3	2	1	1	0	4
43367	459727	3	0	1	0	0	1
43367	459729	3	0	1	0	1	2
43367	459734	3	0	2	0	0	2
43367	459737	3	0	1	0	0	1
43367	459739	3	1	0	0	0	1
43367	459743	3	0	0	0	0	0
43367	459744	3	2	0	0	0	2
43367	459745	3	2	1	0	0	3
43367	459746	3	1	2	0	0	3
43367	459757	3	0	3	0	0	3
43367	459758	3	0	0	0	0	0
43367	459761	3	1	2	0	0	3
43367	50461	3	1	1	0	0	2
43367	57151	3	1	3	0	0	4
43367	599490	3	2	1	0	0	3
43367	599492	3	0	1	0	0	1
43367	599495	3	0	2	0	0	2
43367	599500	3	0	2	0	0	2
43367	599504	3	0	1	0	0	1
43367	599506	3	0	2	0	0	2
43367	599508	3	1	0	0	0	1
43367	599516	3	1	3	0	0	4
43367	599523	3	0	1	0	1	2
43367	599527	3	0	2	0	0	2
43367	64176	3	0	0	0	0	0
43367	68785	3	0	1	0	0	1
43367	70321	3	0	1	1	1	3
43367	72161	3	0	2	0	0	2
43367	79599	3	2	2	0	0	4
43367	92495	3	0	0	0	0	0
43367	97203	3	1	3	0	0	4
43367	105250	2	3	3	0	1	7
43367	182274	2	1	2	0	0	3
43367	195533	2	0	1	0	0	1
43367	214158	2	0	0	0	0	0
43367	459668	2	0	2	0	0	2
43367	459675	2	0	1	0	0	1
43367	459678	2	1	1	0	0	2
43367	459679	2	0	0	0	0	0
43367	459683	2	1	1	0	0	2
43367	459687	2	1	0	0	0	1
43367	459690	2	1	2	0	0	3
43367	459694	2	0	2	0	0	2
43367	459705	2	1	2	0	0	3
43367	459714	2	1	0	0	0	1
43367	459715	2	1	0	0	0	1
43367	459716	2	0	0	0	0	0
43367	459718	2	0	1	0	0	1
43367	459720	2	0	2	0	0	2
43367	459724	2	0	0	0	0	0
43367	459730	2	1	2	0	2	5
43367	459731	2	1	0	0	0	1
43367	459733	2	0	3	0	0	3
43367	459747	2	1	1	0	1	3
43367	459756	2	0	1	0	0	1
43367	459760	2	0	1	0	0	1
43367	459765	2	0	1	0	0	1
43367	50200	2	0	1	0	0	1
43367	57131	2	1	0	1	0	2
43367	59567	2	1	1	0	0	2
43367	599488	2	0	1	0	0	1
43367	599491	2	1	1	0	1	3
43367	599494	2	1	2	1	0	4
43367	599496	2	0	2	0	0	2
43367	599497	2	1	2	0	0	3
43367	599509	2	0	1	0	0	1
43367	599511	2	0	1	0	0	1
43367	599513	2	0	1	1	0	2
43367	599515	2	1	1	0	0	2
43367	599518	2	0	0	0	1	1
43367	599525	2	0	1	0	1	2
43367	83501	2	0	1	0	2	3
43367	86391	2	1	2	0	0	3
43367	107363	1	0	1	0	0	1
43367	189578	1	0	0	0	0	0
43367	199137	1	0	1	0	0	1
43367	294851	1	0	1	0	0	1
43367	294854	1	0	1	0	0	1
43367	294870	1	0	1	0	0	1
43367	459669	1	1	0	0	2	3
43367	459671	1	0	0	0	0	0
43367	459672	1	0	0	0	0	0
43367	459673	1	1	1	0	0	2
43367	459674	1	0	3	0	0	3
43367	459680	1	0	1	0	0	1
43367	459685	1	0	0	0	0	0
43367	459689	1	1	0	0	0	1
43367	459697	1	0	1	0	0	1
43367	459698	1	1	1	0	0	2
43367	459701	1	0	2	0	0	2
43367	459702	1	0	1	0	0	1
43367	459703	1	1	3	0	0	4
43367	459704	1	1	0	0	0	1
43367	459712	1	0	2	0	0	2
43367	459713	1	0	0	0	0	0
43367	459725	1	1	1	0	0	2
43367	459726	1	2	1	0	0	3
43367	459732	1	0	2	0	1	3
43367	459736	1	1	1	0	0	2
43367	459766	1	0	2	0	0	2
43367	51308	1	0	1	0	0	1
43367	599484	1	1	1	0	0	2
43367	599485	1	0	1	0	0	1
43367	599486	1	0	1	0	0	1
43367	599487	1	0	0	0	0	0
43367	599517	1	0	1	0	0	1
43367	599521	1	0	1	0	0	1
43367	74443	1	0	1	0	0	1
43367	92823	1	0	1	0	0	1
64479	477036	12	3	3	0	0	6
64479	476939	11	2	3	3	1	9
64479	476946	11	0	4	1	3	8
64479	476977	10	2	3	0	1	6
64479	477020	10	1	4	1	5	11
64479	98842	10	2	0	0	0	2
64479	195193	9	1	1	1	0	3
64479	221558	9	3	1	0	0	4
64479	300258	9	1	0	0	0	1
64479	476875	9	0	0	0	3	3
64479	476926	9	0	0	0	0	0
64479	476943	9	1	3	0	0	4
64479	476948	9	2	2	1	1	6
64479	477034	9	1	1	1	0	3
64479	477041	9	2	2	1	0	5
64479	91155	9	1	0	0	0	1
64479	212045	8	1	1	0	0	2
64479	476873	8	5	2	0	0	7
64479	476874	8	1	1	0	0	2
64479	476915	8	0	0	1	3	4
64479	476932	8	0	5	0	0	5
64479	476962	8	2	1	1	0	4
64479	476968	8	1	3	0	0	4
64479	476973	8	2	0	1	0	3
64479	476991	8	0	2	0	0	2
64479	476997	8	1	1	1	0	3
64479	477007	8	2	2	0	0	4
64479	477013	8	0	1	1	0	2
64479	476862	7	1	1	0	0	2
64479	476880	7	1	2	2	1	6
64479	476910	7	0	0	0	0	0
64479	476934	7	0	1	0	0	1
64479	477030	7	0	1	0	2	3
64479	477043	7	0	2	0	0	2
64479	56544	7	1	2	1	1	5
64479	193450	6	0	1	1	0	2
64479	204248	6	0	0	0	0	0
64479	476872	6	0	2	0	0	2
64479	476947	6	2	1	0	1	4
64479	476963	6	1	1	0	0	2
64479	476966	6	1	2	0	0	3
64479	476974	6	0	0	0	0	0
64479	476975	6	0	0	0	0	0
64479	476982	6	0	1	0	0	1
64479	476987	6	2	1	0	1	4
64479	477004	6	1	0	0	1	2
64479	477008	6	0	1	0	0	1
64479	477009	6	2	1	0	0	3
64479	477025	6	0	0	0	0	0
64479	477040	6	1	2	0	0	3
64479	183455	5	2	1	0	0	3
64479	183784	5	0	0	0	1	1
64479	188426	5	1	0	0	0	1
64479	209210	5	0	1	0	0	1
64479	476845	5	2	0	0	1	3
64479	476859	5	1	2	0	0	3
64479	476861	5	0	1	2	1	4
64479	476879	5	2	0	0	0	2
64479	476886	5	1	3	0	0	4
64479	476912	5	3	0	0	0	3
64479	476919	5	0	2	0	0	2
64479	476942	5	0	3	0	1	4
64479	476945	5	0	0	0	0	0
64479	476956	5	0	0	0	0	0
64479	476965	5	2	1	0	0	3
64479	476985	5	0	0	0	0	0
64479	476999	5	0	2	0	0	2
64479	477002	5	2	1	0	0	3
64479	477005	5	0	3	0	1	4
64479	477010	5	1	1	1	0	3
64479	477016	5	1	1	0	0	2
64479	477023	5	1	1	1	1	4
64479	477028	5	0	1	0	0	1
64479	477037	5	1	0	0	0	1
64479	477038	5	0	2	0	0	2
64479	203272	4	0	1	0	0	1
64479	205696	4	1	0	0	0	1
64479	210118	4	0	1	0	0	1
64479	212435	4	0	3	0	0	3
64479	218555	4	1	3	0	1	5
64479	300257	4	1	3	0	1	5
64479	476840	4	0	0	0	2	2
64479	476882	4	0	0	1	0	1
64479	476884	4	0	1	0	0	1
64479	476894	4	0	0	0	0	0
64479	476902	4	1	0	0	0	1
64479	476906	4	0	1	0	0	1
64479	476908	4	2	1	0	0	3
64479	476917	4	0	2	0	0	2
64479	476918	4	2	0	0	0	2
64479	476922	4	0	1	0	0	1
64479	476928	4	1	0	0	0	1
64479	476929	4	0	1	0	0	1
64479	476931	4	1	1	1	2	5
64479	476937	4	0	1	0	0	1
64479	476949	4	1	1	0	0	2
64479	476960	4	2	1	0	0	3
64479	476978	4	1	1	0	0	2
64479	476983	4	1	1	1	0	3
64479	476989	4	2	1	0	0	3
64479	476998	4	0	0	0	0	0
64479	477001	4	1	3	1	0	5
64479	477012	4	1	0	0	0	1
64479	477017	4	0	0	0	0	0
64479	477019	4	0	1	1	0	2
64479	477024	4	1	0	0	0	1
64479	477026	4	2	5	0	1	8
64479	477029	4	0	2	0	1	3
64479	477032	4	2	1	0	0	3
64479	477035	4	0	1	0	0	1
64479	477039	4	2	1	0	0	3
64479	94117	4	1	3	0	1	5
64479	189521	3	1	0	0	0	1
64479	192332	3	0	0	0	1	1
64479	195848	3	0	1	0	0	1
64479	203770	3	1	0	0	0	1
64479	206025	3	0	1	1	0	2
64479	207042	3	1	2	0	0	3
64479	300255	3	0	1	0	0	1
64479	300256	3	0	1	0	0	1
64479	476836	3	0	2	0	0	2
64479	476837	3	0	0	0	1	1
64479	476842	3	1	0	0	1	2
64479	476847	3	1	0	0	1	2
64479	476849	3	1	0	0	0	1
64479	476850	3	0	1	1	0	2
64479	476851	3	1	0	0	0	1
64479	476853	3	2	1	0	0	3
64479	476855	3	0	1	0	0	1
64479	476857	3	0	1	0	0	1
64479	476868	3	1	1	0	2	4
64479	476869	3	0	1	0	0	1
64479	476876	3	2	1	0	0	3
64479	476883	3	0	1	0	0	1
64479	476887	3	2	0	0	0	2
64479	476888	3	2	1	0	1	4
64479	476890	3	2	0	0	1	3
64479	476898	3	0	2	0	1	3
64479	476899	3	0	0	0	0	0
64479	476907	3	1	0	0	0	1
64479	476909	3	0	0	0	2	2
64479	476911	3	1	0	0	0	1
64479	476913	3	0	0	0	0	0
64479	476916	3	1	0	0	1	2
64479	476933	3	1	1	0	0	2
64479	476938	3	0	2	0	1	3
64479	476944	3	0	0	0	0	0
64479	476950	3	1	0	0	0	1
64479	476951	3	1	2	0	0	3
64479	476954	3	0	1	0	0	1
64479	476955	3	1	1	0	0	2
64479	476957	3	1	0	0	0	1
64479	476958	3	0	2	0	0	2
64479	476959	3	0	0	0	0	0
64479	476961	3	1	0	0	0	1
64479	476964	3	0	2	0	0	2
64479	476969	3	1	0	0	0	1
64479	476976	3	1	0	0	2	3
64479	476984	3	0	1	0	0	1
64479	476986	3	0	1	0	0	1
64479	476992	3	1	1	0	0	2
64479	476994	3	0	0	0	0	0
64479	477000	3	2	0	0	0	2
64479	477011	3	0	0	0	0	0
64479	477014	3	0	1	0	0	1
64479	477018	3	1	1	0	1	3
64479	477027	3	0	0	0	0	0
64479	477031	3	0	0	0	0	0
64479	56192	3	0	1	0	0	1
64479	71199	3	0	1	0	0	1
64479	182212	2	1	0	0	1	2
64479	188962	2	0	0	0	1	1
64479	300254	2	0	1	0	0	1
64479	476843	2	2	0	0	0	2
64479	476844	2	0	0	0	0	0
64479	476846	2	0	1	0	0	1
64479	476848	2	0	0	0	0	0
64479	476852	2	0	1	0	0	1
64479	476854	2	0	2	0	0	2
64479	476856	2	0	0	0	0	0
64479	476858	2	0	0	0	0	0
64479	476863	2	0	0	0	0	0
64479	476865	2	0	0	0	0	0
64479	476867	2	1	1	0	1	3
64479	476871	2	1	1	0	0	2
64479	476877	2	0	1	0	1	2
64479	476878	2	0	2	0	1	3
64479	476881	2	1	1	0	0	2
64479	476885	2	0	1	0	0	1
64479	476889	2	0	0	0	0	0
64479	476893	2	0	2	1	0	3
64479	476897	2	0	2	0	1	3
64479	476900	2	0	0	0	0	0
64479	476901	2	0	1	0	0	1
64479	476905	2	1	2	0	1	4
64479	476925	2	0	0	0	0	0
64479	476935	2	0	0	0	0	0
64479	476936	2	0	0	0	0	0
64479	476940	2	0	2	0	0	2
64479	476941	2	2	3	0	1	6
64479	476953	2	0	1	0	0	1
64479	476967	2	1	0	0	0	1
64479	476970	2	0	1	0	0	1
64479	476979	2	1	0	0	0	1
64479	476988	2	0	0	0	0	0
64479	476990	2	1	1	2	0	4
64479	476993	2	2	1	0	0	3
64479	476995	2	1	0	0	1	2
64479	477015	2	0	0	0	0	0
64479	477022	2	0	0	0	0	0
64479	477033	2	0	0	0	0	0
64479	477042	2	1	2	0	0	3
64479	74045	2	0	1	0	0	1
64479	186659	1	0	0	0	0	0
64479	191290	1	0	2	0	1	3
64479	196438	1	0	1	0	1	2
64479	208560	1	0	0	0	0	0
64479	211144	1	0	0	0	0	0
64479	212774	1	0	2	0	2	4
64479	300253	1	0	1	0	0	1
64479	476838	1	0	0	0	0	0
64479	476839	1	1	0	0	1	2
64479	476841	1	1	0	0	0	1
64479	476860	1	0	1	0	1	2
64479	476864	1	3	2	0	0	5
64479	476866	1	0	0	0	0	0
64479	476870	1	1	1	0	1	3
64479	476891	1	0	0	0	0	0
64479	476892	1	0	1	0	0	1
64479	476895	1	1	1	0	1	3
64479	476896	1	0	0	0	0	0
64479	476903	1	0	0	0	1	1
64479	476904	1	1	1	0	0	2
64479	476914	1	0	2	0	0	2
64479	476920	1	0	2	0	0	2
64479	476921	1	1	0	0	0	1
64479	476923	1	0	0	0	0	0
64479	476924	1	2	0	0	0	2
64479	476927	1	0	2	0	0	2
64479	476930	1	0	0	0	1	1
64479	476952	1	1	1	0	0	2
64479	476971	1	1	0	0	0	1
64479	476972	1	2	0	1	0	3
64479	476980	1	0	3	0	0	3
64479	476981	1	0	0	1	0	1
64479	477003	1	1	0	0	0	1
64479	477006	1	1	1	0	0	2
64479	477021	1	2	0	0	0	2
616	393320	11	4	0	0	0	4
616	393363	11	5	1	0	0	6
616	393365	10	0	4	0	5	9
616	393412	10	4	0	0	0	4
616	393445	9	0	0	0	1	1
616	393479	9	2	2	0	0	4
616	393385	8	2	2	0	0	4
616	393387	8	5	1	0	2	8
616	393427	8	0	0	0	0	0
616	393461	8	2	1	0	1	4
616	393513	8	0	1	0	1	2
616	283115	7	2	0	1	2	5
616	393319	7	0	0	0	2	2
616	393341	7	3	0	0	0	3
616	393353	7	5	0	0	0	5
616	393390	7	4	2	0	0	6
616	393425	7	1	2	0	0	3
616	393434	7	1	2	0	0	3
616	393497	7	3	1	0	0	4
616	196813	6	0	0	0	1	1
616	210979	6	2	1	0	1	4
616	283121	6	3	1	0	0	4
616	393323	6	1	0	0	0	1
616	393339	6	3	4	0	0	7
616	393340	6	2	1	0	1	4
616	393369	6	1	0	0	3	4
616	393379	6	3	0	0	0	3
616	393392	6	3	0	0	1	4
616	393439	6	1	0	0	0	1
616	393447	6	3	1	0	1	5
616	393455	6	1	0	0	0	1
616	393484	6	1	2	0	0	3
616	393496	6	2	0	0	1	3
616	393500	6	2	1	0	0	3
616	393517	6	1	0	0	0	1
616	208066	5	2	0	0	0	2
616	283114	5	1	0	0	0	1
616	393309	5	0	1	0	0	1
616	393344	5	2	0	1	0	3
616	393345	5	3	1	0	0	4
616	393346	5	2	0	0	4	6
616	393351	5	5	0	1	0	6
616	393356	5	1	2	1	0	4
616	393373	5	0	1	0	1	2
616	393377	5	0	0	0	0	0
616	393382	5	1	1	0	2	4
616	393398	5	2	0	0	0	2
616	393399	5	4	2	0	0	6
616	393416	5	2	0	0	0	2
616	393424	5	1	0	0	0	1
616	393430	5	2	2	1	1	6
616	393456	5	0	1	0	0	1
616	393469	5	0	0	0	0	0
616	393472	5	2	0	0	0	2
616	393491	5	3	0	0	0	3
616	393495	5	3	0	1	0	4
616	393514	5	1	0	0	1	2
616	189161	4	2	0	0	1	3
616	283117	4	0	1	0	1	2
616	393311	4	3	0	0	2	5
616	393314	4	2	3	0	1	6
616	393326	4	0	1	1	0	2
616	393330	4	1	2	0	1	4
616	393337	4	2	1	0	1	4
616	393347	4	1	1	0	0	2
616	393349	4	3	0	0	0	3
616	393366	4	2	1	0	1	4
616	393368	4	2	0	0	1	3
616	393376	4	1	0	0	0	1
616	393378	4	2	0	0	1	3
616	393386	4	2	1	0	1	4
616	393393	4	0	0	0	0	0
616	393397	4	2	3	0	0	5
616	393400	4	1	0	0	0	1
616	393401	4	1	0	0	1	2
616	393403	4	2	1	0	0	3
616	393411	4	1	1	0	1	3
616	393415	4	2	2	0	0	4
616	393417	4	1	1	0	1	3
616	393420	4	3	4	0	0	7
616	393432	4	1	0	0	0	1
616	393438	4	0	1	0	0	1
616	393440	4	1	1	1	3	6
616	393453	4	1	0	0	1	2
616	393454	4	0	1	0	0	1
616	393459	4	1	1	0	0	2
616	393463	4	3	0	0	0	3
616	393470	4	0	1	0	0	1
616	393471	4	0	1	0	0	1
616	393474	4	2	2	0	0	4
616	393478	4	0	0	0	0	0
616	393489	4	2	2	0	0	4
616	393492	4	1	0	0	0	1
616	393493	4	2	0	0	1	3
616	393509	4	0	1	0	0	1
616	393515	4	2	0	0	0	2
616	197304	3	0	0	0	0	0
616	205118	3	1	0	0	2	3
616	205321	3	1	0	0	0	1
616	216374	3	1	0	0	1	2
616	283112	3	2	1	0	0	3
616	283118	3	1	1	0	2	4
616	283125	3	2	1	0	0	3
616	283126	3	3	1	0	0	4
616	283128	3	1	1	0	2	4
616	393312	3	1	0	0	0	1
616	393313	3	1	3	0	1	5
616	393316	3	0	0	0	0	0
616	393317	3	0	1	0	0	1
616	393321	3	2	0	0	0	2
616	393325	3	3	0	0	0	3
616	393327	3	1	0	0	0	1
616	393328	3	0	1	0	0	1
616	393329	3	0	0	1	0	1
616	393331	3	0	0	0	1	1
616	393332	3	1	1	0	0	2
616	393333	3	2	0	0	0	2
616	393334	3	2	1	0	3	6
616	393336	3	1	0	0	1	2
616	393342	3	0	0	0	0	0
616	393343	3	1	0	0	0	1
616	393348	3	0	0	0	1	1
616	393350	3	1	0	0	0	1
616	393354	3	2	0	0	0	2
616	393357	3	1	0	0	1	2
616	393360	3	1	1	0	0	2
616	393367	3	2	0	0	1	3
616	393371	3	1	0	0	1	2
616	393372	3	1	1	0	0	2
616	393374	3	1	1	0	0	2
616	393381	3	1	0	0	0	1
616	393384	3	1	0	0	0	1
616	393388	3	1	1	0	0	2
616	393405	3	3	1	0	0	4
616	393408	3	2	0	0	0	2
616	393409	3	2	1	0	0	3
616	393414	3	0	0	0	0	0
616	393418	3	2	0	0	0	2
616	393419	3	0	2	0	0	2
616	393422	3	1	0	0	0	1
616	393423	3	0	1	0	0	1
616	393426	3	2	1	0	0	3
616	393428	3	4	2	0	0	6
616	393429	3	0	1	0	0	1
616	393433	3	0	2	0	0	2
616	393436	3	0	0	0	0	0
616	393441	3	1	1	0	1	3
616	393442	3	2	0	0	0	2
616	393443	3	0	0	0	0	0
616	393444	3	1	0	0	0	1
616	393446	3	0	1	0	0	1
616	393452	3	4	0	0	0	4
616	393460	3	0	0	0	1	1
616	393462	3	0	1	0	1	2
616	393465	3	1	1	0	1	3
616	393466	3	1	1	0	0	2
616	393473	3	1	2	0	0	3
616	393475	3	0	0	0	0	0
616	393483	3	1	1	0	1	3
616	393486	3	0	0	0	0	0
616	393487	3	1	0	0	0	1
616	393488	3	1	0	0	1	2
616	393494	3	0	1	0	1	2
616	393499	3	2	0	0	0	2
616	393501	3	1	0	0	0	1
616	393504	3	1	1	0	0	2
616	393506	3	1	0	0	0	1
616	393516	3	1	0	0	1	2
616	393518	3	1	1	0	1	3
616	186415	2	0	0	0	0	0
616	189681	2	0	0	0	0	0
616	191188	2	4	0	0	1	5
616	199730	2	2	0	0	0	2
616	203100	2	1	0	0	0	1
616	203287	2	1	0	0	0	1
616	207942	2	2	0	0	0	2
616	209376	2	2	0	0	0	2
616	283113	2	1	0	0	0	1
616	283116	2	1	0	0	2	3
616	283119	2	0	0	0	1	1
616	283120	2	0	0	0	0	0
616	283122	2	2	0	0	0	2
616	283123	2	1	0	0	0	1
616	283124	2	1	0	0	0	1
616	283127	2	3	0	0	0	3
616	393310	2	1	1	0	0	2
616	393318	2	1	0	0	1	2
616	393335	2	3	0	0	0	3
616	393338	2	4	1	0	0	5
616	393352	2	2	1	0	0	3
616	393355	2	0	2	0	0	2
616	393359	2	0	0	0	0	0
616	393361	2	1	0	0	1	2
616	393362	2	2	0	0	0	2
616	393364	2	1	0	0	0	1
616	393370	2	2	1	0	1	4
616	393375	2	2	1	0	0	3
616	393380	2	1	0	0	1	2
616	393383	2	1	0	0	0	1
616	393391	2	1	0	0	1	2
616	393394	2	2	0	0	0	2
616	393404	2	2	0	0	0	2
616	393406	2	1	0	0	0	1
616	393413	2	0	1	0	0	1
616	393421	2	0	1	0	0	1
616	393431	2	1	1	0	0	2
616	393435	2	0	1	0	1	2
616	393437	2	4	0	0	0	4
616	393449	2	2	1	0	0	3
616	393457	2	1	0	0	1	2
616	393458	2	0	2	0	0	2
616	393464	2	1	0	0	0	1
616	393467	2	2	1	1	0	4
616	393468	2	0	0	0	0	0
616	393477	2	1	2	0	0	3
616	393480	2	0	0	0	0	0
616	393481	2	1	0	0	0	1
616	393482	2	0	1	0	0	1
616	393485	2	1	1	0	0	2
616	393490	2	0	0	0	0	0
616	393498	2	0	1	0	0	1
616	393502	2	2	0	0	0	2
616	393507	2	1	0	0	1	2
616	393508	2	2	0	0	0	2
616	393510	2	0	0	0	1	1
616	393511	2	3	0	0	0	3
616	393512	2	3	0	0	0	3
616	186614	1	1	0	0	0	1
616	191220	1	2	1	0	0	3
616	201507	1	0	0	0	0	0
616	202960	1	0	0	0	1	1
616	221933	1	3	0	0	2	5
616	393315	1	0	2	0	0	2
616	393322	1	1	2	0	0	3
616	393324	1	1	1	0	1	3
616	393358	1	1	0	0	0	1
616	393389	1	0	0	0	0	0
616	393395	1	0	0	0	0	0
616	393396	1	1	0	0	0	1
616	393402	1	2	0	0	0	2
616	393407	1	1	1	0	0	2
616	393410	1	0	0	0	0	0
616	393448	1	1	0	0	0	1
616	393450	1	0	0	0	0	0
616	393451	1	3	0	0	0	3
616	393476	1	0	0	0	0	0
616	393503	1	0	1	0	0	1
616	393505	1	1	0	0	1	2
15198	405629	20	2	5	1	5	13
15198	405589	16	2	5	1	0	8
15198	196898	15	0	0	2	2	4
15198	405631	13	1	1	0	2	4
15198	405769	13	1	0	0	3	4
15198	405569	12	0	2	1	0	3
15198	405682	11	0	2	0	0	2
15198	405745	11	0	2	0	0	2
15198	405670	10	0	0	0	3	3
15198	405694	10	0	0	1	0	1
15198	405749	10	1	0	0	0	1
15198	194990	9	0	1	0	1	2
15198	405671	9	2	0	0	0	2
15198	405708	9	0	1	0	1	2
15198	405734	9	0	0	0	1	1
15198	405737	9	1	1	0	1	3
15198	405742	9	1	3	0	0	4
15198	405748	9	0	1	0	0	1
15198	405677	8	4	1	0	3	8
15198	200164	7	0	0	0	1	1
15198	405572	7	0	0	0	0	0
15198	405588	7	1	0	0	1	2
15198	405601	7	5	2	0	2	9
15198	405622	7	3	3	0	1	7
15198	405624	7	1	0	0	0	1
15198	405664	7	2	0	0	0	2
15198	405683	7	0	0	0	0	0
15198	405707	7	1	1	0	0	2
15198	405712	7	2	0	0	0	2
15198	405729	7	2	1	0	0	3
15198	405747	7	2	1	0	0	3
15198	405766	7	1	0	0	1	2
15198	189287	6	1	1	1	0	3
15198	203635	6	0	0	0	0	0
15198	287168	6	1	1	0	0	2
15198	405574	6	2	2	1	0	5
15198	405579	6	2	1	0	0	3
15198	405600	6	1	0	0	0	1
15198	405603	6	1	5	0	1	7
15198	405610	6	2	5	0	0	7
15198	405621	6	4	1	0	1	6
15198	405639	6	1	0	0	1	2
15198	405685	6	1	5	0	0	6
15198	405689	6	5	1	0	1	7
15198	405697	6	2	2	0	1	5
15198	405711	6	0	0	0	0	0
15198	405716	6	1	1	0	2	4
15198	405720	6	0	0	0	0	0
15198	405733	6	1	0	0	1	2
15198	405736	6	1	1	0	0	2
15198	405738	6	1	1	0	0	2
15198	405743	6	2	2	0	0	4
15198	405751	6	0	2	0	0	2
15198	405752	6	5	0	0	1	6
15198	405771	6	4	1	0	0	5
15198	405772	6	1	2	0	3	6
15198	405583	5	0	1	1	0	2
15198	405594	5	1	0	0	1	2
15198	405605	5	0	1	0	0	1
15198	405608	5	1	1	0	0	2
15198	405611	5	0	0	0	0	0
15198	405617	5	1	1	0	0	2
15198	405623	5	3	0	0	1	4
15198	405635	5	1	0	0	1	2
15198	405636	5	3	0	1	2	6
15198	405641	5	1	1	0	1	3
15198	405642	5	0	0	0	0	0
15198	405650	5	0	0	0	0	0
15198	405656	5	0	1	1	1	3
15198	405659	5	0	1	0	1	2
15198	405666	5	3	0	0	0	3
15198	405668	5	0	2	1	0	3
15198	405675	5	3	2	0	3	8
15198	405679	5	1	0	0	1	2
15198	405696	5	2	0	0	1	3
15198	405700	5	2	1	0	1	4
15198	405704	5	1	0	0	1	2
15198	405710	5	0	0	0	0	0
15198	405713	5	0	0	0	1	1
15198	405719	5	1	0	0	2	3
15198	405727	5	2	1	0	0	3
15198	405750	5	1	0	0	0	1
15198	405763	5	3	1	0	0	4
15198	405770	5	3	0	0	0	3
15198	206051	4	1	1	0	0	2
15198	209250	4	2	1	0	0	3
15198	209561	4	0	0	1	1	2
15198	210731	4	2	0	0	2	4
15198	218274	4	1	1	0	0	2
15198	287174	4	0	0	0	1	1
15198	287175	4	2	0	0	1	3
15198	287176	4	0	0	0	0	0
15198	405575	4	0	2	0	0	2
15198	405580	4	0	0	0	1	1
15198	405596	4	0	0	0	0	0
15198	405598	4	3	2	0	1	6
15198	405599	4	0	0	0	0	0
15198	405602	4	1	0	0	0	1
15198	405604	4	2	2	0	0	4
15198	405618	4	3	0	0	2	5
15198	405625	4	0	0	0	0	0
15198	405627	4	0	2	0	0	2
15198	405638	4	0	1	0	1	2
15198	405645	4	1	1	0	0	2
15198	405647	4	2	0	0	0	2
15198	405648	4	2	2	0	0	4
15198	405649	4	0	1	0	0	1
15198	405651	4	0	2	0	0	2
15198	405655	4	2	1	0	0	3
15198	405661	4	1	0	0	0	1
15198	405667	4	0	0	0	1	1
15198	405676	4	2	0	0	0	2
15198	405684	4	1	0	0	0	1
15198	405688	4	1	0	2	0	3
15198	405692	4	0	0	0	0	0
15198	405701	4	2	0	0	1	3
15198	405702	4	1	0	0	0	1
15198	405703	4	0	0	0	0	0
15198	405714	4	1	0	0	0	1
15198	405715	4	1	0	0	0	1
15198	405722	4	1	0	0	0	1
15198	405723	4	1	0	0	0	1
15198	405726	4	2	0	0	0	2
15198	405728	4	1	1	1	1	4
15198	405730	4	3	0	0	0	3
15198	405732	4	0	1	0	0	1
15198	405735	4	1	0	0	0	1
15198	405741	4	1	0	0	1	2
15198	405755	4	0	1	0	1	2
15198	405761	4	2	0	0	0	2
15198	405764	4	1	1	0	0	2
15198	405765	4	1	1	0	0	2
15198	405767	4	4	0	0	1	5
15198	405768	4	0	0	0	1	1
15198	405774	4	2	2	0	0	4
15198	405775	4	0	0	0	0	0
15198	184288	3	0	1	0	0	1
15198	192618	3	1	1	0	0	2
15198	198420	3	1	0	1	1	3
15198	208143	3	0	0	0	0	0
15198	287169	3	0	0	0	1	1
15198	405565	3	0	0	1	0	1
15198	405568	3	1	0	0	0	1
15198	405570	3	0	0	0	0	0
15198	405573	3	0	0	0	0	0
15198	405576	3	1	0	0	0	1
15198	405577	3	1	0	0	2	3
15198	405581	3	1	2	1	0	4
15198	405582	3	0	1	0	1	2
15198	405585	3	3	0	0	0	3
15198	405587	3	1	1	0	0	2
15198	405590	3	1	1	0	0	2
15198	405591	3	0	0	0	0	0
15198	405595	3	0	0	0	0	0
15198	405597	3	1	0	0	0	1
15198	405606	3	1	0	0	0	1
15198	405607	3	2	0	0	0	2
15198	405612	3	1	0	0	0	1
15198	405613	3	1	2	0	0	3
15198	405614	3	1	0	0	0	1
15198	405615	3	3	0	0	1	4
15198	405630	3	0	0	1	0	1
15198	405632	3	0	0	0	0	0
15198	405633	3	0	1	0	0	1
15198	405640	3	1	1	0	0	2
15198	405652	3	0	0	1	0	1
15198	405653	3	1	0	0	1	2
15198	405658	3	2	0	0	0	2
15198	405663	3	3	0	0	0	3
15198	405669	3	0	0	0	0	0
15198	405672	3	1	0	0	0	1
15198	405674	3	1	1	0	1	3
15198	405678	3	0	1	0	0	1
15198	405681	3	1	1	0	0	2
15198	405687	3	0	2	0	0	2
15198	405698	3	0	0	0	0	0
15198	405699	3	1	0	1	0	2
15198	405706	3	0	1	1	0	2
15198	405718	3	0	0	0	1	1
15198	405721	3	1	0	0	1	2
15198	405724	3	0	0	0	0	0
15198	405739	3	2	0	0	0	2
15198	405740	3	1	1	0	0	2
15198	405744	3	1	0	1	0	2
15198	405753	3	1	1	0	0	2
15198	405757	3	0	2	0	0	2
15198	405759	3	0	1	2	0	3
15198	405762	3	0	2	0	0	2
15198	405776	3	0	0	0	0	0
15198	405777	3	0	1	0	0	1
15198	186905	2	1	0	0	0	1
15198	191180	2	0	1	0	1	2
15198	191253	2	0	0	0	0	0
15198	204585	2	1	0	0	0	1
15198	215865	2	1	2	1	1	5
15198	287171	2	1	0	0	0	1
15198	287172	2	1	0	0	0	1
15198	405567	2	1	1	0	0	2
15198	405571	2	1	0	0	0	1
15198	405578	2	0	2	0	0	2
15198	405584	2	0	1	0	1	2
15198	405586	2	1	1	0	0	2
15198	405592	2	0	1	1	0	2
15198	405609	2	1	1	0	0	2
15198	405616	2	0	1	0	0	1
15198	405619	2	1	0	0	0	1
15198	405620	2	0	0	0	1	1
15198	405626	2	1	1	0	0	2
15198	405634	2	0	0	0	0	0
15198	405637	2	0	0	0	0	0
15198	405643	2	0	0	0	1	1
15198	405654	2	0	0	0	0	0
15198	405660	2	0	0	0	0	0
15198	405662	2	0	1	0	1	2
15198	405665	2	0	0	0	1	1
15198	405673	2	1	3	0	0	4
15198	405691	2	2	0	0	0	2
15198	405693	2	2	0	0	0	2
15198	405695	2	1	0	0	0	1
15198	405705	2	1	0	0	0	1
15198	405717	2	0	0	0	0	0
15198	405746	2	1	0	0	0	1
15198	405754	2	0	0	0	1	1
15198	405756	2	1	0	0	0	1
15198	405758	2	1	2	0	4	7
15198	405760	2	1	0	0	0	1
15198	405773	2	0	0	0	0	0
15198	188475	1	1	0	0	0	1
15198	195639	1	0	0	0	0	0
15198	205925	1	2	0	0	0	2
15198	206211	1	0	0	0	0	0
15198	212985	1	0	0	0	0	0
15198	287170	1	0	1	0	1	2
15198	287173	1	0	0	0	0	0
15198	405566	1	2	0	0	0	2
15198	405593	1	0	1	0	0	1
15198	405644	1	0	0	0	0	0
15198	405646	1	1	0	0	1	2
15198	405657	1	1	0	0	0	1
15198	405680	1	0	1	0	0	1
15198	405686	1	1	0	0	0	1
15198	405690	1	0	1	0	0	1
15198	405709	1	0	0	1	0	1
15198	405725	1	0	0	0	0	0
15198	405731	1	2	0	0	0	2
37286	96027	55	6	6	4	6	22
37286	293192	52	3	3	0	1	7
37286	57529	52	3	3	0	1	7
37286	75889	33	1	4	1	1	7
37286	202286	30	3	3	2	3	11
37286	293181	29	3	3	2	3	11
37286	538141	29	3	3	2	3	11
37286	82799	29	3	3	2	3	11
37286	187545	28	2	5	1	3	11
37286	538160	28	2	5	1	3	11
37286	58871	28	2	5	1	3	11
37286	79908	28	2	15	5	5	27
37286	293203	27	2	15	5	5	27
37286	102831	26	2	3	0	1	6
37286	107535	26	1	3	0	2	6
37286	293194	26	1	3	0	2	6
37286	293190	23	5	6	1	1	13
37286	293200	23	0	0	0	2	2
37286	63312	23	5	6	1	1	13
37286	106045	22	2	0	0	0	2
37286	181951	22	4	3	2	2	11
37286	219319	22	2	0	0	0	2
37286	49418	22	4	3	2	2	11
37286	538116	22	1	5	1	0	7
37286	538138	22	4	3	2	2	11
37286	83369	22	1	5	1	0	7
37286	538131	19	1	3	0	1	5
37286	83214	19	1	3	0	1	5
37286	51896	18	0	2	1	1	4
37286	81930	18	2	2	0	0	4
37286	293178	17	2	7	1	0	10
37286	293182	17	0	1	1	1	3
37286	293187	17	0	8	0	1	9
37286	293196	17	2	3	0	3	8
37286	538127	17	2	7	1	0	10
37286	538159	17	0	8	0	1	9
37286	58204	17	4	1	0	1	6
37286	80777	17	2	3	0	3	8
37286	85836	17	1	2	0	0	3
37286	86483	17	0	8	0	1	9
37286	92730	17	2	7	1	0	10
37286	293197	16	2	4	0	1	7
37286	50093	16	2	4	0	1	7
37286	538167	16	2	2	0	3	7
37286	538169	16	2	4	0	1	7
37286	106830	15	0	1	0	0	1
37286	293195	15	3	4	0	3	10
37286	293201	15	1	2	0	1	4
37286	52252	15	1	2	0	1	4
37286	52498	15	4	2	0	0	6
37286	538172	15	1	2	0	1	4
37286	56947	15	3	4	0	3	10
37286	80384	15	3	5	1	5	14
37286	107446	14	2	2	0	1	5
37286	538089	14	1	7	0	1	9
37286	538171	14	1	3	0	4	8
37286	59427	14	1	3	0	3	7
37286	86735	13	0	5	0	1	6
37286	293199	12	2	5	0	1	8
37286	538174	12	0	3	0	1	4
37286	59609	12	0	1	0	0	1
37286	66786	12	2	2	0	2	6
37286	69523	12	0	3	0	1	4
37286	81726	12	0	1	0	1	2
37286	538150	11	1	5	0	0	6
37286	77989	11	0	1	0	0	1
37286	81246	11	1	2	0	0	3
37286	538166	10	1	1	0	0	2
37286	59272	10	3	3	0	0	6
37286	75705	10	0	1	0	2	3
37286	89190	10	2	3	1	0	6
37286	106901	9	0	1	2	3	6
37286	538130	9	0	5	0	1	6
37286	58723	9	1	3	1	0	5
37286	65546	9	1	1	0	2	4
37286	68989	9	0	1	0	1	2
37286	81030	9	2	2	0	1	5
37286	94208	9	1	1	0	2	4
37286	101494	8	1	1	0	0	2
37286	293180	8	0	2	0	1	3
37286	293193	8	0	1	0	0	1
37286	50670	8	0	2	1	0	3
37286	538103	8	1	2	0	1	4
37286	538145	8	2	2	0	0	4
37286	538168	8	2	2	0	1	5
37286	57130	8	1	3	0	0	4
37286	92575	8	0	2	0	1	3
37286	97741	8	0	1	0	0	1
37286	99192	8	3	1	0	1	5
37286	102589	7	2	1	0	0	3
37286	293191	7	0	0	0	0	0
37286	293198	7	0	1	0	0	1
37286	538117	7	2	1	0	0	3
37286	538155	7	1	0	0	2	3
37286	78576	7	0	1	0	2	3
37286	80187	7	2	2	1	0	5
37286	92461	7	2	2	0	3	7
37286	94363	7	0	4	0	0	4
37286	103632	6	0	0	0	0	0
37286	105343	6	1	1	0	1	3
37286	293179	6	1	3	1	2	7
37286	538081	6	1	0	0	0	1
37286	538136	6	0	1	0	0	1
37286	538151	6	4	1	0	0	5
37286	56330	6	1	0	0	2	3
37286	71675	6	1	3	1	2	7
37286	84998	6	0	0	0	0	0
37286	92782	6	0	1	0	0	1
37286	97215	6	1	1	0	0	2
37286	98890	6	1	0	0	3	4
37286	99292	6	0	2	0	2	4
37286	103582	5	0	1	0	0	1
37286	108130	5	0	4	0	0	4
37286	182012	5	1	1	0	0	2
37286	191751	5	0	1	0	0	1
37286	193538	5	0	2	0	1	3
37286	221953	5	0	3	0	1	4
37286	293188	5	0	1	0	0	1
37286	293189	5	3	0	0	2	5
37286	50459	5	0	1	0	0	1
37286	538074	5	0	2	0	2	4
37286	538122	5	1	0	0	0	1
37286	538128	5	0	0	0	0	0
37286	538132	5	0	2	0	2	4
37286	538135	5	1	0	0	0	1
37286	538143	5	0	3	0	0	3
37286	538157	5	1	0	0	0	1
37286	538170	5	1	1	0	0	2
37286	538173	5	2	5	1	1	9
37286	64473	5	0	1	0	0	1
37286	74730	5	0	2	0	1	3
37286	79709	5	2	5	1	1	9
37286	92945	5	2	2	0	0	4
37286	105247	4	0	2	0	1	3
37286	293184	4	0	1	0	0	1
37286	293185	4	0	2	0	0	2
37286	293186	4	1	2	0	0	3
37286	538068	4	1	1	0	0	2
37286	538071	4	1	1	1	0	3
37286	538087	4	1	0	0	1	2
37286	538092	4	4	0	0	0	4
37286	538108	4	1	0	0	0	1
37286	538109	4	0	1	0	0	1
37286	538115	4	0	2	0	1	3
37286	538125	4	1	0	0	0	1
37286	538129	4	0	0	0	0	0
37286	538134	4	1	2	0	0	3
37286	538139	4	0	2	0	0	2
37286	538146	4	0	1	0	0	1
37286	538148	4	1	1	0	0	2
37286	55079	4	1	1	0	2	4
37286	63687	4	0	1	0	0	1
37286	68782	4	0	2	0	1	3
37286	71633	4	0	2	0	0	2
37286	84282	4	1	1	0	0	2
37286	85158	4	1	2	0	0	3
37286	89199	4	2	2	0	1	5
37286	98612	4	1	1	0	0	2
37286	107955	3	0	1	0	1	2
37286	184523	3	1	0	0	1	2
37286	293183	3	1	0	0	1	2
37286	50011	3	1	3	0	0	4
37286	51604	3	1	0	0	0	1
37286	538077	3	0	0	1	0	1
37286	538086	3	0	0	0	0	0
37286	538090	3	0	1	0	0	1
37286	538095	3	1	3	1	6	11
37286	538097	3	0	1	0	0	1
37286	538101	3	1	2	0	1	4
37286	538105	3	0	0	0	0	0
37286	538107	3	1	0	0	0	1
37286	538110	3	1	1	0	0	2
37286	538118	3	1	1	0	0	2
37286	538121	3	1	2	0	0	3
37286	538137	3	1	2	0	0	3
37286	538140	3	0	0	0	0	0
37286	538144	3	1	1	1	1	4
37286	538147	3	0	0	0	1	1
37286	538149	3	0	2	0	0	2
37286	538152	3	2	0	0	0	2
37286	538153	3	0	3	0	0	3
37286	538163	3	0	0	0	0	0
37286	538164	3	0	2	0	1	3
37286	538165	3	0	3	0	0	3
37286	55416	3	0	1	0	1	2
37286	57631	3	0	0	0	0	0
37286	67895	3	0	2	0	1	3
37286	87673	3	1	0	0	1	2
37286	89220	3	1	0	0	0	1
37286	92531	3	0	1	0	0	1
37286	108294	2	0	1	0	0	1
37286	194936	2	0	0	0	0	0
37286	53610	2	0	3	0	0	3
37286	538069	2	0	0	0	0	0
37286	538079	2	0	2	0	0	2
37286	538082	2	1	1	0	0	2
37286	538084	2	1	2	0	0	3
37286	538088	2	1	2	0	0	3
37286	538093	2	0	1	0	1	2
37286	538098	2	2	0	0	0	2
37286	538100	2	1	1	0	0	2
37286	538102	2	0	1	0	0	1
37286	538111	2	0	1	0	1	2
37286	538113	2	1	1	0	0	2
37286	538114	2	0	2	0	0	2
37286	538119	2	0	3	0	0	3
37286	538123	2	0	0	0	0	0
37286	538142	2	0	1	0	0	1
37286	538154	2	0	0	0	0	0
37286	538156	2	1	1	0	0	2
37286	538158	2	1	1	0	1	3
37286	538161	2	0	3	0	0	3
37286	58615	2	0	1	0	0	1
37286	86383	2	0	1	0	0	1
37286	100629	1	1	0	0	0	1
37286	189580	1	0	0	0	0	0
37286	199124	1	0	0	0	0	0
37286	208609	1	0	0	0	0	0
37286	538066	1	0	1	0	0	1
37286	538067	1	0	1	0	1	2
37286	538070	1	1	1	0	0	2
37286	538072	1	0	1	0	0	1
37286	538073	1	0	0	0	0	0
37286	538075	1	0	0	0	0	0
37286	538076	1	0	1	0	0	1
37286	538078	1	0	0	0	0	0
37286	538080	1	1	0	0	0	1
37286	538083	1	0	0	0	0	0
37286	538085	1	0	0	0	0	0
37286	538091	1	0	2	0	0	2
37286	538094	1	0	0	0	0	0
37286	538096	1	0	3	0	0	3
37286	538099	1	1	1	0	0	2
37286	538104	1	0	0	0	0	0
37286	538106	1	0	2	0	0	2
37286	538112	1	0	1	0	0	1
37286	538120	1	0	0	0	1	1
37286	538124	1	0	2	0	2	4
37286	538126	1	1	3	0	0	4
37286	538133	1	1	2	0	1	4
37286	538162	1	1	0	0	0	1
37286	85402	1	0	0	0	0	0
18769	198992	46	2	5	0	2	9
18769	288175	46	2	5	0	2	9
18769	74361	45	2	5	0	2	9
18769	86247	41	3	8	3	1	15
18769	213781	38	5	9	3	5	22
18769	99042	38	5	9	3	5	22
18769	210638	32	3	10	3	2	18
18769	427305	31	3	10	3	2	18
18769	221858	28	2	3	1	3	9
18769	187768	24	1	3	0	3	7
18769	79832	24	0	5	0	2	7
18769	99503	24	2	5	2	1	10
18769	288172	23	3	3	1	1	8
18769	427299	23	3	3	1	1	8
18769	193902	22	4	1	0	0	5
18769	288173	21	4	1	0	0	5
18769	88957	21	4	1	0	0	5
18769	186008	20	0	2	0	0	2
18769	288171	18	2	2	0	2	6
18769	71228	18	2	2	0	2	6
18769	78741	18	2	1	0	2	5
18769	94288	16	1	2	1	1	5
18769	202352	15	0	3	1	0	4
18769	52426	15	3	4	0	1	8
18769	288159	14	0	3	1	0	4
18769	427252	14	0	3	1	0	4
18769	82690	14	0	3	1	0	4
18769	194946	13	1	2	1	1	5
18769	427269	13	3	4	0	4	11
18769	427270	13	3	4	0	4	11
18769	427290	13	3	1	0	0	4
18769	75070	13	3	4	0	4	11
18769	200805	12	0	0	0	0	0
18769	288157	12	1	2	0	1	4
18769	288176	12	0	0	0	0	0
18769	76545	12	0	0	0	0	0
18769	95275	12	1	2	0	1	4
18769	184182	11	1	0	0	1	2
18769	221374	11	0	1	0	0	1
18769	288177	11	2	5	1	1	9
18769	288178	11	0	1	0	0	1
18769	427282	11	1	2	0	2	5
18769	427289	11	1	0	0	0	1
18769	427313	11	2	5	1	1	9
18769	427319	11	4	7	0	0	11
18769	97705	11	2	5	1	1	9
18769	106626	10	1	2	1	0	4
18769	221584	10	0	4	0	0	4
18769	69008	10	0	2	0	4	6
18769	85952	10	0	3	0	2	5
18769	288169	9	0	1	0	1	2
18769	66604	9	1	2	0	1	4
18769	191345	8	2	1	0	0	3
18769	193528	8	1	3	0	1	5
18769	200472	8	0	3	0	0	3
18769	288167	8	1	1	0	2	4
18769	427242	8	0	3	1	0	4
18769	427255	8	0	0	0	0	0
18769	427263	8	3	3	0	1	7
18769	427275	8	1	1	0	0	2
18769	427279	8	0	3	1	0	4
18769	427306	8	1	2	0	0	3
18769	427310	8	0	3	0	0	3
18769	427311	8	1	1	0	0	2
18769	427317	8	1	4	0	0	5
18769	427322	8	3	1	0	0	4
18769	50393	8	0	1	1	1	3
18769	50828	8	1	1	0	2	4
18769	72290	8	0	3	0	0	3
18769	85855	8	2	1	0	0	3
18769	91744	8	1	4	0	0	5
18769	104102	7	2	0	0	4	6
18769	184286	7	2	1	0	2	5
18769	195489	7	0	0	1	1	2
18769	207994	7	1	1	0	1	3
18769	212324	7	1	3	0	0	4
18769	288158	7	1	0	0	1	2
18769	427276	7	3	1	0	0	4
18769	427281	7	1	2	0	1	4
18769	427285	7	1	1	0	3	5
18769	427314	7	2	3	0	1	6
18769	63465	7	0	0	0	1	1
18769	88762	7	0	2	0	0	2
18769	101010	6	3	2	0	1	6
18769	105849	6	0	2	0	0	2
18769	107582	6	0	1	0	0	1
18769	184732	6	0	3	0	0	3
18769	190545	6	0	1	0	0	1
18769	207398	6	0	1	0	0	1
18769	210327	6	0	1	0	1	2
18769	211995	6	3	1	0	1	5
18769	214246	6	1	2	0	0	3
18769	219661	6	0	2	0	0	2
18769	288156	6	1	3	0	0	4
18769	288170	6	0	3	0	0	3
18769	288174	6	3	2	0	1	6
18769	427264	6	1	2	0	2	5
18769	427272	6	1	3	0	0	4
18769	427302	6	0	2	0	0	2
18769	427308	6	3	1	1	2	7
18769	54157	6	0	3	0	0	3
18769	57982	6	0	2	0	0	2
18769	76102	6	0	0	0	3	3
18769	96300	6	0	1	0	0	1
18769	104808	5	3	3	0	1	7
18769	195238	5	1	0	0	1	2
18769	197363	5	0	2	0	0	2
18769	209712	5	1	1	0	0	2
18769	211295	5	1	2	0	2	5
18769	288162	5	1	2	0	1	4
18769	288165	5	0	2	0	2	4
18769	427239	5	0	2	0	1	3
18769	427258	5	1	0	0	0	1
18769	427267	5	0	2	0	0	2
18769	427271	5	1	1	2	0	4
18769	427278	5	3	1	0	1	5
18769	427284	5	3	2	0	0	5
18769	427291	5	2	3	0	0	5
18769	427293	5	0	1	0	0	1
18769	427297	5	1	1	0	2	4
18769	427307	5	1	1	1	0	3
18769	427323	5	1	2	0	3	6
18769	50445	5	1	3	0	0	4
18769	62351	5	0	2	0	0	2
18769	68769	5	0	2	0	1	3
18769	74157	5	0	0	0	0	0
18769	80703	5	0	2	0	2	4
18769	84667	5	1	2	0	1	4
18769	103749	4	0	0	0	0	0
18769	108351	4	1	1	0	0	2
18769	184463	4	3	1	0	0	4
18769	188946	4	2	1	0	0	3
18769	191049	4	1	2	0	1	4
18769	194785	4	0	2	0	0	2
18769	201708	4	1	1	0	1	3
18769	205298	4	0	1	0	0	1
18769	205453	4	2	1	0	1	4
18769	207167	4	1	1	0	0	2
18769	214975	4	0	1	0	0	1
18769	215817	4	2	1	0	0	3
18769	220344	4	0	1	0	0	1
18769	288160	4	0	0	0	0	0
18769	288166	4	0	2	0	0	2
18769	427238	4	0	2	1	0	3
18769	427240	4	0	2	0	0	2
18769	427249	4	0	2	0	0	2
18769	427250	4	0	3	1	0	4
18769	427256	4	1	1	0	0	2
18769	427262	4	0	3	0	0	3
18769	427265	4	0	0	0	0	0
18769	427277	4	1	2	0	2	5
18769	427283	4	2	3	0	2	7
18769	427287	4	0	1	0	1	2
18769	427288	4	0	2	0	1	3
18769	427295	4	1	1	0	0	2
18769	427298	4	0	4	0	1	5
18769	427300	4	2	1	0	0	3
18769	427303	4	0	2	0	0	2
18769	427304	4	1	0	0	0	1
18769	427312	4	2	3	0	1	6
18769	427315	4	0	2	0	1	3
18769	427316	4	0	1	0	1	2
18769	427321	4	1	0	0	0	1
18769	427324	4	0	1	0	0	1
18769	53931	4	1	4	0	1	6
18769	72734	4	0	2	0	0	2
18769	88801	4	0	1	0	0	1
18769	89245	4	0	1	0	0	1
18769	97187	4	0	2	1	4	7
18769	105226	3	0	2	0	2	4
18769	182682	3	1	1	0	0	2
18769	185932	3	0	1	0	0	1
18769	186220	3	0	2	0	0	2
18769	188461	3	1	1	0	0	2
18769	189416	3	0	0	0	0	0
18769	194104	3	0	1	0	0	1
18769	197975	3	0	0	0	0	0
18769	205828	3	0	1	0	0	1
18769	217127	3	2	1	0	0	3
18769	217366	3	0	1	0	0	1
18769	218069	3	1	2	0	0	3
18769	220701	3	2	1	0	1	4
18769	221002	3	1	2	0	0	3
18769	288161	3	0	2	0	0	2
18769	288163	3	1	0	0	0	1
18769	288168	3	1	1	0	0	2
18769	427241	3	2	3	0	0	5
18769	427246	3	0	3	0	0	3
18769	427247	3	0	0	0	1	1
18769	427251	3	0	0	0	0	0
18769	427257	3	0	0	2	0	2
18769	427259	3	3	2	0	1	6
18769	427260	3	1	1	0	0	2
18769	427266	3	1	0	0	0	1
18769	427280	3	1	2	0	0	3
18769	427292	3	0	2	0	0	2
18769	427294	3	0	0	0	0	0
18769	427309	3	2	3	0	1	6
18769	427320	3	1	4	0	0	5
18769	55146	3	3	3	1	1	8
18769	61970	3	1	2	0	0	3
18769	70760	3	0	2	0	0	2
18769	71190	3	1	0	0	0	1
18769	105446	2	0	0	0	0	0
18769	106436	2	0	4	0	0	4
18769	182191	2	0	2	0	0	2
18769	183691	2	0	1	0	0	1
18769	186616	2	1	1	0	0	2
18769	190010	2	0	0	0	2	2
18769	203664	2	0	2	0	0	2
18769	209853	2	0	0	0	0	0
18769	210466	2	1	1	0	0	2
18769	288164	2	0	0	0	0	0
18769	427237	2	0	3	0	0	3
18769	427245	2	0	1	0	0	1
18769	427248	2	1	2	0	1	4
18769	427253	2	0	2	0	1	3
18769	427254	2	0	0	0	0	0
18769	427268	2	0	0	0	0	0
18769	427273	2	2	1	0	0	3
18769	427286	2	0	1	0	0	1
18769	427301	2	0	1	0	0	1
18769	58613	2	0	0	0	0	0
18769	69826	2	0	0	0	1	1
18769	80941	2	0	0	0	0	0
18769	195675	1	1	1	0	0	2
18769	199845	1	0	0	0	0	0
18769	203322	1	0	0	0	0	0
18769	213372	1	0	0	0	0	0
18769	427234	1	0	1	0	0	1
18769	427235	1	0	1	0	0	1
18769	427236	1	0	0	0	0	0
18769	427243	1	0	1	0	4	5
18769	427244	1	0	0	0	0	0
18769	427261	1	1	2	0	0	3
18769	427274	1	0	1	0	0	1
18769	427318	1	0	2	0	0	2
18769	88833	1	0	1	0	0	1
34139	89475	43	4	9	3	15	31
34139	107656	41	7	3	1	6	17
34139	434812	41	4	9	3	17	33
34139	222257	40	6	2	0	4	12
34139	434861	38	6	2	0	4	12
34139	220477	37	7	3	1	6	17
34139	190292	34	2	2	0	3	7
34139	434862	34	2	2	0	3	7
34139	104398	32	5	0	0	1	6
34139	83208	30	2	2	0	2	6
34139	434829	29	2	2	0	2	6
34139	191650	26	7	1	5	1	14
34139	80763	26	3	2	1	9	15
34139	187238	25	5	1	0	1	7
34139	434843	25	1	2	1	2	6
34139	56986	25	1	1	0	4	6
34139	64773	25	4	2	0	1	7
34139	292309	24	1	1	0	4	6
34139	63020	22	5	3	0	2	10
34139	55175	21	10	1	1	2	14
34139	434860	20	5	2	2	8	17
34139	99955	20	6	3	0	1	10
34139	292314	18	3	1	0	2	6
34139	75395	18	2	1	3	2	8
34139	80483	18	3	1	0	2	6
34139	292308	17	3	0	0	1	4
34139	75524	17	3	0	0	1	4
34139	434777	16	3	2	0	1	6
34139	100702	15	4	6	3	2	15
34139	434857	15	8	2	1	1	12
34139	106827	14	2	1	1	1	5
34139	198204	14	3	7	0	4	14
34139	434847	14	2	0	2	0	4
34139	79270	14	5	3	1	2	11
34139	292319	13	3	7	0	4	14
34139	434767	13	4	2	4	6	16
34139	434837	13	3	1	1	1	6
34139	434859	13	3	7	0	4	14
34139	51390	13	3	7	0	4	14
34139	188357	11	4	1	0	3	8
34139	198287	11	1	6	3	2	12
34139	434756	11	1	6	3	2	12
34139	434809	11	0	1	0	1	2
34139	434831	11	3	0	1	5	9
34139	434850	11	3	1	3	5	12
34139	434853	11	2	1	0	3	6
34139	434856	11	1	0	0	1	2
34139	190785	10	0	1	0	3	4
34139	211930	10	2	1	1	1	5
34139	292313	10	4	0	1	2	7
34139	434779	10	1	0	0	0	1
34139	434821	10	4	0	1	2	7
34139	434848	10	1	2	0	4	7
34139	59627	10	0	1	1	0	2
34139	85955	10	6	0	0	0	6
34139	86481	10	4	0	1	2	7
34139	191897	8	2	0	0	2	4
34139	292307	8	1	2	1	1	5
34139	434822	8	2	0	1	2	5
34139	434833	8	1	2	0	1	4
34139	434838	8	1	2	1	2	6
34139	434844	8	0	2	1	3	6
34139	74621	8	1	2	0	1	4
34139	78516	8	2	0	1	2	5
34139	85894	8	1	2	1	1	5
34139	188277	7	6	4	1	0	11
34139	212166	7	3	3	0	0	6
34139	292318	7	2	0	0	2	4
34139	434747	7	0	0	0	3	3
34139	434781	7	3	3	0	0	6
34139	434855	7	2	2	0	1	5
34139	434858	7	1	1	2	3	7
34139	59268	7	2	2	0	0	4
34139	64452	7	2	0	0	2	4
34139	67663	7	1	0	0	1	2
34139	101493	6	6	0	1	1	8
34139	191147	6	2	0	0	0	2
34139	212811	6	0	0	1	2	3
34139	213314	6	1	0	0	1	2
34139	292315	6	1	0	0	2	3
34139	434745	6	2	4	0	1	7
34139	434765	6	0	4	2	1	7
34139	434766	6	0	1	2	3	6
34139	434773	6	2	0	0	0	2
34139	434795	6	4	2	0	0	6
34139	434799	6	4	0	0	0	4
34139	434811	6	4	1	0	0	5
34139	434824	6	2	0	0	1	3
34139	434830	6	0	2	0	2	4
34139	434839	6	3	2	2	1	8
34139	434851	6	0	0	0	1	1
34139	434854	6	3	3	0	0	6
34139	434863	6	1	1	0	0	2
34139	82212	6	2	0	1	0	3
34139	103579	5	1	3	0	0	4
34139	106006	5	3	0	0	0	3
34139	188311	5	2	0	1	0	3
34139	194630	5	4	0	0	1	5
34139	219588	5	3	0	0	0	3
34139	292305	5	1	3	0	1	5
34139	434749	5	5	0	0	0	5
34139	434763	5	1	1	0	0	2
34139	434784	5	2	0	0	5	7
34139	434801	5	2	0	1	0	3
34139	434810	5	5	1	0	2	8
34139	434852	5	1	2	0	2	5
34139	50239	5	3	0	0	0	3
34139	78515	5	1	0	0	0	1
34139	81029	5	2	1	0	0	3
34139	94523	5	1	3	0	1	5
34139	105245	4	1	2	0	3	6
34139	183767	4	0	2	1	0	3
34139	193352	4	0	0	0	2	2
34139	212859	4	2	0	0	0	2
34139	292302	4	2	0	0	1	3
34139	292306	4	0	3	0	0	3
34139	434746	4	1	1	0	2	4
34139	434750	4	1	0	0	0	1
34139	434755	4	0	0	0	1	1
34139	434757	4	3	0	0	0	3
34139	434758	4	0	0	0	0	0
34139	434760	4	2	0	0	0	2
34139	434768	4	4	0	0	1	5
34139	434775	4	0	2	1	1	4
34139	434778	4	1	1	0	2	4
34139	434785	4	3	1	0	0	4
34139	434800	4	2	0	1	0	3
34139	434802	4	1	0	0	0	1
34139	434803	4	1	1	0	0	2
34139	434805	4	3	2	0	0	5
34139	434807	4	0	0	0	0	0
34139	434808	4	1	2	0	0	3
34139	434817	4	4	0	0	0	4
34139	434820	4	1	1	0	1	3
34139	434826	4	3	0	2	0	5
34139	434828	4	0	1	0	1	2
34139	434834	4	0	0	0	1	1
34139	434835	4	4	0	0	1	5
34139	434836	4	3	1	0	1	5
34139	434842	4	2	0	0	0	2
34139	434846	4	1	0	2	0	3
34139	67239	4	0	3	0	0	3
34139	68778	4	0	0	0	1	1
34139	74262	4	1	0	0	0	1
34139	99996	4	2	0	0	1	3
34139	203951	3	1	3	0	0	4
34139	209353	3	1	2	0	0	3
34139	214898	3	2	0	0	0	2
34139	292303	3	2	0	0	0	2
34139	292312	3	0	0	0	0	0
34139	292316	3	1	0	0	1	2
34139	434738	3	1	0	1	0	2
34139	434769	3	3	1	0	1	5
34139	434770	3	0	2	0	1	3
34139	434771	3	2	1	0	0	3
34139	434772	3	1	2	0	0	3
34139	434774	3	2	0	0	2	4
34139	434783	3	1	0	0	2	3
34139	434786	3	2	1	0	0	3
34139	434789	3	3	0	0	2	5
34139	434790	3	2	1	0	0	3
34139	434792	3	2	1	0	0	3
34139	434796	3	0	0	0	0	0
34139	434804	3	0	1	0	1	2
34139	434806	3	2	2	0	0	4
34139	434813	3	0	1	0	0	1
34139	434815	3	3	1	0	0	4
34139	434825	3	2	2	0	0	4
34139	434832	3	2	1	0	0	3
34139	434840	3	3	0	0	0	3
34139	434849	3	2	1	0	1	4
34139	50198	3	1	2	1	0	4
34139	56838	3	2	1	0	0	3
34139	57370	3	0	0	0	1	1
34139	63507	3	0	0	0	1	1
34139	68982	3	2	0	0	0	2
34139	84701	3	1	0	0	1	2
34139	88299	3	2	0	0	0	2
34139	183442	2	2	0	0	0	2
34139	190832	2	1	0	0	0	1
34139	196868	2	1	1	0	1	3
34139	205586	2	2	0	0	0	2
34139	215154	2	1	0	0	0	1
34139	217739	2	0	0	0	2	2
34139	292304	2	0	0	0	1	1
34139	434730	2	1	0	2	0	3
34139	434731	2	2	1	0	0	3
34139	434740	2	1	0	0	0	1
34139	434744	2	3	0	0	0	3
34139	434751	2	1	0	0	1	2
34139	434754	2	2	0	0	0	2
34139	434759	2	1	1	0	1	3
34139	434761	2	1	1	0	1	3
34139	434764	2	1	1	0	0	2
34139	434776	2	3	2	0	0	5
34139	434780	2	0	1	0	0	1
34139	434787	2	0	0	0	2	2
34139	434797	2	1	1	0	0	2
34139	434814	2	1	0	0	0	1
34139	434816	2	1	0	0	0	1
34139	434823	2	3	1	0	0	4
34139	434827	2	0	0	0	0	0
34139	434841	2	2	0	0	0	2
34139	434845	2	1	0	0	1	2
34139	63929	2	1	2	0	0	3
34139	70678	2	1	0	0	1	2
34139	88681	2	1	0	0	0	1
34139	196224	1	1	0	0	0	1
34139	213484	1	0	0	0	1	1
34139	292317	1	3	1	0	1	5
34139	434732	1	2	0	0	0	2
34139	434733	1	0	0	0	0	0
34139	434734	1	0	1	0	0	1
34139	434735	1	1	0	0	0	1
34139	434736	1	2	0	0	0	2
34139	434737	1	0	0	1	1	2
34139	434739	1	3	0	0	1	4
34139	434741	1	1	0	0	0	1
34139	434742	1	0	0	0	1	1
34139	434743	1	2	1	0	1	4
34139	434748	1	3	1	0	0	4
34139	434752	1	1	0	0	0	1
34139	434753	1	1	0	1	0	2
34139	434762	1	0	0	0	0	0
34139	434782	1	0	0	0	0	0
34139	434788	1	0	0	0	1	1
34139	434791	1	2	0	0	0	2
34139	434793	1	1	0	1	0	2
34139	434794	1	0	0	0	0	0
34139	434798	1	1	0	0	1	2
34139	434818	1	1	0	0	0	1
34139	434819	1	1	0	0	0	1
30503	185377	33	2	1	0	1	4
30503	202463	23	1	6	0	2	9
30503	291173	23	1	6	0	2	9
30503	468481	23	1	6	0	2	9
30503	291200	22	1	1	0	3	5
30503	468620	19	4	3	2	1	10
30503	468476	17	3	2	0	0	5
30503	468532	17	0	1	0	2	3
30503	185956	16	0	3	0	0	3
30503	468491	15	1	2	1	1	5
30503	468499	15	1	3	0	1	5
30503	468591	15	3	2	1	3	9
30503	468509	13	0	4	0	0	4
30503	468523	12	0	2	0	1	3
30503	468592	12	3	2	0	0	5
30503	468479	10	1	3	0	0	4
30503	468513	10	1	1	0	0	2
30503	468538	10	3	0	0	0	3
30503	193119	9	1	2	0	1	4
30503	203068	9	2	2	0	0	4
30503	468500	9	2	2	0	0	4
30503	468517	9	2	2	0	0	4
30503	468621	9	1	1	0	0	2
30503	291206	8	1	0	0	1	2
30503	468614	8	1	2	1	0	4
30503	189894	7	0	2	0	0	2
30503	213347	7	0	2	0	0	2
30503	214783	7	2	3	0	3	8
30503	216125	7	3	2	0	0	5
30503	291183	7	0	0	0	0	0
30503	291187	7	0	2	0	0	2
30503	291191	7	2	1	0	4	7
30503	291193	7	3	3	0	0	6
30503	291202	7	0	1	0	0	1
30503	468474	7	3	0	0	1	4
30503	468519	7	2	3	0	0	5
30503	468536	7	1	1	0	1	3
30503	468539	7	0	0	0	1	1
30503	468579	7	5	2	1	0	8
30503	468607	7	0	2	0	0	2
30503	468624	7	0	2	0	0	2
30503	214643	6	1	1	0	0	2
30503	291181	6	2	1	0	1	4
30503	291184	6	1	2	0	0	3
30503	291185	6	2	3	0	3	8
30503	291203	6	3	2	0	0	5
30503	468475	6	0	0	0	0	0
30503	468482	6	3	2	0	0	5
30503	468516	6	2	1	0	1	4
30503	468521	6	2	1	0	4	7
30503	468522	6	2	0	0	0	2
30503	468570	6	1	3	0	1	5
30503	468576	6	2	1	0	1	4
30503	468587	6	1	1	0	0	2
30503	468596	6	0	0	0	1	1
30503	468625	6	0	4	0	1	5
30503	468626	6	2	1	0	0	3
30503	185876	5	0	1	1	0	2
30503	194900	5	0	1	0	0	1
30503	195309	5	0	1	0	0	1
30503	195313	5	0	0	0	1	1
30503	199177	5	3	1	0	0	4
30503	206875	5	0	2	0	0	2
30503	291174	5	1	2	0	0	3
30503	291176	5	3	1	0	0	4
30503	291186	5	2	1	0	0	3
30503	291190	5	2	3	0	0	5
30503	291196	5	2	1	0	0	3
30503	291199	5	4	1	0	0	5
30503	468496	5	0	0	2	0	2
30503	468503	5	1	1	0	0	2
30503	468510	5	1	0	0	0	1
30503	468529	5	0	1	0	0	1
30503	468535	5	0	0	0	0	0
30503	468537	5	0	4	0	0	4
30503	468544	5	0	1	0	0	1
30503	468548	5	1	3	0	0	4
30503	468550	5	1	0	0	1	2
30503	468551	5	0	3	0	0	3
30503	468552	5	1	1	0	1	3
30503	468559	5	1	1	0	0	2
30503	468560	5	1	2	0	1	4
30503	468563	5	2	2	0	0	4
30503	468567	5	3	2	0	0	5
30503	468571	5	0	2	0	0	2
30503	468573	5	0	1	0	0	1
30503	468600	5	1	1	0	0	2
30503	468616	5	3	3	0	0	6
30503	468618	5	2	1	0	0	3
30503	468623	5	1	3	0	0	4
30503	187009	4	1	0	0	2	3
30503	190444	4	0	1	0	0	1
30503	198520	4	1	2	0	0	3
30503	206580	4	1	0	0	0	1
30503	210555	4	2	1	0	0	3
30503	212976	4	0	2	0	0	2
30503	220697	4	1	0	0	0	1
30503	291177	4	0	1	0	1	2
30503	291178	4	1	2	0	0	3
30503	291179	4	0	0	0	0	0
30503	291180	4	0	1	0	1	2
30503	291192	4	0	1	0	0	1
30503	291194	4	2	2	0	0	4
30503	291195	4	1	1	0	0	2
30503	468480	4	1	1	0	0	2
30503	468484	4	1	0	0	0	1
30503	468488	4	1	3	0	1	5
30503	468489	4	1	2	0	0	3
30503	468492	4	0	3	0	0	3
30503	468494	4	1	1	0	0	2
30503	468497	4	0	2	1	0	3
30503	468498	4	2	1	0	0	3
30503	468504	4	0	1	0	0	1
30503	468505	4	1	2	0	0	3
30503	468512	4	0	0	0	1	1
30503	468518	4	1	0	1	1	3
30503	468524	4	0	2	0	0	2
30503	468527	4	1	1	0	0	2
30503	468530	4	0	1	0	1	2
30503	468533	4	1	5	0	0	6
30503	468534	4	1	1	0	0	2
30503	468542	4	0	3	0	0	3
30503	468543	4	1	2	0	0	3
30503	468545	4	0	0	0	0	0
30503	468547	4	1	1	0	0	2
30503	468549	4	0	1	0	0	1
30503	468556	4	0	2	0	1	3
30503	468564	4	0	1	0	0	1
30503	468566	4	2	2	0	0	4
30503	468568	4	2	1	0	0	3
30503	468569	4	1	0	0	0	1
30503	468574	4	1	0	0	0	1
30503	468575	4	0	2	0	1	3
30503	468577	4	1	2	0	0	3
30503	468578	4	0	0	0	0	0
30503	468580	4	0	0	0	1	1
30503	468584	4	3	0	0	0	3
30503	468585	4	1	1	0	0	2
30503	468590	4	0	1	0	0	1
30503	468597	4	0	0	0	0	0
30503	468604	4	2	0	0	1	3
30503	468608	4	1	1	0	0	2
30503	468609	4	0	0	0	0	0
30503	468611	4	1	2	0	0	3
30503	468612	4	1	2	0	0	3
30503	468613	4	0	1	0	0	1
30503	468617	4	1	2	0	0	3
30503	468629	4	1	1	0	0	2
30503	186057	3	0	3	1	0	4
30503	186497	3	2	0	0	0	2
30503	197078	3	0	2	0	0	2
30503	211884	3	0	3	0	0	3
30503	214526	3	1	1	0	0	2
30503	216694	3	1	2	0	0	3
30503	218511	3	2	2	0	0	4
30503	219973	3	0	0	0	2	2
30503	220264	3	0	2	0	0	2
30503	291175	3	1	0	0	0	1
30503	291182	3	0	2	0	0	2
30503	291188	3	1	2	0	0	3
30503	291189	3	2	2	0	0	4
30503	291205	3	2	0	0	0	2
30503	468495	3	0	3	0	0	3
30503	468501	3	1	0	0	0	1
30503	468507	3	0	1	0	1	2
30503	468520	3	1	2	0	0	3
30503	468526	3	1	2	0	0	3
30503	468528	3	0	1	0	0	1
30503	468540	3	0	0	0	0	0
30503	468546	3	1	0	0	1	2
30503	468553	3	0	1	0	1	2
30503	468554	3	0	4	0	0	4
30503	468561	3	3	2	0	1	6
30503	468562	3	2	1	0	0	3
30503	468565	3	0	1	0	0	1
30503	468581	3	0	2	0	0	2
30503	468588	3	0	1	0	0	1
30503	468595	3	1	0	0	0	1
30503	468598	3	2	1	0	1	4
30503	468599	3	0	2	0	0	2
30503	468603	3	1	1	0	0	2
30503	468610	3	1	2	0	0	3
30503	468615	3	2	0	0	0	2
30503	468619	3	1	2	0	0	3
30503	468628	3	1	3	0	0	4
30503	468630	3	0	0	0	0	0
30503	191051	2	0	1	0	0	1
30503	203134	2	0	0	0	0	0
30503	204601	2	1	1	0	0	2
30503	209598	2	0	1	0	0	1
30503	216545	2	0	1	0	0	1
30503	221595	2	0	2	0	1	3
30503	291204	2	0	0	0	1	1
30503	291207	2	0	0	0	0	0
30503	468478	2	0	0	0	0	0
30503	468483	2	0	0	1	1	2
30503	468486	2	1	0	1	0	2
30503	468487	2	0	1	0	0	1
30503	468490	2	0	0	0	0	0
30503	468493	2	2	3	0	0	5
30503	468502	2	1	0	0	0	1
30503	468506	2	2	3	0	0	5
30503	468508	2	1	4	0	0	5
30503	468541	2	1	0	0	0	1
30503	468555	2	0	0	0	0	0
30503	468558	2	1	0	0	0	1
30503	468572	2	1	1	0	0	2
30503	468582	2	1	1	0	0	2
30503	468583	2	0	1	0	0	1
30503	468586	2	0	2	0	0	2
30503	468593	2	0	0	0	0	0
30503	468594	2	0	2	0	0	2
30503	468601	2	0	1	0	0	1
30503	468602	2	0	1	0	0	1
30503	468605	2	0	2	0	0	2
30503	468622	2	0	1	0	0	1
30503	468627	2	2	1	0	0	3
30503	201911	1	0	0	0	1	1
30503	205984	1	0	0	0	0	0
30503	208140	1	1	0	0	0	1
30503	291197	1	1	0	0	0	1
30503	291198	1	0	0	0	0	0
30503	291201	1	1	2	0	0	3
30503	468477	1	0	2	0	0	2
30503	468485	1	0	0	0	0	0
30503	468511	1	0	0	0	1	1
30503	468514	1	2	1	0	0	3
30503	468515	1	0	0	0	2	2
30503	468525	1	0	1	0	1	2
30503	468531	1	0	0	0	0	0
30503	468557	1	1	1	0	0	2
30503	468589	1	2	3	0	0	5
30503	468606	1	1	1	0	0	2
20167	198950	35	2	5	0	1	8
20167	288610	34	2	5	0	1	8
20167	74368	34	2	5	0	1	8
20167	186102	31	8	3	0	1	12
20167	210645	31	5	6	3	0	14
20167	572714	31	5	6	3	0	14
20167	288616	30	8	3	0	1	12
20167	78030	27	1	3	0	1	5
20167	202449	20	2	2	0	1	5
20167	288605	20	2	2	0	1	5
20167	288606	20	1	5	1	0	7
20167	52429	20	1	5	1	0	7
20167	572673	20	2	2	0	1	5
20167	82718	20	2	2	0	1	5
20167	210900	18	2	2	2	1	7
20167	572753	17	0	3	0	4	7
20167	572702	15	0	4	1	0	5
20167	572712	15	0	4	1	0	5
20167	59782	15	2	3	1	1	7
20167	187355	14	1	4	1	0	6
20167	188787	14	2	3	1	1	7
20167	217063	14	1	2	0	2	5
20167	288624	14	2	3	1	1	7
20167	572677	14	2	5	2	2	11
20167	75071	14	2	5	2	2	11
20167	100208	13	0	2	1	0	3
20167	51648	13	5	4	1	5	15
20167	572706	13	0	2	1	0	3
20167	88763	13	2	1	1	0	4
20167	204687	12	0	4	0	0	4
20167	572755	12	0	1	0	0	1
20167	200558	11	0	0	0	1	1
20167	204053	11	2	1	0	1	4
20167	51270	11	1	3	0	2	6
20167	572709	11	0	0	0	1	1
20167	72291	11	0	0	0	1	1
20167	89621	11	2	1	0	0	3
20167	185743	10	0	2	0	0	2
20167	216342	10	1	3	0	1	5
20167	220250	10	0	1	0	1	2
20167	49582	10	0	1	0	0	1
20167	572687	10	8	2	0	0	10
20167	572737	10	1	1	0	0	2
20167	572760	10	2	2	0	1	5
20167	572745	9	2	3	1	1	7
20167	572758	9	2	2	2	1	7
20167	101013	8	4	1	0	1	6
20167	183336	8	0	2	0	1	3
20167	216939	8	1	2	1	1	5
20167	288609	8	0	2	0	0	2
20167	288623	8	2	3	0	1	6
20167	288627	8	4	1	0	1	6
20167	572707	8	0	2	0	1	3
20167	572728	8	4	1	2	1	8
20167	572749	8	1	2	1	0	4
20167	572762	8	2	2	0	0	4
20167	58631	8	2	3	0	1	6
20167	183119	7	0	0	0	0	0
20167	211357	7	0	2	0	1	3
20167	288614	7	2	2	0	0	4
20167	50836	7	2	2	0	0	4
20167	572692	7	3	1	0	2	6
20167	572713	7	1	0	2	2	5
20167	572722	7	0	2	0	3	5
20167	572729	7	1	0	1	0	2
20167	572732	7	4	0	0	0	4
20167	101646	6	0	1	1	2	4
20167	188189	6	1	1	4	3	9
20167	210301	6	0	3	1	1	5
20167	214389	6	1	1	0	0	2
20167	215848	6	0	2	0	0	2
20167	220997	6	0	0	0	0	0
20167	288615	6	0	1	1	2	4
20167	572679	6	3	1	1	1	6
20167	572683	6	1	0	1	0	2
20167	572690	6	0	0	0	1	1
20167	572694	6	2	3	0	0	5
20167	572700	6	1	1	0	2	4
20167	572716	6	1	2	0	0	3
20167	572726	6	2	2	0	0	4
20167	572727	6	2	0	0	0	2
20167	572731	6	1	1	0	0	2
20167	572739	6	2	2	0	0	4
20167	572747	6	1	0	2	2	5
20167	572754	6	2	0	0	0	2
20167	79549	6	0	2	0	0	2
20167	185788	5	0	0	0	0	0
20167	189185	5	1	1	1	1	4
20167	194773	5	0	1	0	0	1
20167	204296	5	0	1	0	0	1
20167	210006	5	0	0	0	0	0
20167	221589	5	1	1	0	0	2
20167	288612	5	1	1	0	0	2
20167	288619	5	1	3	0	0	4
20167	288625	5	1	0	0	0	1
20167	52992	5	0	0	0	0	0
20167	53846	5	1	0	0	0	1
20167	572662	5	2	3	0	2	7
20167	572666	5	1	1	0	0	2
20167	572680	5	0	0	0	1	1
20167	572698	5	0	0	0	0	0
20167	572701	5	0	1	1	0	2
20167	572719	5	0	3	0	0	3
20167	572720	5	0	1	1	1	3
20167	572725	5	1	1	0	0	2
20167	90655	5	1	3	0	0	4
20167	193557	4	0	1	0	0	1
20167	195507	4	0	1	0	0	1
20167	195610	4	0	2	0	0	2
20167	197063	4	0	2	0	0	2
20167	206627	4	1	2	0	0	3
20167	207049	4	0	0	0	0	0
20167	212655	4	1	1	0	0	2
20167	218754	4	2	0	0	1	3
20167	288607	4	0	1	0	0	1
20167	288608	4	0	0	0	0	0
20167	288617	4	0	0	0	1	1
20167	288620	4	0	1	0	0	1
20167	572665	4	0	0	1	0	1
20167	572670	4	0	1	1	0	2
20167	572678	4	1	2	0	1	4
20167	572681	4	2	1	0	1	4
20167	572684	4	1	2	0	0	3
20167	572685	4	1	1	0	0	2
20167	572686	4	0	3	0	0	3
20167	572691	4	3	0	1	2	6
20167	572696	4	0	2	0	1	3
20167	572699	4	0	2	0	0	2
20167	572704	4	1	3	0	0	4
20167	572705	4	2	1	0	0	3
20167	572710	4	1	0	0	1	2
20167	572711	4	1	0	0	2	3
20167	572717	4	1	1	0	0	2
20167	572724	4	1	0	0	0	1
20167	572730	4	3	1	0	0	4
20167	572743	4	0	1	0	0	1
20167	572744	4	2	0	0	0	2
20167	572757	4	2	0	0	0	2
20167	84393	4	0	1	0	0	1
20167	188988	3	0	1	0	0	1
20167	189163	3	0	2	0	0	2
20167	189704	3	1	0	0	1	2
20167	190501	3	1	0	0	0	1
20167	195554	3	1	1	0	0	2
20167	195763	3	1	1	0	0	2
20167	201695	3	1	0	0	0	1
20167	205277	3	1	1	0	0	2
20167	207311	3	0	1	0	0	1
20167	207375	3	1	0	0	0	1
20167	207413	3	1	2	0	2	5
20167	208111	3	0	0	0	0	0
20167	212968	3	0	3	0	0	3
20167	213869	3	0	0	0	2	2
20167	216701	3	2	1	0	2	5
20167	217353	3	0	0	0	0	0
20167	218391	3	0	0	0	0	0
20167	288603	3	1	1	1	1	4
20167	572667	3	0	1	0	1	2
20167	572669	3	0	1	0	0	1
20167	572671	3	0	2	0	0	2
20167	572674	3	1	1	0	0	2
20167	572676	3	0	0	0	0	0
20167	572682	3	1	2	0	0	3
20167	572688	3	1	2	0	0	3
20167	572689	3	0	2	0	1	3
20167	572695	3	0	1	0	0	1
20167	572703	3	1	2	0	0	3
20167	572715	3	0	0	0	0	0
20167	572718	3	1	1	0	0	2
20167	572733	3	0	1	0	0	1
20167	572736	3	1	2	0	0	3
20167	572741	3	0	0	0	1	1
20167	572748	3	1	2	1	0	4
20167	572750	3	1	0	0	0	1
20167	572751	3	1	2	0	0	3
20167	572752	3	1	2	0	2	5
20167	572761	3	0	3	0	0	3
20167	81313	3	2	2	0	0	4
20167	84671	3	1	1	1	1	4
20167	188481	2	0	0	0	0	0
20167	192608	2	0	1	0	0	1
20167	200142	2	0	1	0	0	1
20167	203851	2	0	2	0	0	2
20167	207571	2	0	0	0	0	0
20167	210402	2	1	1	0	2	4
20167	217909	2	0	1	0	0	1
20167	220672	2	0	0	0	0	0
20167	221518	2	1	0	0	0	1
20167	288613	2	0	0	0	0	0
20167	288618	2	1	0	0	0	1
20167	288621	2	0	0	0	0	0
20167	288622	2	1	1	0	0	2
20167	572664	2	0	0	0	0	0
20167	572668	2	0	1	1	0	2
20167	572675	2	0	1	0	0	1
20167	572693	2	2	2	0	0	4
20167	572697	2	0	1	0	1	2
20167	572721	2	0	3	0	0	3
20167	572735	2	0	3	0	0	3
20167	572742	2	0	0	0	0	0
20167	572746	2	2	1	0	0	3
20167	71995	2	1	0	0	0	1
20167	85618	2	1	1	0	0	2
20167	93762	2	0	0	0	0	0
20167	191228	1	0	2	0	0	2
20167	196466	1	0	0	0	1	1
20167	196469	1	0	1	0	0	1
20167	199893	1	0	1	0	0	1
20167	200090	1	1	3	0	0	4
20167	205330	1	0	0	0	0	0
20167	205785	1	0	0	0	0	0
20167	205982	1	0	0	0	0	0
20167	207190	1	0	1	0	0	1
20167	210052	1	0	1	0	0	1
20167	288604	1	1	0	0	0	1
20167	288611	1	1	0	0	0	1
20167	288626	1	0	0	0	0	0
20167	53655	1	0	0	0	0	0
20167	572663	1	0	1	0	0	1
20167	572672	1	0	2	0	0	2
20167	572708	1	0	1	0	1	2
20167	572723	1	1	0	0	0	1
20167	572734	1	1	2	0	0	3
20167	572738	1	1	0	0	0	1
20167	572740	1	0	1	0	0	1
20167	572756	1	1	0	0	0	1
20167	572759	1	0	1	0	1	2
20167	71285	1	1	0	0	0	1
20167	92541	1	1	0	0	0	1
64487	63380	28	5	3	0	0	8
64487	435453	16	5	3	0	1	9
64487	435495	13	2	1	1	0	4
64487	435456	12	1	0	0	1	2
64487	212044	11	0	3	0	1	4
64487	221729	11	1	1	0	1	3
64487	435396	11	1	3	4	0	8
64487	435400	11	0	3	0	1	4
64487	435433	11	1	2	0	0	3
64487	435499	11	1	1	0	0	2
64487	435515	11	5	1	0	0	6
64487	435542	11	0	2	0	0	2
64487	435475	10	0	1	0	0	1
64487	435504	10	1	0	0	0	1
64487	300282	9	0	0	0	0	0
64487	435486	9	1	0	0	0	1
64487	435490	9	4	3	2	1	10
64487	435516	9	4	3	0	1	8
64487	435527	9	2	3	0	0	5
64487	91157	9	0	0	0	0	0
64487	435425	8	2	0	0	0	2
64487	435488	8	2	1	0	1	4
64487	435510	8	1	2	1	1	5
64487	435512	8	6	1	0	2	9
64487	435523	8	3	0	0	0	3
64487	435534	8	4	2	0	1	7
64487	435428	7	3	2	0	0	5
64487	435459	7	3	1	0	0	4
64487	435463	7	0	6	1	0	7
64487	435477	7	2	2	1	0	5
64487	435481	7	2	1	0	0	3
64487	435496	7	2	1	0	0	3
64487	435506	7	1	0	0	0	1
64487	435508	7	2	1	0	0	3
64487	435509	7	1	1	0	1	3
64487	435529	7	3	2	0	0	5
64487	435539	7	0	0	0	0	0
64487	183783	6	1	2	0	0	3
64487	193449	6	0	1	0	0	1
64487	218554	6	2	1	0	1	4
64487	300280	6	2	1	0	1	4
64487	435387	6	1	2	0	0	3
64487	435388	6	2	0	0	2	4
64487	435399	6	0	2	0	0	2
64487	435462	6	2	1	0	0	3
64487	435468	6	0	0	0	0	0
64487	435469	6	0	0	0	0	0
64487	435479	6	4	1	1	0	6
64487	435513	6	0	0	0	0	0
64487	435519	6	1	0	0	5	6
64487	435524	6	3	4	2	0	9
64487	435531	6	2	0	0	0	2
64487	435540	6	3	0	0	0	3
64487	94119	6	2	1	0	1	4
64487	183448	5	1	1	0	0	2
64487	188425	5	2	1	0	0	3
64487	204245	5	1	0	0	0	1
64487	205695	5	4	5	0	0	9
64487	300279	5	2	2	0	2	6
64487	435378	5	2	0	0	0	2
64487	435384	5	1	0	0	0	1
64487	435406	5	4	0	2	0	6
64487	435411	5	0	0	0	0	0
64487	435431	5	2	0	0	2	4
64487	435436	5	1	0	0	0	1
64487	435437	5	1	0	0	0	1
64487	435461	5	0	0	0	1	1
64487	435465	5	1	1	0	1	3
64487	435470	5	2	0	0	0	2
64487	435471	5	1	3	1	3	8
64487	435484	5	2	0	0	0	2
64487	435485	5	2	2	0	0	4
64487	435487	5	1	0	1	1	3
64487	435491	5	0	1	0	0	1
64487	435492	5	1	0	0	0	1
64487	435507	5	1	1	0	0	2
64487	435517	5	0	2	0	0	2
64487	435518	5	0	1	0	1	2
64487	435528	5	0	0	0	0	0
64487	435533	5	2	0	0	1	3
64487	209203	4	3	1	0	0	4
64487	300278	4	0	0	0	0	0
64487	435351	4	0	0	0	1	1
64487	435357	4	0	0	0	2	2
64487	435367	4	1	0	0	0	1
64487	435383	4	2	1	0	1	4
64487	435409	4	0	0	0	0	0
64487	435410	4	1	1	0	0	2
64487	435418	4	1	0	0	0	1
64487	435422	4	0	0	0	1	1
64487	435423	4	2	1	0	0	3
64487	435427	4	1	2	0	1	4
64487	435430	4	1	2	0	0	3
64487	435432	4	1	1	0	1	3
64487	435439	4	1	0	0	0	1
64487	435440	4	2	1	0	0	3
64487	435441	4	2	0	0	0	2
64487	435460	4	0	0	0	0	0
64487	435482	4	0	0	0	0	0
64487	435489	4	2	1	0	2	5
64487	435493	4	1	1	0	3	5
64487	435498	4	0	2	0	1	3
64487	435501	4	2	0	0	0	2
64487	435503	4	1	0	0	0	1
64487	435505	4	1	0	0	0	1
64487	435521	4	0	1	0	0	1
64487	435530	4	1	1	0	0	2
64487	435532	4	1	0	0	1	2
64487	435535	4	2	3	0	0	5
64487	71201	4	0	0	0	0	0
64487	74047	4	0	0	0	0	0
64487	188961	3	2	2	0	2	6
64487	207041	3	1	1	0	0	2
64487	210117	3	0	0	0	0	0
64487	212773	3	0	3	0	0	3
64487	300275	3	0	0	0	0	0
64487	300276	3	0	0	0	0	0
64487	300277	3	0	0	0	0	0
64487	300281	3	0	0	0	1	1
64487	435355	3	0	0	0	1	1
64487	435356	3	2	0	0	1	3
64487	435363	3	2	0	0	0	2
64487	435364	3	0	1	0	0	1
64487	435371	3	1	0	0	0	1
64487	435372	3	3	0	0	0	3
64487	435376	3	2	0	0	0	2
64487	435377	3	1	0	0	1	2
64487	435386	3	1	0	0	0	1
64487	435391	3	1	0	0	1	2
64487	435394	3	2	0	0	0	2
64487	435395	3	0	1	0	1	2
64487	435398	3	1	1	1	0	3
64487	435403	3	0	2	0	0	2
64487	435405	3	0	0	0	1	1
64487	435407	3	1	2	0	0	3
64487	435408	3	3	0	0	0	3
64487	435416	3	0	0	0	0	0
64487	435429	3	2	2	0	0	4
64487	435438	3	0	1	0	0	1
64487	435445	3	2	1	0	0	3
64487	435449	3	0	0	0	0	0
64487	435452	3	0	1	0	1	2
64487	435455	3	0	2	0	0	2
64487	435457	3	0	1	1	1	3
64487	435458	3	2	0	0	0	2
64487	435464	3	0	2	2	1	5
64487	435466	3	1	0	0	0	1
64487	435473	3	0	0	1	2	3
64487	435476	3	0	0	0	0	0
64487	435478	3	3	0	0	0	3
64487	435483	3	1	0	0	0	1
64487	435494	3	1	2	0	0	3
64487	435497	3	1	0	0	0	1
64487	435500	3	0	0	0	0	0
64487	435511	3	1	1	0	0	2
64487	435525	3	1	0	0	1	2
64487	435536	3	0	1	0	0	1
64487	56194	3	0	0	0	0	0
64487	189520	2	0	0	0	0	0
64487	195845	2	0	2	0	0	2
64487	196437	2	1	0	0	1	2
64487	203266	2	0	0	0	0	0
64487	211137	2	0	0	0	0	0
64487	435353	2	1	0	0	0	1
64487	435358	2	3	3	0	1	7
64487	435361	2	0	1	0	3	4
64487	435365	2	0	0	0	0	0
64487	435366	2	0	0	0	1	1
64487	435369	2	1	0	0	0	1
64487	435370	2	1	1	0	0	2
64487	435374	2	1	1	0	0	2
64487	435375	2	2	0	0	0	2
64487	435379	2	0	0	0	0	0
64487	435380	2	2	0	0	0	2
64487	435381	2	0	0	0	0	0
64487	435382	2	0	0	0	0	0
64487	435389	2	1	0	0	0	1
64487	435401	2	0	0	0	1	1
64487	435402	2	1	1	0	1	3
64487	435404	2	1	1	0	0	2
64487	435412	2	1	0	0	0	1
64487	435413	2	1	1	0	0	2
64487	435414	2	1	2	0	0	3
64487	435417	2	1	1	0	0	2
64487	435419	2	1	0	0	0	1
64487	435421	2	1	0	0	0	1
64487	435424	2	1	1	0	0	2
64487	435426	2	0	0	0	0	0
64487	435434	2	2	0	1	2	5
64487	435435	2	1	2	0	0	3
64487	435442	2	0	0	0	0	0
64487	435443	2	1	0	0	0	1
64487	435447	2	1	1	0	0	2
64487	435451	2	0	0	0	2	2
64487	435467	2	3	4	0	0	7
64487	435474	2	0	1	0	0	1
64487	435480	2	1	0	0	0	1
64487	435502	2	0	0	0	0	0
64487	435514	2	0	0	0	0	0
64487	435520	2	1	0	0	0	1
64487	435526	2	1	4	0	1	6
64487	435538	2	0	1	0	1	2
64487	435541	2	2	1	0	0	3
64487	191289	1	1	0	0	0	1
64487	208558	1	0	0	0	0	0
64487	209749	1	0	0	0	0	0
64487	435352	1	0	1	0	0	1
64487	435354	1	0	0	0	0	0
64487	435359	1	1	2	0	0	3
64487	435360	1	0	0	0	0	0
64487	435362	1	0	0	0	0	0
64487	435368	1	1	0	0	0	1
64487	435373	1	0	1	0	0	1
64487	435385	1	2	0	0	0	2
64487	435390	1	1	0	0	2	3
64487	435392	1	0	3	0	0	3
64487	435393	1	0	0	0	0	0
64487	435397	1	2	0	0	0	2
64487	435415	1	1	1	0	0	2
64487	435420	1	1	0	0	1	2
64487	435444	1	0	0	0	0	0
64487	435446	1	0	0	0	0	0
64487	435448	1	0	0	0	0	0
64487	435450	1	0	1	0	0	1
64487	435454	1	1	0	0	0	1
64487	435472	1	0	0	0	0	0
64487	435522	1	0	0	0	0	0
64487	435537	1	0	4	0	2	6
53438	610583	13	4	3	0	3	10
53438	610631	13	8	5	0	4	17
53438	297289	10	3	2	0	2	7
53438	610580	10	4	2	0	0	6
53438	610623	10	4	0	0	3	7
53438	610654	10	0	0	0	0	0
53438	610701	10	1	3	0	1	5
53438	214422	9	2	2	0	0	4
53438	610664	9	2	0	0	0	2
53438	610730	9	0	0	0	0	0
53438	186060	8	1	3	0	1	5
53438	297284	8	0	5	2	1	8
53438	610668	8	5	2	0	2	9
53438	610718	8	2	1	0	0	3
53438	198087	7	0	1	0	0	1
53438	610574	7	1	0	0	2	3
53438	610600	7	1	2	0	2	5
53438	610607	7	3	0	0	0	3
53438	610641	7	4	1	0	1	6
53438	610658	7	1	1	0	3	5
53438	610671	7	2	1	0	2	5
53438	610720	7	4	3	0	0	7
53438	610722	7	2	1	0	3	6
53438	610741	7	1	3	0	1	5
53438	183782	6	1	1	0	1	3
53438	297282	6	2	0	0	1	3
53438	610579	6	2	0	0	0	2
53438	610582	6	0	0	0	0	0
53438	610586	6	3	2	0	0	5
53438	610587	6	1	0	0	1	2
53438	610597	6	1	0	0	1	2
53438	610599	6	4	0	0	1	5
53438	610605	6	1	0	0	0	1
53438	610613	6	3	1	0	0	4
53438	610614	6	0	2	1	1	4
53438	610618	6	1	0	0	0	1
53438	610627	6	3	1	0	0	4
53438	610642	6	2	2	0	1	5
53438	610656	6	2	0	1	0	3
53438	610665	6	3	1	0	1	5
53438	610679	6	1	1	0	1	3
53438	610700	6	2	3	0	1	6
53438	610724	6	1	0	0	2	3
53438	610726	6	0	0	0	1	1
53438	214779	5	1	1	0	3	5
53438	214807	5	1	1	0	3	5
53438	218539	5	0	3	0	3	6
53438	281070	5	1	0	1	3	5
53438	297278	5	1	0	0	2	3
53438	297280	5	1	1	0	1	3
53438	297288	5	0	3	0	3	6
53438	297290	5	0	3	0	3	6
53438	610576	5	1	1	0	0	2
53438	610581	5	2	0	0	0	2
53438	610584	5	3	0	0	0	3
53438	610589	5	0	1	0	1	2
53438	610592	5	0	0	0	1	1
53438	610593	5	3	2	0	1	6
53438	610598	5	1	0	2	2	5
53438	610604	5	1	0	0	0	1
53438	610606	5	3	3	0	2	8
53438	610608	5	1	0	0	1	2
53438	610612	5	0	1	0	0	1
53438	610622	5	5	0	0	0	5
53438	610651	5	0	1	0	2	3
53438	610652	5	1	0	0	1	2
53438	610657	5	1	0	0	1	2
53438	610667	5	2	2	0	0	4
53438	610675	5	1	0	0	0	1
53438	610677	5	2	0	0	1	3
53438	610682	5	0	0	0	1	1
53438	610683	5	3	0	0	1	4
53438	610684	5	2	0	0	1	3
53438	610687	5	0	1	0	0	1
53438	610692	5	1	2	0	0	3
53438	610696	5	2	1	0	0	3
53438	610703	5	2	0	0	0	2
53438	610705	5	0	4	0	0	4
53438	610711	5	1	2	0	1	4
53438	610717	5	1	1	0	1	3
53438	610719	5	1	1	0	0	2
53438	182330	4	1	1	0	0	2
53438	185648	4	0	2	0	0	2
53438	196541	4	1	1	0	1	3
53438	207125	4	3	3	0	2	8
53438	297274	4	1	3	1	0	5
53438	297286	4	1	4	0	1	6
53438	297287	4	1	1	0	3	5
53438	297291	4	0	0	2	3	5
53438	610573	4	0	0	0	2	2
53438	610603	4	1	0	0	0	1
53438	610610	4	1	2	0	1	4
53438	610611	4	1	4	0	1	6
53438	610625	4	2	1	0	3	6
53438	610626	4	1	2	0	2	5
53438	610628	4	2	0	0	1	3
53438	610630	4	1	1	0	2	4
53438	610633	4	1	0	0	1	2
53438	610637	4	2	0	0	0	2
53438	610640	4	1	3	0	1	5
53438	610644	4	4	2	0	0	6
53438	610648	4	0	0	0	0	0
53438	610655	4	1	0	0	1	2
53438	610660	4	2	1	0	0	3
53438	610663	4	1	0	0	0	1
53438	610669	4	2	2	0	1	5
53438	610678	4	3	2	0	1	6
53438	610680	4	0	2	0	3	5
53438	610681	4	2	1	0	1	4
53438	610686	4	1	3	0	1	5
53438	610688	4	1	3	0	0	4
53438	610689	4	3	1	0	1	5
53438	610713	4	3	0	0	0	3
53438	610732	4	0	0	0	0	0
53438	610733	4	0	1	0	1	2
53438	610734	4	3	1	0	0	4
53438	610738	4	2	1	0	0	3
53438	610739	4	1	0	0	2	3
53438	610742	4	2	3	0	0	5
53438	610749	4	2	1	0	0	3
53438	188239	3	1	1	0	0	2
53438	192242	3	0	0	0	0	0
53438	196024	3	1	2	0	1	4
53438	198606	3	0	0	0	1	1
53438	200427	3	0	0	0	1	1
53438	204533	3	1	0	0	1	2
53438	205853	3	3	3	0	0	6
53438	218983	3	0	0	0	0	0
53438	297275	3	1	2	0	0	3
53438	297276	3	0	0	1	0	1
53438	297281	3	3	0	0	1	4
53438	297285	3	2	1	0	3	6
53438	610575	3	1	0	0	2	3
53438	610578	3	0	0	0	0	0
53438	610602	3	1	0	0	0	1
53438	610615	3	0	1	0	0	1
53438	610616	3	0	0	0	1	1
53438	610617	3	1	0	0	0	1
53438	610620	3	0	0	0	0	0
53438	610634	3	0	1	0	0	1
53438	610635	3	0	0	0	0	0
53438	610638	3	2	1	0	0	3
53438	610639	3	1	1	0	1	3
53438	610643	3	2	1	0	0	3
53438	610645	3	3	1	0	2	6
53438	610646	3	4	0	0	1	5
53438	610659	3	1	0	0	0	1
53438	610673	3	2	3	0	0	5
53438	610674	3	0	2	0	0	2
53438	610691	3	1	1	0	0	2
53438	610693	3	2	2	0	0	4
53438	610694	3	2	1	0	0	3
53438	610695	3	2	1	0	0	3
53438	610698	3	2	2	0	0	4
53438	610702	3	1	0	0	0	1
53438	610709	3	1	0	0	2	3
53438	610712	3	1	1	0	0	2
53438	610714	3	1	0	0	0	1
53438	610727	3	0	4	0	0	4
53438	610728	3	0	1	0	2	3
53438	610736	3	2	0	0	0	2
53438	610737	3	1	0	2	0	3
53438	610744	3	2	0	0	2	4
53438	610748	3	0	0	0	0	0
53438	184232	2	0	0	1	1	2
53438	199806	2	1	1	0	1	3
53438	201955	2	0	1	0	1	2
53438	203039	2	1	0	0	2	3
53438	205927	2	0	1	0	0	1
53438	215720	2	0	0	0	1	1
53438	281071	2	0	0	0	0	0
53438	297277	2	0	0	0	1	1
53438	297279	2	0	0	0	0	0
53438	610572	2	1	4	0	1	6
53438	610577	2	1	1	0	0	2
53438	610585	2	0	0	0	0	0
53438	610588	2	1	2	0	0	3
53438	610590	2	1	1	0	0	2
53438	610594	2	1	1	0	0	2
53438	610595	2	0	0	0	1	1
53438	610596	2	2	0	0	1	3
53438	610609	2	1	1	0	0	2
53438	610619	2	0	0	0	1	1
53438	610621	2	1	0	0	1	2
53438	610624	2	2	1	0	0	3
53438	610629	2	2	1	0	0	3
53438	610632	2	0	1	0	1	2
53438	610636	2	0	2	0	1	3
53438	610647	2	3	0	0	1	4
53438	610661	2	0	0	0	0	0
53438	610662	2	1	0	0	1	2
53438	610672	2	0	1	0	2	3
53438	610690	2	0	0	0	0	0
53438	610697	2	0	2	0	0	2
53438	610704	2	0	0	0	1	1
53438	610707	2	2	0	0	0	2
53438	610708	2	0	3	0	0	3
53438	610710	2	0	0	0	2	2
53438	610715	2	0	0	0	1	1
53438	610721	2	1	2	0	0	3
53438	610725	2	1	1	0	0	2
53438	610729	2	1	1	0	2	4
53438	610731	2	0	1	0	0	1
53438	610735	2	2	0	0	0	2
53438	610740	2	1	2	0	1	4
53438	610743	2	1	0	0	2	3
53438	610746	2	2	0	0	1	3
53438	610747	2	0	0	0	0	0
53438	186406	1	0	0	0	1	1
53438	186523	1	1	1	0	0	2
53438	191602	1	0	0	0	0	0
53438	193982	1	0	0	0	0	0
53438	208901	1	0	1	0	0	1
53438	297283	1	1	0	0	0	1
53438	610591	1	1	2	0	1	4
53438	610601	1	2	0	0	0	2
53438	610649	1	1	1	0	0	2
53438	610650	1	3	0	0	1	4
53438	610653	1	0	0	0	1	1
53438	610666	1	1	1	0	1	3
53438	610670	1	0	1	0	1	2
53438	610685	1	0	2	0	1	3
53438	610699	1	2	0	0	0	2
53438	610706	1	1	0	0	0	1
53438	610716	1	1	0	0	0	1
53438	610723	1	0	1	0	1	2
53438	610745	1	1	1	0	0	2
66712	69820	47	2	4	2	0	8
66712	92553	38	9	7	2	4	22
66712	491671	34	5	6	0	2	13
66712	491651	33	8	1	1	7	17
66712	69002	33	5	2	0	0	7
66712	52046	29	0	5	2	2	9
66712	103532	23	1	0	2	0	3
66712	72188	20	0	1	0	1	2
66712	491681	19	1	4	3	2	10
66712	69601	19	1	4	3	2	10
66712	105094	18	1	1	0	1	3
66712	300981	16	2	1	0	0	3
66712	491595	16	1	1	0	0	2
66712	97170	16	1	1	0	0	2
66712	97812	16	2	1	0	0	3
66712	71900	15	0	2	3	1	6
66712	106313	14	3	0	0	0	3
66712	219195	14	3	0	0	0	3
66712	80876	14	0	1	0	0	1
66712	491503	11	1	1	1	3	6
66712	66647	11	3	0	1	0	4
66712	86431	11	2	3	2	1	8
66712	491549	10	2	0	1	0	3
66712	491661	10	0	2	0	0	2
66712	72497	10	2	2	1	0	5
66712	491510	9	2	1	1	0	4
66712	491594	9	0	0	0	0	0
66712	491598	9	1	0	0	1	2
66712	491636	9	0	0	0	0	0
66712	491663	9	0	2	0	1	3
66712	491674	9	1	0	1	1	3
66712	491678	9	1	1	0	0	2
66712	300985	8	1	1	0	0	2
66712	491514	8	1	1	0	0	2
66712	491523	8	1	2	1	1	5
66712	491540	8	1	0	0	0	1
66712	491680	8	1	3	1	1	6
66712	70801	8	1	1	0	0	2
66712	98894	8	1	3	0	0	4
66712	300982	7	1	1	0	1	3
66712	491525	7	0	2	0	1	3
66712	491576	7	0	1	0	1	2
66712	491658	7	1	3	1	2	7
66712	491675	7	3	1	0	0	4
66712	50475	7	0	0	0	0	0
66712	71458	7	1	1	0	1	3
66712	92595	7	2	4	0	2	8
66712	103606	6	0	1	0	0	1
66712	188109	6	1	1	0	1	3
66712	221770	6	1	0	0	0	1
66712	491512	6	1	3	0	0	4
66712	491526	6	0	0	0	0	0
66712	491527	6	0	2	0	1	3
66712	491542	6	0	3	0	1	4
66712	491544	6	2	1	0	0	3
66712	491607	6	0	0	0	0	0
66712	491662	6	1	3	0	0	4
66712	491665	6	0	0	0	0	0
66712	491673	6	1	0	0	0	1
66712	67910	6	1	1	0	0	2
66712	199131	5	0	2	0	0	2
66712	491520	5	0	0	0	1	1
66712	491531	5	0	1	0	0	1
66712	491541	5	0	1	0	0	1
66712	491547	5	1	0	1	0	2
66712	491553	5	1	1	0	0	2
66712	491554	5	1	1	0	2	4
66712	491557	5	2	1	0	0	3
66712	491558	5	1	0	0	0	1
66712	491560	5	0	1	0	0	1
66712	491569	5	0	0	0	0	0
66712	491587	5	0	1	1	0	2
66712	491589	5	0	1	0	1	2
66712	491597	5	0	2	0	0	2
66712	491610	5	0	0	0	1	1
66712	491613	5	0	2	0	1	3
66712	491620	5	0	0	1	1	2
66712	491629	5	1	2	0	0	3
66712	491633	5	0	1	0	2	3
66712	491640	5	0	0	3	1	4
66712	491641	5	0	2	0	0	2
66712	491642	5	0	2	0	0	2
66712	491653	5	0	0	2	0	2
66712	491656	5	0	1	0	0	1
66712	491664	5	1	2	0	0	3
66712	491676	5	1	1	0	1	3
66712	491677	5	1	0	0	0	1
66712	92477	5	1	1	0	1	3
66712	193475	4	1	1	0	0	2
66712	491502	4	2	0	0	0	2
66712	491506	4	1	1	0	0	2
66712	491517	4	2	1	0	1	4
66712	491518	4	0	0	0	0	0
66712	491536	4	0	0	0	0	0
66712	491537	4	1	0	0	0	1
66712	491546	4	1	0	0	1	2
66712	491562	4	1	0	0	1	2
66712	491563	4	0	2	0	0	2
66712	491564	4	0	1	0	1	2
66712	491566	4	1	1	0	0	2
66712	491568	4	0	1	0	0	1
66712	491571	4	0	1	0	0	1
66712	491575	4	1	1	0	0	2
66712	491580	4	1	2	0	0	3
66712	491582	4	1	1	0	0	2
66712	491586	4	0	1	0	0	1
66712	491591	4	0	1	0	0	1
66712	491592	4	0	0	1	0	1
66712	491601	4	0	0	0	0	0
66712	491602	4	1	1	0	0	2
66712	491604	4	1	0	0	2	3
66712	491605	4	1	1	0	0	2
66712	491606	4	0	0	0	0	0
66712	491608	4	0	2	1	0	3
66712	491611	4	0	1	0	0	1
66712	491618	4	0	3	0	1	4
66712	491623	4	1	2	0	0	3
66712	491626	4	1	2	2	0	5
66712	491627	4	0	1	0	0	1
66712	491631	4	1	1	1	0	3
66712	491650	4	1	0	0	0	1
66712	491652	4	0	1	0	0	1
66712	491655	4	0	2	0	0	2
66712	491669	4	1	1	0	0	2
66712	491670	4	1	1	0	0	2
66712	50688	4	2	2	0	0	4
66712	55364	4	0	1	0	0	1
66712	87653	4	2	2	0	0	4
66712	183679	3	1	1	0	0	2
66712	191245	3	1	0	0	0	1
66712	221500	3	0	1	0	0	1
66712	491500	3	1	1	0	0	2
66712	491504	3	1	0	0	0	1
66712	491508	3	1	2	0	0	3
66712	491511	3	1	0	0	0	1
66712	491513	3	0	0	0	0	0
66712	491521	3	0	1	0	0	1
66712	491522	3	0	0	0	0	0
66712	491530	3	2	1	0	2	5
66712	491533	3	0	1	0	3	4
66712	491535	3	0	1	0	0	1
66712	491543	3	0	0	0	1	1
66712	491545	3	0	2	0	0	2
66712	491555	3	1	1	0	0	2
66712	491574	3	1	0	0	0	1
66712	491583	3	0	1	0	1	2
66712	491590	3	1	0	1	0	2
66712	491596	3	0	1	0	0	1
66712	491600	3	1	0	0	0	1
66712	491609	3	1	0	0	0	1
66712	491617	3	1	0	0	1	2
66712	491624	3	0	1	0	0	1
66712	491625	3	1	0	0	1	2
66712	491634	3	0	2	2	1	5
66712	491635	3	0	1	0	1	2
66712	491645	3	0	0	0	0	0
66712	491649	3	1	2	0	0	3
66712	491657	3	1	0	0	0	1
66712	491667	3	0	1	0	0	1
66712	491672	3	1	3	2	0	6
66712	491499	2	0	1	0	1	2
66712	491515	2	0	1	1	0	2
66712	491516	2	2	1	0	0	3
66712	491524	2	0	0	0	0	0
66712	491534	2	0	0	0	1	1
66712	491539	2	0	0	0	1	1
66712	491548	2	0	0	0	0	0
66712	491550	2	0	0	0	0	0
66712	491552	2	0	1	0	0	1
66712	491559	2	0	0	0	0	0
66712	491561	2	0	0	0	0	0
66712	491565	2	1	0	0	1	2
66712	491567	2	0	1	0	0	1
66712	491572	2	0	0	0	2	2
66712	491577	2	0	1	0	0	1
66712	491578	2	0	0	0	0	0
66712	491584	2	2	1	0	3	6
66712	491585	2	0	1	0	0	1
66712	491593	2	0	0	0	0	0
66712	491599	2	0	0	0	0	0
66712	491603	2	2	0	0	0	2
66712	491612	2	1	0	0	0	1
66712	491614	2	0	0	0	0	0
66712	491619	2	0	0	0	0	0
66712	491622	2	1	0	0	0	1
66712	491628	2	0	0	0	0	0
66712	491632	2	0	1	0	1	2
66712	491637	2	0	0	0	0	0
66712	491646	2	0	0	0	0	0
66712	491647	2	0	2	0	0	2
66712	491648	2	0	1	1	0	2
66712	491659	2	1	0	0	0	1
66712	491666	2	0	0	0	0	0
66712	491668	2	0	1	0	0	1
66712	491679	2	0	1	1	0	2
66712	92298	2	0	0	0	1	1
66712	491497	1	0	1	0	0	1
66712	491498	1	0	0	0	0	0
66712	491501	1	0	0	0	0	0
66712	491505	1	0	1	1	0	2
66712	491507	1	0	0	0	1	1
66712	491509	1	0	1	0	0	1
66712	491519	1	0	1	0	0	1
66712	491528	1	1	0	0	1	2
66712	491529	1	0	3	0	0	3
66712	491532	1	0	1	0	0	1
66712	491538	1	0	0	0	0	0
66712	491551	1	0	0	0	0	0
66712	491556	1	0	0	0	0	0
66712	491570	1	0	2	0	1	3
66712	491573	1	0	0	0	0	0
66712	491579	1	0	0	0	0	0
66712	491581	1	1	1	0	0	2
66712	491588	1	1	2	0	0	3
66712	491615	1	0	0	0	0	0
66712	491616	1	0	0	0	0	0
66712	491621	1	0	0	0	1	1
66712	491630	1	0	0	0	1	1
66712	491638	1	0	0	0	0	0
66712	491639	1	0	0	0	0	0
66712	491643	1	0	0	0	0	0
66712	491644	1	0	0	0	0	0
66712	491654	1	0	0	0	0	0
66712	491660	1	0	1	1	0	2
60127	102468	80	3	3	0	3	9
60127	51251	57	11	10	1	1	23
60127	463642	50	11	9	1	2	23
60127	50633	48	0	2	0	3	5
60127	187015	45	8	8	1	5	22
60127	57541	45	8	8	1	5	22
60127	463618	41	1	1	0	1	3
60127	183875	32	0	2	0	3	5
60127	104047	31	5	5	0	2	12
60127	463621	31	0	2	0	3	5
60127	93440	30	3	2	0	3	8
60127	102739	27	5	4	0	2	11
60127	298921	27	5	4	0	2	11
60127	463644	27	3	1	0	8	12
60127	463651	27	2	2	0	3	7
60127	85263	27	3	1	0	8	12
60127	104420	25	3	3	0	1	7
60127	185714	25	1	2	2	2	7
60127	463655	25	9	4	0	5	18
60127	298928	24	2	3	0	5	10
60127	463561	24	3	4	0	1	8
60127	463632	24	2	3	0	5	10
60127	463661	24	0	2	0	4	6
60127	91584	24	2	3	0	5	10
60127	96182	24	1	3	0	2	6
60127	463587	23	2	1	0	1	4
60127	182810	22	0	4	1	0	5
60127	222123	22	3	3	1	1	8
60127	108959	21	3	3	1	1	8
60127	210095	21	0	5	0	2	7
60127	298932	21	0	4	1	0	5
60127	463552	21	3	3	1	1	8
60127	463634	21	0	5	0	2	7
60127	49503	21	0	4	1	0	5
60127	93118	21	0	5	0	2	7
60127	463610	20	0	3	0	4	7
60127	463660	20	1	2	0	0	3
60127	59456	20	0	3	0	4	7
60127	70086	20	1	2	0	0	3
60127	89609	20	5	1	0	2	8
60127	463584	19	6	1	0	2	9
60127	463599	19	1	2	1	0	4
60127	106935	18	2	3	0	2	7
60127	463557	18	2	3	0	1	6
60127	463563	18	3	3	1	0	7
60127	463631	18	0	0	1	0	1
60127	463653	18	2	0	0	2	4
60127	108414	17	2	2	0	2	6
60127	187478	17	2	0	0	2	4
60127	198098	17	0	2	1	2	5
60127	220917	17	1	2	0	3	6
60127	463565	17	4	3	0	1	8
60127	463583	17	5	3	0	1	9
60127	463619	17	2	2	0	2	6
60127	463649	17	1	4	0	4	9
60127	57503	17	2	3	0	2	7
60127	58738	17	2	0	0	2	4
60127	72111	17	4	3	0	1	8
60127	73711	17	0	2	1	2	5
60127	78818	17	3	2	0	4	9
60127	88357	17	2	1	0	3	6
60127	88595	17	3	3	0	0	6
60127	90056	17	1	4	0	4	9
60127	106996	16	1	2	0	3	6
60127	107034	16	1	2	0	3	6
60127	298931	16	1	2	0	3	6
60127	463575	16	5	0	0	0	5
60127	463603	16	0	2	1	2	5
60127	463650	16	2	1	0	3	6
60127	210317	15	4	0	0	1	5
60127	463573	15	0	2	0	4	6
60127	463616	15	1	0	0	2	3
60127	463622	15	6	8	1	1	16
60127	463637	15	1	1	1	3	6
60127	189114	14	2	2	0	1	5
60127	206551	14	1	7	0	0	8
60127	215785	14	1	5	1	0	7
60127	216538	14	5	1	0	0	6
60127	463579	14	0	1	0	3	4
60127	463598	14	1	1	0	0	2
60127	463625	14	4	4	1	1	10
60127	463627	14	2	2	0	2	6
60127	70413	14	1	5	1	4	11
60127	82977	14	3	4	0	5	12
60127	94572	14	3	3	0	1	7
60127	298923	13	2	2	0	1	5
60127	463596	13	2	2	0	1	5
60127	463647	13	0	1	0	0	1
60127	463652	13	3	0	1	1	5
60127	61096	13	2	2	0	1	5
60127	78615	13	2	0	0	4	6
60127	78890	13	0	5	0	2	7
60127	183766	12	1	0	0	0	1
60127	184705	12	2	0	0	3	5
60127	207012	12	3	6	0	2	11
60127	207379	12	1	4	0	0	5
60127	298929	12	2	0	0	3	5
60127	463550	12	3	1	1	0	5
60127	463556	12	0	0	0	1	1
60127	463578	12	0	5	0	1	6
60127	463626	12	3	2	0	1	6
60127	463633	12	0	1	0	1	2
60127	463639	12	0	0	0	1	1
60127	463648	12	1	4	0	0	5
60127	54305	12	2	0	0	3	5
60127	74248	12	0	1	0	1	2
60127	86745	12	1	4	0	0	5
60127	193291	11	2	0	0	2	4
60127	463570	11	4	1	0	0	5
60127	463586	11	1	0	0	0	1
60127	463595	11	2	2	0	3	7
60127	463608	11	3	4	1	5	13
60127	463612	11	4	1	0	0	5
60127	463615	11	3	1	0	0	4
60127	463630	11	3	0	1	5	9
60127	463643	11	2	0	0	2	4
60127	463646	11	2	2	0	5	9
60127	67175	11	2	0	0	2	4
60127	82078	11	1	2	0	0	3
60127	85563	11	2	1	0	1	4
60127	204136	10	2	1	0	3	6
60127	298927	10	2	2	0	3	7
60127	463566	10	3	3	0	2	8
60127	463571	10	1	1	0	1	3
60127	463574	10	2	0	1	2	5
60127	463582	10	2	4	0	0	6
60127	463594	10	2	0	0	2	4
60127	463604	10	4	3	0	0	7
60127	463605	10	3	1	0	1	5
60127	463606	10	1	0	0	0	1
60127	463609	10	2	1	1	2	6
60127	463635	10	2	0	0	3	5
60127	463658	10	0	0	0	1	1
60127	183975	9	2	3	0	3	8
60127	463555	9	3	2	0	2	7
60127	463564	9	2	3	0	2	7
60127	463569	9	4	2	0	0	6
60127	463572	9	0	1	0	2	3
60127	463580	9	1	1	0	3	5
60127	463593	9	1	3	0	1	5
60127	463620	9	2	3	0	0	5
60127	463638	9	2	3	0	1	6
60127	463656	9	2	2	0	1	5
60127	59006	9	2	2	0	1	5
60127	64852	9	2	7	2	2	13
60127	84493	9	2	1	0	3	6
60127	208405	8	4	0	1	2	7
60127	298924	8	1	3	0	3	7
60127	298925	8	0	1	0	0	1
60127	298930	8	2	1	0	3	6
60127	463551	8	2	2	1	1	6
60127	463553	8	4	3	1	2	10
60127	463560	8	2	2	0	0	4
60127	463562	8	1	0	0	0	1
60127	463567	8	1	0	0	0	1
60127	463576	8	4	4	2	1	11
60127	463577	8	1	1	0	0	2
60127	463614	8	1	0	0	0	1
60127	463624	8	1	3	0	3	7
60127	463628	8	2	3	0	0	5
60127	463640	8	3	0	0	0	3
60127	463641	8	1	1	0	2	4
60127	463657	8	1	1	0	0	2
60127	66845	8	1	4	0	4	9
60127	92587	8	1	3	0	3	7
60127	200443	7	1	3	0	2	6
60127	207552	7	1	1	0	1	3
60127	213566	7	0	1	0	0	1
60127	298933	7	2	5	0	1	8
60127	463559	7	2	4	0	2	8
60127	463581	7	1	0	1	2	4
60127	463600	7	0	1	0	2	3
60127	463602	7	1	3	0	0	4
60127	463607	7	0	1	0	2	3
60127	463636	7	1	1	0	0	2
60127	463659	7	4	0	1	2	7
60127	463662	7	2	5	0	1	8
60127	79591	7	2	5	0	1	8
60127	92145	7	4	0	1	2	7
60127	92614	7	1	2	0	1	4
60127	107911	6	0	6	0	1	7
60127	198691	6	4	1	0	3	8
60127	298922	6	0	6	0	1	7
60127	298926	6	2	2	0	3	7
60127	463546	6	2	1	0	1	4
60127	463554	6	2	2	1	3	8
60127	463558	6	0	0	2	0	2
60127	463568	6	0	0	0	0	0
60127	463591	6	5	4	0	0	9
60127	463592	6	1	3	1	1	6
60127	463611	6	3	0	0	1	4
60127	463613	6	1	1	0	1	3
60127	463645	6	1	0	0	0	1
60127	463654	6	0	6	0	1	7
60127	75618	6	2	2	0	3	7
60127	298935	5	1	1	0	0	2
60127	463548	5	3	0	0	1	4
60127	463585	5	1	1	1	0	3
60127	463589	5	1	3	0	0	4
60127	463590	5	1	0	0	1	2
60127	463597	5	0	3	0	1	4
60127	463617	5	4	1	0	3	8
60127	463623	5	0	3	0	1	4
60127	463629	5	0	1	0	2	3
60127	74657	5	4	1	0	3	8
60127	94066	5	1	1	0	0	2
60127	298934	4	2	1	0	1	4
60127	463664	4	1	2	0	0	3
60127	59170	4	2	1	0	0	3
60127	60852	4	2	1	0	1	4
60127	463545	3	0	1	0	0	1
60127	463588	3	0	2	0	0	2
60127	183681	2	0	0	0	0	0
60127	463547	2	0	0	0	0	0
60127	463549	2	1	0	0	1	2
60127	463663	2	0	0	0	0	0
60127	190226	1	0	0	0	0	0
60127	202117	1	0	0	0	0	0
60127	208742	1	0	0	0	0	0
60127	211138	1	0	0	0	0	0
60127	463601	1	0	0	1	0	1
69539	490015	47	3	5	0	3	11
69539	83239	47	3	5	0	3	11
69539	210658	42	2	7	3	7	19
69539	490029	42	2	7	3	7	19
69539	96647	31	1	2	0	2	5
69539	103016	29	1	0	0	0	1
69539	274480	29	1	0	0	0	1
69539	220862	18	1	0	0	3	4
69539	220533	17	0	0	0	2	2
69539	274483	17	2	2	2	3	9
69539	274503	17	2	1	1	2	6
69539	490028	17	2	2	2	3	9
69539	97820	17	2	2	2	3	9
69539	91882	16	4	3	0	1	8
69539	188897	14	1	2	1	2	6
69539	490027	14	3	3	1	2	9
69539	197125	13	1	2	0	1	4
69539	274504	13	1	2	1	2	6
69539	490036	13	1	1	0	0	2
69539	59972	13	1	2	1	2	6
69539	104222	12	3	4	2	1	10
69539	211244	12	2	3	2	0	7
69539	217046	12	3	4	2	1	10
69539	221577	12	0	1	0	1	2
69539	274491	12	3	4	2	1	10
69539	490067	12	2	1	0	2	5
69539	490089	12	1	1	0	3	5
69539	274486	11	4	2	0	3	9
69539	490092	11	2	1	0	1	4
69539	53919	11	4	2	0	3	9
69539	101225	10	3	1	1	0	5
69539	274490	10	1	2	0	4	7
69539	274505	10	3	1	1	0	5
69539	274506	9	1	1	0	2	4
69539	490043	9	0	1	0	1	2
69539	490086	9	1	3	0	3	7
69539	78569	9	2	1	0	1	4
69539	186140	8	4	2	0	1	7
69539	199716	8	1	2	1	3	7
69539	200223	8	2	3	0	1	6
69539	203658	8	0	3	1	1	5
69539	490044	8	0	0	0	0	0
69539	200564	7	0	0	0	0	0
69539	208931	7	0	0	0	0	0
69539	274477	7	2	1	0	4	7
69539	274484	7	0	2	0	1	3
69539	274489	7	4	2	0	1	7
69539	274496	7	3	1	0	3	7
69539	485261	7	2	2	0	0	4
69539	485262	7	2	1	0	2	5
69539	490039	7	0	1	0	1	2
69539	490076	7	0	0	0	0	0
69539	91979	7	3	1	0	3	7
69539	98022	7	2	1	0	4	7
69539	207538	6	3	1	0	1	5
69539	211091	6	1	2	0	0	3
69539	216810	6	2	4	0	1	7
69539	216821	6	1	2	0	3	6
69539	274495	6	0	2	0	1	3
69539	490020	6	0	4	0	2	6
69539	490022	6	0	0	0	1	1
69539	490040	6	0	2	0	1	3
69539	490048	6	2	3	0	1	6
69539	490070	6	2	1	0	2	5
69539	490077	6	0	2	0	1	3
69539	490078	6	1	2	0	1	4
69539	102239	5	2	0	0	4	6
69539	107385	5	4	1	0	0	5
69539	108032	5	1	1	0	1	3
69539	189924	5	2	0	0	0	2
69539	194829	5	2	1	1	1	5
69539	204822	5	1	1	0	2	4
69539	207715	5	0	1	0	0	1
69539	210445	5	0	0	0	0	0
69539	210797	5	1	3	0	1	5
69539	214782	5	2	0	0	4	6
69539	218618	5	2	2	0	2	6
69539	274475	5	1	1	0	1	3
69539	274485	5	0	3	0	0	3
69539	274488	5	4	2	0	1	7
69539	274492	5	0	3	0	1	4
69539	274493	5	2	0	0	4	6
69539	274501	5	2	1	0	1	4
69539	490012	5	0	4	0	0	4
69539	490019	5	4	2	0	0	6
69539	490033	5	3	0	0	2	5
69539	490051	5	1	0	0	1	2
69539	490054	5	0	0	0	0	0
69539	490063	5	0	0	0	0	0
69539	490071	5	1	0	0	0	1
69539	490080	5	2	2	1	0	5
69539	490082	5	0	2	0	0	2
69539	490083	5	1	2	1	1	5
69539	490088	5	2	3	0	1	6
69539	490091	5	0	1	0	1	2
69539	55533	5	1	3	0	1	5
69539	59082	5	0	3	0	1	4
69539	91236	5	4	2	0	1	7
69539	101935	4	2	0	0	1	3
69539	188259	4	1	1	0	1	3
69539	189629	4	2	2	0	0	4
69539	190023	4	1	0	0	2	3
69539	202687	4	0	4	0	0	4
69539	203065	4	0	0	0	2	2
69539	204465	4	1	1	0	0	2
69539	205494	4	0	1	0	1	2
69539	205719	4	0	2	0	0	2
69539	208781	4	2	1	0	0	3
69539	210072	4	1	2	2	0	5
69539	211682	4	0	2	0	0	2
69539	211897	4	3	2	0	0	5
69539	211997	4	1	2	0	1	4
69539	214127	4	1	0	0	0	1
69539	215118	4	1	0	0	0	1
69539	215777	4	0	3	0	0	3
69539	216713	4	1	0	0	0	1
69539	217207	4	1	1	0	0	2
69539	220263	4	0	1	0	2	3
69539	274478	4	0	2	0	0	2
69539	274479	4	2	0	0	1	3
69539	274502	4	2	5	0	2	9
69539	485258	4	2	1	0	1	4
69539	485259	4	2	3	1	4	10
69539	490010	4	1	3	1	2	7
69539	490011	4	1	3	1	2	7
69539	490016	4	1	2	0	2	5
69539	490018	4	2	1	0	1	4
69539	490024	4	0	4	0	2	6
69539	490030	4	0	0	0	2	2
69539	490041	4	5	1	0	0	6
69539	490042	4	2	1	0	1	4
69539	490045	4	0	0	0	1	1
69539	490046	4	1	0	0	1	2
69539	490052	4	3	1	0	2	6
69539	490057	4	1	1	0	1	3
69539	490060	4	0	1	0	0	1
69539	490062	4	2	1	0	0	3
69539	490065	4	2	1	0	2	5
69539	490066	4	1	1	0	0	2
69539	490068	4	1	1	0	0	2
69539	490079	4	2	0	0	1	3
69539	490081	4	0	2	0	1	3
69539	490084	4	2	5	0	2	9
69539	490087	4	2	2	0	0	4
69539	52589	4	2	5	0	2	9
69539	70847	4	0	2	0	0	2
69539	195611	3	1	3	0	1	5
69539	195804	3	2	0	0	0	2
69539	207437	3	0	0	0	0	0
69539	211219	3	1	1	0	0	2
69539	211889	3	0	0	0	0	0
69539	216925	3	0	1	0	0	1
69539	218647	3	0	0	0	1	1
69539	220359	3	2	0	0	0	2
69539	274476	3	0	0	0	0	0
69539	274481	3	1	0	0	1	2
69539	274482	3	1	1	0	0	2
69539	274494	3	0	1	0	1	2
69539	274499	3	1	0	0	1	2
69539	274500	3	0	1	0	1	2
69539	485260	3	1	0	0	1	2
69539	490023	3	0	3	0	1	4
69539	490026	3	1	2	0	2	5
69539	490035	3	0	0	1	0	1
69539	490049	3	0	2	0	1	3
69539	490055	3	0	1	0	0	1
69539	490056	3	0	0	0	1	1
69539	490058	3	2	2	0	0	4
69539	490059	3	1	0	0	0	1
69539	490064	3	1	0	0	0	1
69539	490072	3	0	0	0	0	0
69539	490090	3	0	1	0	1	2
69539	51157	3	1	0	0	1	2
69539	71070	3	1	0	0	1	2
69539	79245	3	1	1	0	0	2
69539	84119	3	1	2	2	0	5
69539	90283	3	0	1	0	1	2
69539	103292	2	1	0	0	0	1
69539	184971	2	0	0	0	1	1
69539	185606	2	0	0	0	0	0
69539	192831	2	0	1	0	1	2
69539	196448	2	2	0	0	0	2
69539	200079	2	0	0	0	0	0
69539	203833	2	0	1	0	0	1
69539	204896	2	0	0	0	0	0
69539	206790	2	3	1	0	0	4
69539	211686	2	0	0	0	0	0
69539	215990	2	0	0	0	0	0
69539	218503	2	0	1	0	0	1
69539	218613	2	0	0	0	1	1
69539	274497	2	0	1	0	0	1
69539	274498	2	1	0	0	0	1
69539	490013	2	0	0	0	0	0
69539	490014	2	0	0	0	0	0
69539	490017	2	2	0	0	0	2
69539	490021	2	1	0	0	0	1
69539	490025	2	0	1	0	1	2
69539	490031	2	1	0	0	0	1
69539	490032	2	0	1	0	3	4
69539	490034	2	3	1	0	1	5
69539	490037	2	1	0	0	0	1
69539	490038	2	1	1	0	0	2
69539	490047	2	0	1	0	0	1
69539	490061	2	1	0	0	0	1
69539	490069	2	1	0	0	0	1
69539	490074	2	2	1	0	0	3
69539	490085	2	0	0	0	0	0
69539	56846	2	1	1	0	3	5
69539	94180	2	0	1	0	0	1
69539	189634	1	0	2	0	0	2
69539	193083	1	0	2	0	1	3
69539	203943	1	1	0	0	0	1
69539	207436	1	0	1	0	0	1
69539	274487	1	0	0	0	0	0
69539	490009	1	0	0	0	1	1
69539	490050	1	1	0	0	0	1
69539	490053	1	2	1	0	0	3
69539	490073	1	4	2	0	0	6
69539	490075	1	0	0	0	2	2
61515	78686	26	6	4	1	4	15
61515	488994	19	2	0	0	0	2
61515	489058	19	4	4	0	1	9
61515	99524	19	1	1	0	0	2
61515	96193	18	1	5	0	0	6
61515	489016	17	2	2	1	1	6
61515	489014	16	1	0	0	0	1
61515	489039	15	1	1	0	3	5
61515	489054	14	1	1	0	0	2
61515	489043	13	2	1	0	0	3
61515	489046	13	1	1	1	1	4
61515	489084	13	3	4	1	3	11
61515	489027	12	2	2	0	1	5
61515	489082	12	2	0	0	2	4
61515	216979	11	0	3	0	2	5
61515	277560	11	0	3	0	2	5
61515	489020	11	2	0	0	0	2
61515	489049	11	0	2	0	1	3
61515	489051	11	0	3	0	2	5
61515	185248	10	1	1	0	0	2
61515	489006	10	2	3	0	0	5
61515	489036	10	2	4	0	2	8
61515	489085	10	0	0	0	1	1
61515	489086	10	1	1	0	0	2
61515	184633	9	3	1	0	0	4
61515	198184	9	1	1	0	2	4
61515	489021	9	0	1	0	1	2
61515	489022	9	1	2	0	1	4
61515	489040	9	0	1	0	0	1
61515	489078	9	2	2	0	0	4
61515	489116	9	1	2	0	0	3
61515	195680	8	1	0	0	1	2
61515	218066	8	1	3	0	0	4
61515	299407	8	1	1	0	0	2
61515	489047	8	2	2	0	0	4
61515	489060	8	1	1	0	0	2
61515	489096	8	2	0	0	0	2
61515	205417	7	3	0	0	1	4
61515	206374	7	1	3	0	0	4
61515	299409	7	1	0	0	0	1
61515	488982	7	1	1	0	0	2
61515	488988	7	0	1	0	0	1
61515	488995	7	1	0	0	0	1
61515	489012	7	1	2	1	1	5
61515	489029	7	0	1	0	0	1
61515	489033	7	3	3	0	0	6
61515	489103	7	3	0	2	0	5
61515	489115	7	1	2	0	0	3
61515	56399	7	1	0	0	0	1
61515	214298	6	1	1	0	4	6
61515	299402	6	1	1	0	0	2
61515	488998	6	1	3	0	4	8
61515	489007	6	2	2	0	0	4
61515	489008	6	1	0	0	0	1
61515	489018	6	4	5	0	2	11
61515	489026	6	0	0	0	3	3
61515	489032	6	2	0	0	1	3
61515	489044	6	0	0	0	0	0
61515	489066	6	0	0	0	1	1
61515	489067	6	1	0	0	0	1
61515	489071	6	2	0	0	0	2
61515	489076	6	2	2	1	0	5
61515	489080	6	1	3	0	1	5
61515	489083	6	1	1	0	0	2
61515	489090	6	0	0	0	1	1
61515	489093	6	1	0	0	0	1
61515	489094	6	2	1	0	0	3
61515	489097	6	0	0	0	0	0
61515	489098	6	1	2	0	0	3
61515	489105	6	2	0	0	0	2
61515	489106	6	0	0	0	2	2
61515	188312	5	0	0	0	1	1
61515	208145	5	0	0	0	1	1
61515	208926	5	0	0	0	0	0
61515	488981	5	0	0	0	0	0
61515	488991	5	2	0	0	0	2
61515	489003	5	0	2	0	0	2
61515	489004	5	1	1	0	0	2
61515	489009	5	2	2	0	0	4
61515	489013	5	1	3	0	3	7
61515	489019	5	1	1	0	0	2
61515	489025	5	2	3	0	1	6
61515	489028	5	0	1	0	0	1
61515	489057	5	0	2	0	0	2
61515	489074	5	0	0	0	0	0
61515	489075	5	0	0	0	1	1
61515	489077	5	1	1	0	0	2
61515	489088	5	0	0	0	0	0
61515	489089	5	2	0	1	0	3
61515	489095	5	2	1	0	0	3
61515	185630	4	1	1	0	0	2
61515	187226	4	1	0	0	1	2
61515	201954	4	2	0	0	1	3
61515	208866	4	0	2	0	0	2
61515	218534	4	1	1	0	0	2
61515	277561	4	1	1	0	0	2
61515	299406	4	0	0	1	0	1
61515	299408	4	1	1	0	1	3
61515	488975	4	0	3	0	0	3
61515	488979	4	1	0	0	0	1
61515	488987	4	1	1	0	0	2
61515	488993	4	0	0	0	0	0
61515	488997	4	1	0	0	1	2
61515	488999	4	1	3	0	0	4
61515	489005	4	0	0	0	1	1
61515	489010	4	3	0	0	0	3
61515	489015	4	0	1	0	0	1
61515	489030	4	0	1	0	1	2
61515	489037	4	1	0	0	0	1
61515	489055	4	0	5	0	0	5
61515	489063	4	0	1	0	0	1
61515	489065	4	2	1	0	1	4
61515	489068	4	0	0	0	0	0
61515	489069	4	1	1	0	2	4
61515	489073	4	2	3	0	0	5
61515	489081	4	1	1	0	0	2
61515	489099	4	1	0	0	1	2
61515	489101	4	1	0	0	1	2
61515	489104	4	0	2	0	0	2
61515	489107	4	0	1	0	0	1
61515	489109	4	3	2	0	0	5
61515	489118	4	0	1	0	0	1
61515	489119	4	1	1	0	0	2
61515	489120	4	2	2	0	0	4
61515	489125	4	0	2	0	0	2
61515	59388	4	0	0	1	0	1
61515	182716	3	1	0	0	0	1
61515	192347	3	1	1	1	0	3
61515	194343	3	0	0	0	0	0
61515	202950	3	1	0	0	0	1
61515	204274	3	1	1	0	2	4
61515	205362	3	0	2	0	0	2
61515	207106	3	0	1	0	0	1
61515	217168	3	0	3	0	0	3
61515	277562	3	0	0	0	0	0
61515	299405	3	1	0	0	0	1
61515	488976	3	1	0	0	0	1
61515	488978	3	1	3	0	0	4
61515	488984	3	0	3	0	2	5
61515	488985	3	4	0	0	0	4
61515	489000	3	1	0	0	0	1
61515	489002	3	0	1	0	0	1
61515	489011	3	0	1	0	0	1
61515	489017	3	0	0	0	0	0
61515	489023	3	0	1	0	1	2
61515	489031	3	1	1	0	0	2
61515	489038	3	1	0	0	0	1
61515	489052	3	2	0	0	0	2
61515	489053	3	0	0	0	0	0
61515	489056	3	1	4	0	1	6
61515	489064	3	0	2	0	3	5
61515	489091	3	1	0	0	0	1
61515	489092	3	1	0	0	0	1
61515	489100	3	0	0	0	3	3
61515	489108	3	1	0	0	0	1
61515	489117	3	1	0	0	0	1
61515	489122	3	1	0	0	0	1
61515	489123	3	1	0	0	0	1
61515	489126	3	0	0	0	0	0
61515	185468	2	0	0	0	0	0
61515	193185	2	1	0	0	0	1
61515	195727	2	1	0	0	0	1
61515	207332	2	1	1	0	0	2
61515	208902	2	1	1	0	0	2
61515	216543	2	0	0	0	0	0
61515	277559	2	3	0	0	0	3
61515	277563	2	0	1	0	0	1
61515	299401	2	1	1	0	0	2
61515	299403	2	3	0	0	0	3
61515	299404	2	0	0	0	0	0
61515	488977	2	1	2	0	0	3
61515	488980	2	0	0	0	0	0
61515	488983	2	1	0	0	0	1
61515	488989	2	0	1	0	0	1
61515	488990	2	0	0	0	0	0
61515	489001	2	0	2	0	0	2
61515	489024	2	1	1	0	0	2
61515	489034	2	4	0	0	0	4
61515	489035	2	1	4	0	0	5
61515	489041	2	1	1	0	0	2
61515	489050	2	1	0	0	0	1
61515	489059	2	5	1	0	0	6
61515	489061	2	0	3	0	0	3
61515	489062	2	0	1	0	0	1
61515	489072	2	0	0	0	0	0
61515	489079	2	0	0	0	0	0
61515	489110	2	0	1	0	0	1
61515	489111	2	1	0	0	0	1
61515	489113	2	1	2	0	0	3
61515	489114	2	1	1	0	0	2
61515	489121	2	0	0	0	0	0
61515	489124	2	1	0	0	0	1
61515	79226	2	0	0	0	0	0
61515	84497	2	1	1	0	0	2
61515	87842	2	3	0	0	0	3
61515	187118	1	1	0	0	1	2
61515	187211	1	0	1	0	0	1
61515	187891	1	0	0	0	1	1
61515	189802	1	0	0	0	0	0
61515	195628	1	0	0	0	1	1
61515	201307	1	0	0	0	0	0
61515	203171	1	0	1	0	0	1
61515	207602	1	0	1	0	0	1
61515	210321	1	0	1	0	0	1
61515	210369	1	1	2	0	5	8
61515	211188	1	0	0	0	0	0
61515	211685	1	0	0	0	0	0
61515	214062	1	2	1	0	0	3
61515	220375	1	1	0	0	0	1
61515	488974	1	2	0	0	1	3
61515	488986	1	1	0	0	0	1
61515	488992	1	0	0	0	0	0
61515	488996	1	1	2	0	0	3
61515	489042	1	1	1	0	2	4
61515	489045	1	0	1	0	0	1
61515	489048	1	0	0	0	0	0
61515	489070	1	2	0	0	0	2
61515	489087	1	0	0	0	1	1
61515	489102	1	0	0	0	0	0
61515	489112	1	4	0	0	0	4
8884	199031	89	7	9	4	5	25
8884	275833	89	7	9	4	5	25
8884	389378	49	4	1	1	4	10
8884	540046	37	4	1	0	9	14
8884	540057	28	3	4	1	0	8
8884	275850	24	3	7	0	4	14
8884	212146	21	5	5	0	2	12
8884	389384	21	5	5	0	2	12
8884	540068	21	5	5	0	2	12
8884	184672	19	1	2	0	5	8
8884	213649	18	2	3	1	2	8
8884	540069	18	0	1	1	5	7
8884	540098	18	1	1	1	1	4
8884	275816	16	1	3	0	2	6
8884	540082	16	1	3	2	5	11
8884	540092	16	3	4	0	0	7
8884	275820	15	1	0	0	0	1
8884	275822	15	1	0	0	2	3
8884	275841	15	3	4	0	2	9
8884	275838	14	1	0	0	5	6
8884	275842	13	2	2	0	2	6
8884	540052	13	2	2	2	2	8
8884	188346	12	0	2	1	0	3
8884	195390	12	4	0	0	2	6
8884	275849	12	2	1	0	2	5
8884	193825	11	3	7	0	1	11
8884	275844	11	3	7	0	2	12
8884	275856	11	2	2	0	2	6
8884	182451	10	1	0	1	0	2
8884	211515	10	2	2	1	0	5
8884	220014	10	0	3	0	0	3
8884	275817	10	3	0	0	1	4
8884	389380	10	0	0	0	1	1
8884	389382	10	3	0	0	1	4
8884	540047	10	4	2	1	0	7
8884	540066	10	1	1	0	0	2
8884	214283	9	2	1	0	0	3
8884	275832	9	0	2	1	5	8
8884	275840	9	1	3	0	2	6
8884	275846	9	3	3	1	4	11
8884	540053	9	0	0	0	0	0
8884	183374	8	0	2	0	4	6
8884	192220	8	1	0	0	0	1
8884	275851	8	2	3	0	1	6
8884	275855	8	2	1	0	3	6
8884	540056	8	1	1	0	2	4
8884	540073	8	0	0	1	5	6
8884	540086	8	3	5	1	5	14
8884	540093	8	2	3	0	1	6
8884	540107	8	2	0	0	0	2
8884	540108	8	1	1	1	2	5
8884	540110	8	1	1	1	2	5
8884	188143	7	1	2	0	1	4
8884	189893	7	2	1	0	0	3
8884	210918	7	0	3	1	1	5
8884	221842	7	1	0	0	2	3
8884	275836	7	1	2	0	0	3
8884	275847	7	1	1	0	3	5
8884	275853	7	0	2	0	2	4
8884	389383	7	1	0	0	0	1
8884	540088	7	2	2	0	1	5
8884	184979	6	0	2	0	2	4
8884	187137	6	0	0	2	1	3
8884	191678	6	1	1	0	2	4
8884	195994	6	3	1	0	1	5
8884	196285	6	1	0	0	0	1
8884	205421	6	0	2	0	2	4
8884	207735	6	2	0	0	4	6
8884	214467	6	1	0	0	0	1
8884	275824	6	0	0	0	1	1
8884	275825	6	2	1	0	1	4
8884	275831	6	0	0	0	2	2
8884	540061	6	1	2	1	3	7
8884	540067	6	2	1	0	2	5
8884	540077	6	3	1	0	3	7
8884	540087	6	4	2	0	4	10
8884	540091	6	2	1	0	1	4
8884	540097	6	2	1	1	0	4
8884	540103	6	0	0	0	0	0
8884	540105	6	0	2	0	2	4
8884	540117	6	0	0	0	4	4
8884	186728	5	3	1	0	2	6
8884	191096	5	1	2	0	1	4
8884	192978	5	0	1	0	0	1
8884	194285	5	0	2	0	2	4
8884	205803	5	0	1	0	0	1
8884	206943	5	1	2	0	1	4
8884	207704	5	1	0	0	2	3
8884	210015	5	1	0	0	0	1
8884	275828	5	0	1	0	1	2
8884	275830	5	0	0	0	2	2
8884	275857	5	1	0	0	0	1
8884	540042	5	0	1	0	0	1
8884	540043	5	1	0	0	0	1
8884	540050	5	2	0	0	1	3
8884	540058	5	1	2	0	1	4
8884	540063	5	2	2	0	1	5
8884	540076	5	1	0	0	0	1
8884	540081	5	0	1	0	0	1
8884	540099	5	1	0	3	1	5
8884	540100	5	1	3	0	1	5
8884	540112	5	1	1	0	2	4
8884	540114	5	0	0	0	1	1
8884	185446	4	0	1	0	3	4
8884	190653	4	0	3	0	0	3
8884	190654	4	0	0	0	1	1
8884	193062	4	1	0	0	0	1
8884	193582	4	2	1	0	2	5
8884	196871	4	1	1	0	0	2
8884	201595	4	0	1	0	2	3
8884	203438	4	0	1	0	2	3
8884	207736	4	0	0	0	1	1
8884	208146	4	2	0	0	2	4
8884	209557	4	1	0	0	2	3
8884	210326	4	2	2	0	1	5
8884	213009	4	0	1	0	1	2
8884	219995	4	2	0	0	1	3
8884	275839	4	2	1	1	0	4
8884	275845	4	0	3	0	1	4
8884	275848	4	1	0	0	0	1
8884	275852	4	1	0	0	0	1
8884	275860	4	0	0	0	0	0
8884	389376	4	1	0	0	0	1
8884	389377	4	0	0	0	1	1
8884	540045	4	0	1	0	1	2
8884	540049	4	0	1	0	0	1
8884	540062	4	1	0	0	2	3
8884	540070	4	3	2	1	2	8
8884	540078	4	0	1	0	1	2
8884	540080	4	2	2	1	1	6
8884	540089	4	2	3	2	4	11
8884	540090	4	0	0	0	0	0
8884	540094	4	0	1	0	0	1
8884	540101	4	3	5	0	2	10
8884	540102	4	1	0	0	1	2
8884	540106	4	1	1	0	1	3
8884	540111	4	0	1	0	2	3
8884	185610	3	0	0	0	2	2
8884	185720	3	0	1	1	1	3
8884	187488	3	0	0	0	1	1
8884	192772	3	0	0	0	0	0
8884	194912	3	0	2	0	1	3
8884	198095	3	1	0	0	1	2
8884	199950	3	1	0	0	1	2
8884	202104	3	1	3	0	1	5
8884	202663	3	0	0	0	1	1
8884	202975	3	0	1	1	1	3
8884	203638	3	0	2	1	0	3
8884	204805	3	0	0	0	2	2
8884	204859	3	0	0	0	0	0
8884	206395	3	2	0	0	0	2
8884	207053	3	1	0	0	0	1
8884	207500	3	2	1	0	1	4
8884	210747	3	0	0	0	0	0
8884	211723	3	0	0	0	0	0
8884	214306	3	0	0	0	2	2
8884	216186	3	1	1	0	1	3
8884	275821	3	0	2	0	1	3
8884	275823	3	1	0	0	0	1
8884	275826	3	0	0	0	0	0
8884	275827	3	1	3	0	1	5
8884	275834	3	1	1	0	1	3
8884	275835	3	0	0	0	3	3
8884	275837	3	0	0	0	4	4
8884	275843	3	1	2	0	0	3
8884	275854	3	1	0	0	0	1
8884	275858	3	1	0	0	0	1
8884	275859	3	1	1	0	1	3
8884	389381	3	4	0	1	0	5
8884	540041	3	2	0	0	1	3
8884	540048	3	0	2	1	2	5
8884	540051	3	1	1	0	1	3
8884	540054	3	1	1	0	2	4
8884	540055	3	0	0	0	0	0
8884	540064	3	0	0	0	2	2
8884	540071	3	0	1	0	2	3
8884	540072	3	0	1	0	0	1
8884	540074	3	1	0	0	0	1
8884	540083	3	1	0	0	0	1
8884	540085	3	0	2	0	3	5
8884	540095	3	1	0	0	1	2
8884	540113	3	0	1	1	0	2
8884	203986	2	0	3	0	2	5
8884	207058	2	0	1	0	0	1
8884	207218	2	0	0	0	2	2
8884	209607	2	0	1	0	0	1
8884	213899	2	0	0	0	1	1
8884	215414	2	0	1	0	0	1
8884	218688	2	0	0	0	1	1
8884	218964	2	0	2	0	2	4
8884	219789	2	0	0	0	2	2
8884	540044	2	0	1	0	0	1
8884	540059	2	0	0	0	0	0
8884	540075	2	0	2	0	1	3
8884	540079	2	0	0	0	0	0
8884	540084	2	0	0	0	0	0
8884	540096	2	1	2	0	0	3
8884	540104	2	0	0	0	0	0
8884	540109	2	0	0	0	0	0
8884	540115	2	3	2	0	2	7
8884	187051	1	1	1	0	0	2
8884	190050	1	0	0	0	1	1
8884	201217	1	0	2	0	1	3
8884	206234	1	0	0	0	1	1
8884	207597	1	0	0	0	0	0
8884	207821	1	1	1	0	2	4
8884	210471	1	0	0	0	0	0
8884	212745	1	2	0	0	0	2
8884	217308	1	0	0	0	0	0
8884	275819	1	0	0	0	1	1
8884	275829	1	1	0	0	1	2
8884	389379	1	0	0	0	1	1
8884	540060	1	1	2	0	1	4
8884	540065	1	0	0	0	1	1
8884	540116	1	0	1	0	1	2
8884	540118	1	0	2	0	5	7
61519	78687	42	11	7	2	5	25
61519	95663	27	4	7	0	0	11
61519	473296	21	2	1	0	1	4
61519	473272	19	1	1	1	1	4
61519	473200	18	0	0	2	0	2
61519	473206	18	2	2	1	2	7
61519	473309	18	5	2	0	0	7
61519	473261	16	3	3	1	2	9
61519	473310	15	4	9	0	1	14
61519	473318	15	2	1	0	0	3
61519	188249	14	5	2	2	0	9
61519	473268	14	6	1	0	1	8
61519	473316	14	1	0	0	3	4
61519	473216	13	0	2	1	0	3
61519	473223	13	1	3	0	4	8
61519	473308	13	7	0	0	1	8
61519	473276	12	1	2	1	0	4
61519	473325	12	1	0	0	0	1
61519	212740	11	1	2	0	1	4
61519	473231	11	0	0	0	0	0
61519	473245	11	1	0	0	0	1
61519	473258	11	5	0	0	0	5
61519	473287	11	1	0	0	1	2
61519	473298	11	2	1	0	0	3
61519	182318	10	4	2	0	2	8
61519	190302	10	2	1	0	0	3
61519	473225	10	3	1	0	0	4
61519	473273	10	0	2	0	2	4
61519	473317	10	2	1	1	1	5
61519	192358	9	1	0	0	1	2
61519	473201	9	1	2	1	3	7
61519	473226	9	1	2	0	0	3
61519	473243	9	1	1	0	1	3
61519	473251	9	4	2	0	1	7
61519	473193	8	4	1	0	0	5
61519	473212	8	0	2	0	2	4
61519	473240	8	2	0	0	0	2
61519	473250	8	4	1	2	2	9
61519	473265	8	3	8	0	0	11
61519	473279	8	0	1	0	1	2
61519	473314	8	2	0	0	0	2
61519	473326	8	0	1	0	1	2
61519	209741	7	4	0	0	3	7
61519	213394	7	5	6	0	0	11
61519	473207	7	0	2	0	2	4
61519	473208	7	1	3	0	0	4
61519	473210	7	0	3	0	1	4
61519	473234	7	3	2	0	0	5
61519	473241	7	0	0	0	1	1
61519	473242	7	0	1	0	0	1
61519	473247	7	0	0	2	1	3
61519	473249	7	1	1	0	0	2
61519	473266	7	2	5	0	1	8
61519	473280	7	4	2	0	0	6
61519	473282	7	1	2	0	0	3
61519	473285	7	2	3	0	0	5
61519	473286	7	1	0	0	0	1
61519	473292	7	2	2	0	1	5
61519	473301	7	1	1	0	0	2
61519	473313	7	3	0	0	0	3
61519	193184	6	2	0	0	0	2
61519	204273	6	0	0	0	0	0
61519	210547	6	1	3	0	0	4
61519	210829	6	1	4	0	1	6
61519	214297	6	1	1	0	4	6
61519	215786	6	1	0	0	0	1
61519	473192	6	0	2	0	2	4
61519	473205	6	2	2	0	0	4
61519	473214	6	1	1	0	1	3
61519	473221	6	1	0	0	1	2
61519	473222	6	1	2	0	1	4
61519	473237	6	1	0	0	0	1
61519	473253	6	2	1	0	1	4
61519	473263	6	0	1	0	0	1
61519	473269	6	1	3	1	2	7
61519	473275	6	2	1	0	2	5
61519	473277	6	3	3	0	1	7
61519	473278	6	0	4	0	0	4
61519	473290	6	1	2	0	0	3
61519	473293	6	4	0	0	2	6
61519	473307	6	1	2	0	0	3
61519	55493	6	1	4	0	1	6
61519	100112	5	3	1	0	0	4
61519	105378	5	0	0	0	0	0
61519	187889	5	1	4	0	1	6
61519	189801	5	1	0	0	0	1
61519	193040	5	2	4	0	1	7
61519	193760	5	1	3	0	1	5
61519	202065	5	1	4	0	0	5
61519	220968	5	1	0	0	2	3
61519	299410	5	2	1	1	0	4
61519	299411	5	0	0	0	0	0
61519	299416	5	3	1	0	0	4
61519	473224	5	0	1	0	1	2
61519	473227	5	2	0	0	0	2
61519	473233	5	0	0	0	1	1
61519	473264	5	1	1	0	0	2
61519	473267	5	0	1	0	4	5
61519	473294	5	2	0	0	1	3
61519	473295	5	3	2	0	0	5
61519	473300	5	1	2	0	0	3
61519	473320	5	1	1	0	1	3
61519	473321	5	1	0	0	1	2
61519	473322	5	1	1	0	1	3
61519	473323	5	3	0	0	0	3
61519	473324	5	2	1	0	0	3
61519	473328	5	0	1	0	0	1
61519	473332	5	1	2	0	2	5
61519	84498	5	0	0	0	0	0
61519	182693	4	2	0	0	0	2
61519	189842	4	1	0	0	0	1
61519	198222	4	0	1	0	0	1
61519	199190	4	1	2	0	0	3
61519	205363	4	2	1	0	0	3
61519	205414	4	1	1	0	0	2
61519	206453	4	0	0	0	0	0
61519	207105	4	1	4	0	0	5
61519	212755	4	0	0	0	0	0
61519	220887	4	0	0	0	0	0
61519	299413	4	2	0	0	0	2
61519	299414	4	1	1	0	0	2
61519	299415	4	3	1	0	1	5
61519	299418	4	3	4	1	1	9
61519	473198	4	1	1	0	2	4
61519	473199	4	0	0	0	1	1
61519	473209	4	1	2	0	2	5
61519	473220	4	1	1	0	0	2
61519	473229	4	1	1	0	0	2
61519	473230	4	0	1	0	0	1
61519	473232	4	2	0	0	1	3
61519	473235	4	0	0	1	0	1
61519	473270	4	1	0	0	1	2
61519	473271	4	0	0	0	0	0
61519	473284	4	3	0	0	0	3
61519	473289	4	1	1	0	0	2
61519	473297	4	4	0	0	1	5
61519	473306	4	4	2	0	0	6
61519	473312	4	0	1	0	1	2
61519	473315	4	6	0	0	0	6
61519	473319	4	1	0	0	1	2
61519	94081	4	3	4	1	1	9
61519	99625	4	3	1	0	1	5
61519	192346	3	1	1	1	0	3
61519	202063	3	1	1	0	0	2
61519	203190	3	0	0	0	0	0
61519	207004	3	0	1	0	0	1
61519	208890	3	3	1	0	0	4
61519	208925	3	1	0	0	1	2
61519	214516	3	2	0	0	0	2
61519	216758	3	0	0	0	0	0
61519	218448	3	3	4	1	1	9
61519	220105	3	1	1	0	1	3
61519	473196	3	2	0	1	0	3
61519	473197	3	1	0	0	0	1
61519	473202	3	1	1	0	0	2
61519	473204	3	0	3	0	0	3
61519	473213	3	2	3	0	2	7
61519	473228	3	2	0	0	0	2
61519	473244	3	0	2	0	0	2
61519	473248	3	2	2	0	0	4
61519	473252	3	1	0	0	0	1
61519	473257	3	1	0	0	0	1
61519	473259	3	3	0	0	0	3
61519	473281	3	1	0	0	0	1
61519	473283	3	2	0	0	0	2
61519	473288	3	2	0	0	1	3
61519	473329	3	1	0	0	1	2
61519	473330	3	3	0	0	0	3
61519	473331	3	0	0	0	1	1
61519	473333	3	1	1	0	0	2
61519	187120	2	1	0	0	0	1
61519	195964	2	0	0	0	1	1
61519	207336	2	0	0	0	0	0
61519	214349	2	0	1	0	0	1
61519	214972	2	0	0	0	0	0
61519	299417	2	0	0	0	0	0
61519	473194	2	1	0	0	1	2
61519	473195	2	1	0	0	0	1
61519	473203	2	1	4	0	0	5
61519	473215	2	0	0	0	0	0
61519	473218	2	2	2	0	0	4
61519	473219	2	2	3	0	0	5
61519	473238	2	2	1	0	2	5
61519	473239	2	1	0	0	0	1
61519	473254	2	0	0	0	1	1
61519	473260	2	2	2	0	2	6
61519	473274	2	1	1	0	1	3
61519	473299	2	0	0	0	1	1
61519	473302	2	1	1	0	0	2
61519	473304	2	1	1	0	0	2
61519	473305	2	0	0	0	0	0
61519	473311	2	0	0	0	0	0
61519	82106	2	0	1	0	3	4
61519	83833	2	0	0	0	0	0
61519	186224	1	0	1	0	0	1
61519	193045	1	0	0	0	0	0
61519	199956	1	0	1	0	0	1
61519	203173	1	0	0	0	0	0
61519	207605	1	1	0	0	0	1
61519	210154	1	1	0	0	0	1
61519	210323	1	0	0	0	0	0
61519	211187	1	0	0	0	0	0
61519	214061	1	1	0	0	0	1
61519	220374	1	0	0	0	0	0
61519	299412	1	1	0	0	0	1
61519	473191	1	0	0	0	0	0
61519	473211	1	1	0	0	0	1
61519	473217	1	0	0	0	1	1
61519	473236	1	0	0	0	0	0
61519	473246	1	2	1	0	1	4
61519	473255	1	1	0	2	0	3
61519	473256	1	0	0	0	0	0
61519	473262	1	2	1	0	1	4
61519	473291	1	0	1	0	0	1
61519	473303	1	2	1	0	0	3
61519	473327	1	0	0	0	0	0
61519	87843	1	1	0	0	0	1
31280	291445	36	4	1	1	1	7
31280	202327	30	2	3	0	1	6
31280	210652	30	6	3	2	6	17
31280	291410	29	2	3	0	1	6
31280	291435	22	3	2	0	2	7
31280	291419	18	3	3	1	0	7
31280	186096	17	1	1	2	1	5
31280	291423	16	1	1	2	1	5
31280	211571	15	1	0	1	1	3
31280	199058	14	1	0	0	0	1
31280	291429	14	1	0	0	0	1
31280	291442	14	2	1	0	0	3
31280	197202	13	1	1	0	2	4
31280	215254	13	1	2	2	1	6
31280	217451	12	1	2	1	0	4
31280	220012	12	3	2	0	1	6
31280	194996	11	1	1	0	2	4
31280	199321	11	4	2	0	2	8
31280	206649	11	2	0	0	0	2
31280	207226	11	1	0	0	1	2
31280	212818	11	1	1	0	1	3
31280	214583	11	3	6	2	2	13
31280	219905	11	1	6	1	3	11
31280	291436	11	0	0	2	1	3
31280	291437	11	1	1	0	2	4
31280	184925	10	1	0	1	4	6
31280	185363	10	2	5	0	0	7
31280	187158	10	2	0	1	2	5
31280	192417	10	1	1	0	0	2
31280	199170	10	1	0	1	0	2
31280	203760	9	3	1	0	1	5
31280	205265	9	1	1	0	1	3
31280	212123	9	2	3	2	1	8
31280	212847	9	0	2	0	1	3
31280	220541	9	0	0	0	0	0
31280	220581	9	2	1	0	1	4
31280	221333	9	1	0	1	1	3
31280	291441	9	1	0	1	4	6
31280	291444	9	2	0	0	0	2
31280	291451	9	3	2	0	0	5
31280	185967	8	0	1	0	1	2
31280	189840	8	1	0	0	2	3
31280	200379	8	0	0	0	0	0
31280	291409	8	1	2	0	2	5
31280	291427	8	3	2	1	1	7
31280	291431	8	0	0	0	0	0
31280	291443	8	4	4	0	0	8
31280	187930	7	2	0	1	0	3
31280	203883	7	2	3	0	1	6
31280	207148	7	0	0	1	0	1
31280	212329	7	0	0	1	0	1
31280	212491	7	1	3	0	0	4
31280	291413	7	1	1	0	1	3
31280	291414	7	0	0	0	0	0
31280	291421	7	2	0	0	0	2
31280	291430	7	1	4	1	0	6
31280	291433	7	1	1	0	1	3
31280	291447	7	1	2	0	1	4
31280	185684	6	0	0	0	0	0
31280	190574	6	1	0	0	0	1
31280	191557	6	0	1	0	0	1
31280	193212	6	1	0	0	1	2
31280	194922	6	1	2	0	0	3
31280	200650	6	2	0	0	0	2
31280	201584	6	0	0	0	0	0
31280	206053	6	0	1	0	0	1
31280	206985	6	2	1	0	0	3
31280	207540	6	0	0	1	0	1
31280	209778	6	1	1	3	0	5
31280	217681	6	1	2	0	1	4
31280	220492	6	0	3	1	4	8
31280	220589	6	2	2	3	4	11
31280	291425	6	2	0	0	0	2
31280	291428	6	2	1	1	4	8
31280	291432	6	2	1	0	1	4
31280	291439	6	0	0	0	1	1
31280	291440	6	5	1	0	0	6
31280	183121	5	1	1	0	1	3
31280	185523	5	0	2	1	0	3
31280	185883	5	0	2	0	0	2
31280	185941	5	1	2	1	0	4
31280	187854	5	1	0	1	1	3
31280	188255	5	1	2	1	2	6
31280	189889	5	0	1	0	0	1
31280	194142	5	1	0	0	0	1
31280	196388	5	1	0	0	2	3
31280	197231	5	0	0	0	3	3
31280	201322	5	0	4	0	1	5
31280	201888	5	2	0	0	0	2
31280	203709	5	1	1	0	0	2
31280	204962	5	0	0	0	0	0
31280	207586	5	1	1	0	0	2
31280	207703	5	0	1	0	0	1
31280	208006	5	0	1	0	0	1
31280	208288	5	0	0	0	0	0
31280	209310	5	1	0	1	1	3
31280	211973	5	1	1	1	1	4
31280	212618	5	0	2	0	2	4
31280	213321	5	2	1	1	3	7
31280	214441	5	2	0	0	1	3
31280	215415	5	1	0	0	0	1
31280	216891	5	0	1	0	1	2
31280	291418	5	2	0	0	0	2
31280	291446	5	0	3	0	3	6
31280	561377	5	2	1	0	1	4
31280	561378	5	2	1	0	1	4
31280	182311	4	0	0	0	0	0
31280	183233	4	2	0	1	1	4
31280	183969	4	1	0	0	1	2
31280	188491	4	1	0	1	0	2
31280	190490	4	0	2	0	0	2
31280	192238	4	0	0	0	1	1
31280	197188	4	1	0	1	0	2
31280	198374	4	2	2	0	1	5
31280	198652	4	3	1	1	2	7
31280	200005	4	1	2	0	0	3
31280	201657	4	3	0	0	0	3
31280	204823	4	1	0	0	1	2
31280	206079	4	0	2	0	1	3
31280	206494	4	0	2	0	1	3
31280	208018	4	1	0	0	1	2
31280	210740	4	0	1	0	0	1
31280	212760	4	2	2	0	0	4
31280	213416	4	0	0	0	0	0
31280	215805	4	0	2	0	0	2
31280	216123	4	0	1	1	0	2
31280	216765	4	0	0	0	0	0
31280	221576	4	0	0	0	0	0
31280	291412	4	0	1	0	0	1
31280	291417	4	1	0	0	0	1
31280	291420	4	0	2	0	0	2
31280	291449	4	1	1	0	0	2
31280	189667	3	1	1	0	0	2
31280	190097	3	0	1	0	0	1
31280	191076	3	0	0	0	0	0
31280	193581	3	2	0	0	1	3
31280	195605	3	1	0	0	2	3
31280	196718	3	0	0	0	0	0
31280	202586	3	0	0	0	0	0
31280	205306	3	2	1	0	4	7
31280	205419	3	2	1	0	0	3
31280	205533	3	1	0	0	0	1
31280	206452	3	1	0	0	0	1
31280	207129	3	1	1	0	0	2
31280	207570	3	1	1	0	0	2
31280	207728	3	0	0	0	1	1
31280	209774	3	0	0	1	0	1
31280	211667	3	0	0	1	2	3
31280	212331	3	3	0	0	0	3
31280	213018	3	1	1	0	1	3
31280	213355	3	1	2	1	0	4
31280	214086	3	0	1	2	0	3
31280	214546	3	0	0	0	1	1
31280	214671	3	0	0	0	0	0
31280	214907	3	1	1	0	2	4
31280	215404	3	1	0	0	0	1
31280	216345	3	0	0	1	0	1
31280	216547	3	0	1	0	0	1
31280	217808	3	1	1	0	0	2
31280	218088	3	1	2	0	3	6
31280	291415	3	2	0	0	0	2
31280	291438	3	3	3	0	0	6
31280	291450	3	0	1	1	0	2
31280	182326	2	0	2	2	1	5
31280	183063	2	0	0	2	0	2
31280	183511	2	0	0	0	0	0
31280	183861	2	0	1	0	0	1
31280	184229	2	1	0	0	0	1
31280	188968	2	2	0	0	1	3
31280	191387	2	0	0	0	1	1
31280	195688	2	0	0	0	0	0
31280	196023	2	1	0	0	0	1
31280	198023	2	1	0	0	0	1
31280	198181	2	1	0	0	0	1
31280	200023	2	0	0	0	0	0
31280	201262	2	0	0	0	0	0
31280	201386	2	0	1	0	0	1
31280	202936	2	0	0	0	1	1
31280	206382	2	0	0	0	0	0
31280	207266	2	0	0	1	0	1
31280	207969	2	0	0	0	1	1
31280	208918	2	0	1	0	0	1
31280	210486	2	0	0	0	0	0
31280	212989	2	0	1	0	0	1
31280	213357	2	0	1	0	0	1
31280	213885	2	1	0	0	0	1
31280	221936	2	2	3	0	2	7
31280	291411	2	0	0	0	0	0
31280	291416	2	2	1	0	0	3
31280	291424	2	2	1	0	1	4
31280	291426	2	0	0	0	1	1
31280	291434	2	0	0	0	0	0
31280	186683	1	0	0	0	0	0
31280	190628	1	0	0	0	0	0
31280	190855	1	0	0	0	0	0
31280	192797	1	2	0	0	2	4
31280	195649	1	0	0	0	0	0
31280	197285	1	0	0	0	0	0
31280	199779	1	0	0	0	0	0
31280	200035	1	2	0	0	0	2
31280	203347	1	0	0	0	0	0
31280	206411	1	0	1	0	0	1
31280	206509	1	0	0	0	0	0
31280	215161	1	1	0	0	0	1
31280	218004	1	1	0	0	0	1
31280	218847	1	0	0	0	0	0
31280	291422	1	1	0	0	0	1
31280	291448	1	1	0	0	0	1
31280	561379	1	1	2	0	0	3
72817	193234	33	4	6	0	1	11
72817	280611	33	4	6	0	1	11
72817	575721	25	1	2	0	4	7
72817	575641	17	1	0	0	1	2
72817	575633	13	0	0	0	0	0
72817	575639	13	3	4	0	0	7
72817	575598	12	3	0	0	1	4
72817	575636	12	3	3	0	0	6
72817	575688	12	1	2	0	0	3
72817	575694	12	5	0	1	1	7
72817	575698	12	1	0	0	1	2
72817	575626	11	1	0	0	2	3
72817	199187	10	2	3	0	2	7
72817	575644	10	1	2	0	0	3
72817	575687	10	2	2	1	0	5
72817	575695	10	5	4	0	0	9
72817	575696	10	1	4	0	2	7
72817	575736	10	2	0	0	1	3
72817	575681	9	2	3	1	6	12
72817	575686	9	0	1	0	1	2
72817	575717	9	0	0	0	0	0
72817	214368	8	2	1	0	1	4
72817	575620	8	0	2	0	1	3
72817	575646	8	0	0	0	1	1
72817	575676	8	2	1	0	0	3
72817	575703	8	1	0	0	0	1
72817	575709	8	4	2	0	4	10
72817	575735	8	1	2	0	0	3
72817	204301	7	3	1	0	0	4
72817	206372	7	1	3	0	0	4
72817	210944	7	4	1	0	0	5
72817	215247	7	1	1	0	2	4
72817	280608	7	3	1	0	0	4
72817	280622	7	0	1	1	0	2
72817	280624	7	0	2	0	1	3
72817	575603	7	3	0	0	0	3
72817	575610	7	2	2	0	0	4
72817	575615	7	0	1	0	0	1
72817	575624	7	2	3	0	0	5
72817	575631	7	1	0	0	1	2
72817	575632	7	4	1	0	0	5
72817	575647	7	2	2	0	2	6
72817	575667	7	0	1	0	1	2
72817	575682	7	3	4	0	1	8
72817	575685	7	3	0	0	0	3
72817	575692	7	0	3	0	0	3
72817	575701	7	1	1	0	3	5
72817	575708	7	2	0	0	0	2
72817	575726	7	1	1	0	2	4
72817	575731	7	2	0	0	0	2
72817	575741	7	1	1	0	0	2
72817	199146	6	0	0	0	0	0
72817	201977	6	0	1	2	0	3
72817	208275	6	1	1	0	0	2
72817	214299	6	1	1	0	4	6
72817	216989	6	1	4	1	0	6
72817	280615	6	0	1	0	0	1
72817	280616	6	1	4	1	0	6
72817	575606	6	1	1	0	0	2
72817	575619	6	0	1	1	1	3
72817	575621	6	3	0	0	2	5
72817	575656	6	2	1	0	1	4
72817	575660	6	1	1	0	2	4
72817	575662	6	0	0	0	1	1
72817	575665	6	1	4	1	0	6
72817	575672	6	0	1	0	0	1
72817	575697	6	1	2	0	3	6
72817	575718	6	0	0	1	0	1
72817	575740	6	0	0	0	0	0
72817	575744	6	3	0	0	0	3
72817	193186	5	2	1	0	0	3
72817	280618	5	2	0	0	5	7
72817	575595	5	1	1	0	0	2
72817	575597	5	0	0	0	0	0
72817	575618	5	0	1	0	0	1
72817	575623	5	0	2	0	2	4
72817	575627	5	0	2	0	1	3
72817	575637	5	0	3	0	0	3
72817	575648	5	1	0	0	1	2
72817	575649	5	0	4	0	0	4
72817	575658	5	0	0	0	0	0
72817	575671	5	0	1	0	0	1
72817	575677	5	2	0	0	1	3
72817	575705	5	1	0	0	0	1
72817	575707	5	2	0	0	6	8
72817	575712	5	0	0	0	1	1
72817	575714	5	1	0	0	0	1
72817	575715	5	1	0	0	0	1
72817	575720	5	0	0	0	0	0
72817	575722	5	2	0	0	2	4
72817	575724	5	1	2	0	0	3
72817	575727	5	2	0	0	1	3
72817	575733	5	1	1	0	0	2
72817	575737	5	1	1	0	0	2
72817	575738	5	1	0	0	1	2
72817	182667	4	1	0	0	0	1
72817	205413	4	0	0	0	3	3
72817	207107	4	0	1	1	1	3
72817	208161	4	1	1	0	0	2
72817	208927	4	1	0	0	0	1
72817	213331	4	2	2	0	0	4
72817	214524	4	0	2	0	0	2
72817	280609	4	1	1	0	0	2
72817	280617	4	1	4	0	1	6
72817	575596	4	1	0	0	0	1
72817	575611	4	0	2	0	1	3
72817	575612	4	0	1	0	1	2
72817	575625	4	0	1	0	0	1
72817	575628	4	2	0	0	0	2
72817	575629	4	5	1	0	0	6
72817	575630	4	1	2	0	0	3
72817	575640	4	2	0	0	0	2
72817	575655	4	2	1	0	1	4
72817	575659	4	1	0	0	0	1
72817	575664	4	2	2	0	0	4
72817	575666	4	0	1	0	0	1
72817	575669	4	0	1	0	0	1
72817	575689	4	0	2	0	2	4
72817	575691	4	0	0	0	0	0
72817	575693	4	0	2	1	1	4
72817	575699	4	3	0	0	0	3
72817	575706	4	0	2	0	1	3
72817	575711	4	1	0	0	1	2
72817	575723	4	0	1	0	2	3
72817	575732	4	1	1	0	1	3
72817	575739	4	1	0	0	0	1
72817	189803	3	0	0	0	1	1
72817	192348	3	1	1	1	0	3
72817	205358	3	0	1	0	2	3
72817	208831	3	1	0	0	0	1
72817	212423	3	2	3	0	1	6
72817	216082	3	1	1	0	0	2
72817	218536	3	0	1	0	0	1
72817	280613	3	0	3	1	0	4
72817	280619	3	0	1	0	0	1
72817	280620	3	0	1	1	2	4
72817	280621	3	0	0	0	0	0
72817	575600	3	3	2	0	0	5
72817	575601	3	2	1	0	0	3
72817	575602	3	4	1	0	0	5
72817	575607	3	0	2	0	0	2
72817	575608	3	1	0	0	0	1
72817	575609	3	3	1	0	0	4
72817	575613	3	1	2	0	0	3
72817	575634	3	2	2	0	1	5
72817	575642	3	0	0	0	0	0
72817	575651	3	2	0	0	0	2
72817	575653	3	0	1	0	0	1
72817	575654	3	0	0	0	0	0
72817	575657	3	2	0	0	0	2
72817	575661	3	2	1	0	1	4
72817	575663	3	0	1	0	1	2
72817	575668	3	0	0	0	0	0
72817	575674	3	4	2	0	0	6
72817	575678	3	0	0	0	0	0
72817	575679	3	2	1	0	0	3
72817	575680	3	0	0	0	0	0
72817	575684	3	1	0	0	1	2
72817	575690	3	1	1	0	0	2
72817	575700	3	1	0	0	2	3
72817	575713	3	0	1	0	0	1
72817	575716	3	1	0	0	1	2
72817	575725	3	1	0	0	2	3
72817	575742	3	0	2	0	1	3
72817	187893	2	0	1	0	0	1
72817	195772	2	0	2	0	1	3
72817	207331	2	0	0	0	1	1
72817	208885	2	0	3	0	0	3
72817	217171	2	0	4	0	0	4
72817	280610	2	1	0	0	0	1
72817	280614	2	1	0	0	0	1
72817	280623	2	0	0	0	0	0
72817	575604	2	1	1	0	0	2
72817	575617	2	0	1	0	2	3
72817	575622	2	0	0	0	0	0
72817	575635	2	1	1	0	0	2
72817	575638	2	3	0	0	0	3
72817	575643	2	0	0	0	0	0
72817	575650	2	0	0	0	0	0
72817	575670	2	4	0	0	1	5
72817	575673	2	1	0	0	0	1
72817	575675	2	0	1	0	0	1
72817	575683	2	0	0	0	0	0
72817	575702	2	0	0	0	0	0
72817	575704	2	1	1	0	0	2
72817	575710	2	1	2	0	1	4
72817	575728	2	0	0	0	1	1
72817	575729	2	0	0	0	1	1
72817	575730	2	0	1	0	0	1
72817	575734	2	2	0	0	1	3
72817	575743	2	3	0	0	0	3
72817	575745	2	1	1	0	0	2
72817	147270	1	1	0	0	0	1
72817	187212	1	0	0	0	0	0
72817	195856	1	1	0	0	1	2
72817	202966	1	0	0	0	0	0
72817	203172	1	0	0	0	0	0
72817	207603	1	0	1	0	0	1
72817	208897	1	2	0	0	0	2
72817	210322	1	0	1	0	0	1
72817	211185	1	0	1	0	0	1
72817	220376	1	0	0	0	0	0
72817	280612	1	0	0	0	0	0
72817	575599	1	0	1	0	0	1
72817	575605	1	3	3	0	0	6
72817	575614	1	1	0	0	0	1
72817	575616	1	1	2	0	0	3
72817	575645	1	2	0	0	1	3
72817	575652	1	0	0	0	0	0
72817	575719	1	1	2	0	1	4
41320	221565	35	1	1	0	0	2
41320	294242	24	3	4	0	3	10
41320	76793	24	3	4	0	3	10
41320	105584	23	1	4	0	1	6
41320	62409	13	1	2	0	1	4
41320	444277	12	0	2	0	2	4
41320	444281	12	0	1	0	0	1
41320	106081	11	0	1	0	0	1
41320	219547	11	0	1	0	0	1
41320	444293	11	1	0	0	0	1
41320	205489	10	2	3	0	0	5
41320	444247	10	2	3	0	2	7
41320	444274	10	0	0	0	0	0
41320	65881	10	2	3	0	2	7
41320	102128	9	3	2	0	0	5
41320	204747	9	0	2	0	0	2
41320	214861	9	3	2	0	0	5
41320	294245	9	3	2	0	0	5
41320	444195	9	3	1	0	1	5
41320	51655	9	1	3	0	0	4
41320	104108	8	1	0	1	0	2
41320	210398	8	3	0	1	1	5
41320	294247	8	0	2	0	1	3
41320	444173	8	2	1	0	0	3
41320	444217	8	2	1	0	0	3
41320	444221	8	3	1	1	0	5
41320	444227	8	0	0	0	0	0
41320	444264	8	1	0	1	2	4
41320	444276	8	4	4	0	0	8
41320	107450	7	1	1	0	0	2
41320	220133	7	1	1	0	0	2
41320	444182	7	0	1	0	0	1
41320	444188	7	1	1	1	1	4
41320	444204	7	0	2	2	0	4
41320	444238	7	0	2	0	0	2
41320	444246	7	1	1	0	0	2
41320	444270	7	2	2	1	1	6
41320	444271	7	3	1	0	0	4
41320	444273	7	0	1	0	0	1
41320	444275	7	1	3	1	0	5
41320	95718	7	0	0	0	0	0
41320	194727	6	0	1	0	0	1
41320	196769	6	1	3	0	1	5
41320	208195	6	0	0	0	0	0
41320	212966	6	1	2	0	1	4
41320	217846	6	1	2	0	0	3
41320	444176	6	2	1	0	0	3
41320	444179	6	1	0	1	0	2
41320	444197	6	1	2	1	0	4
41320	444213	6	3	1	0	2	6
41320	444215	6	1	0	0	0	1
41320	444254	6	0	0	0	0	0
41320	444263	6	0	0	1	0	1
41320	444280	6	2	4	0	0	6
41320	444283	6	0	0	0	0	0
41320	444288	6	0	0	0	0	0
41320	444295	6	0	0	0	0	0
41320	82100	6	3	1	0	0	4
41320	101103	5	1	1	0	0	2
41320	185529	5	4	2	0	0	6
41320	216927	5	0	0	0	0	0
41320	220165	5	1	1	0	0	2
41320	294239	5	0	0	0	0	0
41320	294243	5	1	1	0	0	2
41320	444171	5	0	0	0	0	0
41320	444174	5	0	0	1	0	1
41320	444181	5	0	1	0	0	1
41320	444186	5	0	0	0	0	0
41320	444198	5	1	0	0	0	1
41320	444200	5	1	1	0	0	2
41320	444201	5	1	0	0	1	2
41320	444203	5	1	0	1	1	3
41320	444210	5	0	0	0	0	0
41320	444219	5	1	1	0	2	4
41320	444220	5	0	5	1	0	6
41320	444225	5	0	0	0	0	0
41320	444230	5	1	1	2	0	4
41320	444233	5	0	1	0	0	1
41320	444240	5	1	2	0	1	4
41320	444242	5	0	1	0	0	1
41320	444248	5	1	0	0	0	1
41320	444249	5	4	1	0	1	6
41320	444253	5	0	0	0	0	0
41320	444266	5	1	3	0	0	4
41320	444267	5	1	0	0	2	3
41320	444278	5	2	1	0	0	3
41320	444285	5	0	0	0	1	1
41320	444289	5	0	0	0	0	0
41320	444291	5	0	1	0	0	1
41320	444294	5	0	1	0	0	1
41320	444300	5	0	2	0	1	3
41320	444305	5	1	2	0	0	3
41320	444309	5	0	0	0	0	0
41320	444310	5	0	1	1	0	2
41320	51349	5	1	0	1	0	2
41320	88599	5	0	0	0	0	0
41320	102992	4	0	1	1	0	2
41320	190694	4	1	0	0	0	1
41320	209266	4	1	0	1	0	2
41320	294238	4	0	1	1	0	2
41320	294240	4	0	1	1	0	2
41320	294246	4	1	1	0	0	2
41320	444168	4	1	0	0	0	1
41320	444172	4	1	2	0	0	3
41320	444175	4	2	1	0	2	5
41320	444183	4	2	1	0	0	3
41320	444187	4	1	1	0	0	2
41320	444193	4	0	0	0	0	0
41320	444199	4	0	1	0	0	1
41320	444209	4	0	0	0	2	2
41320	444218	4	3	0	0	0	3
41320	444222	4	1	1	0	1	3
41320	444226	4	3	0	0	0	3
41320	444231	4	1	0	0	1	2
41320	444237	4	0	0	0	0	0
41320	444245	4	1	1	0	0	2
41320	444252	4	1	4	0	0	5
41320	444259	4	1	2	0	1	4
41320	444260	4	1	2	0	1	4
41320	444265	4	0	3	0	0	3
41320	444268	4	1	0	0	0	1
41320	444286	4	0	2	0	0	2
41320	444292	4	2	0	0	0	2
41320	444302	4	0	1	0	0	1
41320	444303	4	0	0	1	0	1
41320	444304	4	1	1	0	0	2
41320	53707	4	1	1	0	0	2
41320	189751	3	1	4	0	0	5
41320	193217	3	0	0	0	0	0
41320	206206	3	1	2	0	1	4
41320	211874	3	1	0	0	0	1
41320	444165	3	0	1	0	0	1
41320	444170	3	1	0	0	0	1
41320	444189	3	0	1	0	0	1
41320	444190	3	1	1	0	0	2
41320	444196	3	1	0	0	0	1
41320	444205	3	0	0	0	0	0
41320	444206	3	0	0	0	0	0
41320	444207	3	0	1	0	0	1
41320	444211	3	0	0	0	0	0
41320	444223	3	1	2	0	0	3
41320	444232	3	0	0	0	0	0
41320	444235	3	0	0	0	1	1
41320	444236	3	0	1	1	1	3
41320	444243	3	2	1	0	0	3
41320	444250	3	0	1	0	0	1
41320	444251	3	1	1	0	0	2
41320	444255	3	0	2	0	0	2
41320	444261	3	0	0	0	0	0
41320	444272	3	0	1	0	0	1
41320	444279	3	1	0	0	0	1
41320	444282	3	0	1	0	0	1
41320	444290	3	2	1	0	0	3
41320	444298	3	1	2	0	0	3
41320	444301	3	2	1	1	0	4
41320	444307	3	2	1	0	0	3
41320	444308	3	0	0	0	0	0
41320	62443	3	0	2	0	0	2
41320	69253	3	0	2	0	0	2
41320	69264	3	0	2	0	0	2
41320	191211	2	0	1	0	2	3
41320	195713	2	0	1	0	0	1
41320	208594	2	0	0	0	0	0
41320	213469	2	0	0	0	0	0
41320	220322	2	1	0	1	0	2
41320	220766	2	0	0	0	0	0
41320	294236	2	0	0	0	0	0
41320	294241	2	1	1	0	1	3
41320	294244	2	1	1	0	0	2
41320	444164	2	0	2	0	0	2
41320	444167	2	0	1	0	0	1
41320	444169	2	1	1	0	0	2
41320	444177	2	1	0	0	0	1
41320	444178	2	1	0	0	0	1
41320	444185	2	0	0	0	0	0
41320	444192	2	1	0	0	0	1
41320	444194	2	1	0	0	0	1
41320	444202	2	0	0	0	0	0
41320	444208	2	0	0	0	0	0
41320	444212	2	0	0	0	0	0
41320	444214	2	0	1	0	0	1
41320	444216	2	0	1	0	0	1
41320	444224	2	0	0	0	0	0
41320	444228	2	1	3	0	0	4
41320	444229	2	0	1	0	0	1
41320	444234	2	0	0	0	0	0
41320	444239	2	0	0	0	0	0
41320	444241	2	1	0	0	0	1
41320	444244	2	1	0	0	0	1
41320	444257	2	0	0	0	0	0
41320	444262	2	2	2	0	0	4
41320	444284	2	1	0	0	0	1
41320	444287	2	0	1	0	0	1
41320	444296	2	0	2	0	0	2
41320	444297	2	0	0	0	0	0
41320	74203	2	1	1	0	1	3
41320	206417	1	0	1	0	0	1
41320	294237	1	0	1	0	0	1
41320	444166	1	0	0	0	0	0
41320	444180	1	1	0	0	1	2
41320	444184	1	0	1	0	1	2
41320	444191	1	0	0	0	0	0
41320	444256	1	0	0	0	0	0
41320	444269	1	0	1	0	0	1
41320	444299	1	0	2	0	0	2
41320	444306	1	0	0	0	0	0
41320	85865	1	0	0	0	0	0
48042	199043	38	3	4	0	3	10
48042	202494	13	2	3	0	1	6
48042	280499	13	2	3	0	1	6
48042	512768	10	1	1	0	0	2
48042	512802	10	0	5	1	2	8
48042	280495	8	2	2	0	0	4
48042	512725	8	1	0	0	0	1
48042	512728	8	0	1	0	1	2
48042	512745	8	3	2	0	1	6
48042	512753	8	0	4	0	0	4
48042	512797	8	1	1	0	0	2
48042	187940	7	1	1	0	0	2
48042	216823	7	3	0	0	1	4
48042	512695	7	1	2	1	2	6
48042	512700	7	0	0	0	1	1
48042	512705	7	0	1	0	1	2
48042	512708	7	0	1	0	1	2
48042	512730	7	1	1	0	1	3
48042	512744	7	2	2	0	0	4
48042	512764	7	0	1	0	0	1
48042	512800	7	2	1	0	0	3
48042	512824	7	0	3	0	1	4
48042	211361	6	2	1	0	0	3
48042	213345	6	1	3	0	0	4
48042	512774	6	0	0	0	0	0
48042	512776	6	2	2	0	0	4
48042	512781	6	1	3	0	0	4
48042	512783	6	3	1	0	0	4
48042	512803	6	1	0	0	0	1
48042	512819	6	2	1	0	0	3
48042	512829	6	0	1	0	0	1
48042	512849	6	1	3	0	1	5
48042	512859	6	0	2	0	0	2
48042	183206	5	2	2	0	0	4
48042	212767	5	1	2	0	1	4
48042	280496	5	1	0	1	0	2
48042	512717	5	1	3	0	0	4
48042	512720	5	1	3	0	0	4
48042	512722	5	1	3	0	0	4
48042	512724	5	1	2	0	0	3
48042	512734	5	0	1	0	0	1
48042	512735	5	1	2	0	0	3
48042	512740	5	0	3	2	1	6
48042	512742	5	2	1	0	0	3
48042	512743	5	0	6	0	3	9
48042	512746	5	0	4	0	0	4
48042	512801	5	2	1	2	0	5
48042	512816	5	0	0	0	0	0
48042	512830	5	0	1	0	0	1
48042	512855	5	0	2	0	0	2
48042	512863	5	1	3	0	0	4
48042	193570	4	0	3	0	0	3
48042	193912	4	0	3	0	0	3
48042	198370	4	0	1	0	0	1
48042	205315	4	2	1	0	1	4
48042	209553	4	0	1	0	0	1
48042	209683	4	1	1	0	0	2
48042	210501	4	0	4	0	0	4
48042	215934	4	0	2	0	0	2
48042	512698	4	0	2	1	0	3
48042	512701	4	0	2	0	0	2
48042	512702	4	0	0	0	1	1
48042	512710	4	1	0	0	0	1
48042	512712	4	1	1	0	2	4
48042	512726	4	0	2	0	1	3
48042	512736	4	3	5	0	0	8
48042	512747	4	0	0	0	0	0
48042	512748	4	1	2	0	0	3
48042	512750	4	1	1	0	0	2
48042	512752	4	0	0	0	0	0
48042	512755	4	1	0	0	1	2
48042	512760	4	1	1	0	0	2
48042	512766	4	1	0	0	0	1
48042	512767	4	0	2	0	0	2
48042	512769	4	1	1	0	0	2
48042	512770	4	0	2	0	0	2
48042	512773	4	0	0	0	0	0
48042	512780	4	0	5	0	0	5
48042	512788	4	0	2	0	0	2
48042	512789	4	0	1	0	1	2
48042	512794	4	2	2	0	0	4
48042	512799	4	1	0	0	0	1
48042	512804	4	1	0	0	0	1
48042	512805	4	1	3	0	0	4
48042	512812	4	0	3	0	0	3
48042	512817	4	0	2	0	0	2
48042	512823	4	2	0	0	0	2
48042	512825	4	2	1	0	0	3
48042	512832	4	1	1	0	0	2
48042	512833	4	1	2	0	0	3
48042	512835	4	0	1	0	0	1
48042	512836	4	0	0	0	0	0
48042	512848	4	1	3	0	0	4
48042	512853	4	1	2	0	0	3
48042	512854	4	2	1	0	0	3
48042	512862	4	0	0	0	1	1
48042	512864	4	0	0	0	0	0
48042	192656	3	0	3	0	0	3
48042	193295	3	1	0	0	0	1
48042	195783	3	0	1	0	0	1
48042	209858	3	0	2	0	1	3
48042	211204	3	1	2	0	0	3
48042	214100	3	0	2	0	0	2
48042	218006	3	0	1	0	0	1
48042	218867	3	0	0	0	0	0
48042	280498	3	0	0	0	0	0
48042	512696	3	0	1	0	1	2
48042	512699	3	0	0	0	1	1
48042	512709	3	1	2	0	1	4
48042	512711	3	1	0	0	0	1
48042	512733	3	0	2	0	1	3
48042	512737	3	0	1	0	0	1
48042	512738	3	0	0	0	0	0
48042	512739	3	1	1	0	0	2
48042	512754	3	0	2	0	1	3
48042	512756	3	0	1	0	0	1
48042	512759	3	1	1	0	0	2
48042	512761	3	0	1	0	0	1
48042	512762	3	1	2	0	1	4
48042	512771	3	0	1	0	0	1
48042	512772	3	2	1	0	0	3
48042	512777	3	0	2	0	0	2
48042	512778	3	0	1	0	0	1
48042	512787	3	1	2	0	1	4
48042	512791	3	0	2	0	1	3
48042	512793	3	2	1	0	1	4
48042	512796	3	0	1	0	1	2
48042	512806	3	0	2	0	0	2
48042	512809	3	1	3	0	2	6
48042	512810	3	1	1	0	2	4
48042	512811	3	1	1	0	0	2
48042	512815	3	1	1	0	0	2
48042	512820	3	0	0	0	0	0
48042	512821	3	1	1	0	0	2
48042	512828	3	1	2	1	1	5
48042	512831	3	2	2	0	0	4
48042	512834	3	0	0	0	3	3
48042	512837	3	2	3	0	1	6
48042	512838	3	0	1	0	0	1
48042	512842	3	0	3	0	1	4
48042	512843	3	2	1	0	0	3
48042	512845	3	1	0	0	0	1
48042	512852	3	0	1	0	0	1
48042	512860	3	0	0	0	1	1
48042	512866	3	0	1	0	0	1
48042	187117	2	1	0	0	0	1
48042	193655	2	0	2	0	0	2
48042	197883	2	0	0	0	0	0
48042	203343	2	0	2	0	0	2
48042	204315	2	0	0	0	0	0
48042	204547	2	0	1	0	0	1
48042	209558	2	1	0	0	0	1
48042	220982	2	1	2	0	1	4
48042	512697	2	1	0	0	0	1
48042	512703	2	0	0	0	0	0
48042	512704	2	1	1	0	1	3
48042	512706	2	0	0	0	0	0
48042	512707	2	0	0	0	0	0
48042	512727	2	0	2	0	0	2
48042	512729	2	0	2	0	0	2
48042	512731	2	0	2	0	0	2
48042	512732	2	0	3	0	0	3
48042	512741	2	1	0	0	0	1
48042	512757	2	0	2	0	0	2
48042	512758	2	2	0	0	0	2
48042	512763	2	2	0	0	0	2
48042	512775	2	0	2	0	0	2
48042	512779	2	0	2	0	0	2
48042	512784	2	1	1	0	2	4
48042	512785	2	0	1	0	0	1
48042	512786	2	0	1	0	0	1
48042	512792	2	1	1	0	0	2
48042	512807	2	1	1	0	0	2
48042	512808	2	1	2	0	0	3
48042	512813	2	0	1	0	0	1
48042	512814	2	1	0	0	0	1
48042	512822	2	2	0	0	0	2
48042	512839	2	1	1	0	0	2
48042	512840	2	1	0	0	2	3
48042	512841	2	0	3	0	0	3
48042	512847	2	0	1	0	0	1
48042	512851	2	1	1	0	0	2
48042	512857	2	0	2	0	0	2
48042	512861	2	0	0	0	0	0
48042	512865	2	0	1	0	1	2
48042	182676	1	0	1	0	0	1
48042	186675	1	0	0	0	0	0
48042	201547	1	0	0	0	0	0
48042	207083	1	0	1	0	0	1
48042	207828	1	0	1	0	0	1
48042	211129	1	0	0	0	0	0
48042	216881	1	0	1	0	0	1
48042	280497	1	0	1	0	0	1
48042	512723	1	0	4	0	0	4
48042	512749	1	2	1	0	0	3
48042	512751	1	1	2	0	0	3
48042	512765	1	0	1	0	0	1
48042	512782	1	0	0	0	0	0
48042	512790	1	0	1	0	0	1
48042	512795	1	1	0	0	1	2
48042	512798	1	0	1	0	0	1
48042	512818	1	1	1	0	0	2
48042	512826	1	0	0	0	0	0
48042	512827	1	2	1	0	0	3
48042	512844	1	0	1	0	0	1
48042	512846	1	1	1	0	0	2
48042	512850	1	0	0	0	0	0
48042	512856	1	1	0	0	0	1
48042	512858	1	0	1	0	0	1
32719	59032	63	3	6	1	1	11
32719	66414	30	3	7	1	1	12
32719	100465	23	2	5	2	0	9
32719	78902	20	0	1	0	0	1
32719	103857	17	2	5	0	1	8
32719	432771	17	3	3	0	1	7
32719	67077	17	2	6	1	1	10
32719	432809	14	2	1	1	4	8
32719	432817	14	2	1	3	5	11
32719	54559	13	2	1	0	0	3
32719	55857	13	0	3	3	0	6
32719	78303	13	3	6	1	0	10
32719	194257	12	2	0	0	0	2
32719	195057	12	0	0	1	0	1
32719	432778	12	1	7	0	0	8
32719	56975	12	2	2	1	0	5
32719	96251	12	0	0	0	0	0
32719	200733	11	1	2	0	0	3
32719	95883	11	1	0	1	2	4
32719	103864	10	1	2	0	1	4
32719	291835	10	1	2	0	0	3
32719	406903	10	1	2	0	1	4
32719	432830	10	2	0	0	0	2
32719	62103	10	3	2	0	0	5
32719	76700	10	1	2	0	0	3
32719	82981	10	2	3	0	0	5
32719	432759	9	2	1	0	0	3
32719	432822	9	1	1	2	0	4
32719	432825	9	1	1	0	0	2
32719	50396	9	0	4	0	2	6
32719	84035	9	0	0	0	0	0
32719	97176	9	1	0	0	0	1
32719	406905	8	1	2	0	1	4
32719	432786	8	0	0	1	1	2
32719	432804	8	0	0	0	0	0
32719	432805	8	2	1	0	0	3
32719	432816	8	0	0	0	0	0
32719	432856	8	1	1	0	0	2
32719	78155	8	0	0	0	1	1
32719	102617	7	0	4	0	0	4
32719	105027	7	3	3	0	1	7
32719	186209	7	1	0	0	0	1
32719	406902	7	2	0	0	0	2
32719	406907	7	1	4	1	0	6
32719	432777	7	0	1	0	0	1
32719	432779	7	1	0	0	0	1
32719	432841	7	1	1	0	0	2
32719	432854	7	0	0	0	0	0
32719	58142	7	0	0	1	2	3
32719	61949	7	2	0	0	1	3
32719	89751	7	3	1	0	0	4
32719	99202	7	1	0	0	1	2
32719	103831	6	1	1	0	0	2
32719	104841	6	1	2	2	0	5
32719	406901	6	0	2	0	0	2
32719	432766	6	2	2	0	0	4
32719	432775	6	5	1	1	0	7
32719	432788	6	3	1	0	0	4
32719	432797	6	1	1	0	1	3
32719	432813	6	0	1	0	0	1
32719	432828	6	0	3	2	0	5
32719	432865	6	0	0	2	0	2
32719	432867	6	3	1	0	0	4
32719	54657	6	0	1	0	0	1
32719	80607	6	0	0	0	0	0
32719	98920	6	0	0	0	0	0
32719	99771	6	0	1	0	1	2
32719	100262	5	0	0	0	0	0
32719	105050	5	1	2	0	1	4
32719	193909	5	1	1	0	0	2
32719	195260	5	0	0	0	0	0
32719	199700	5	0	2	0	0	2
32719	432767	5	0	2	0	0	2
32719	432782	5	0	2	1	0	3
32719	432789	5	0	1	0	0	1
32719	432793	5	3	2	0	0	5
32719	432803	5	0	0	0	0	0
32719	432806	5	1	1	0	3	5
32719	432807	5	2	2	0	0	4
32719	432810	5	2	1	2	0	5
32719	432818	5	1	2	0	0	3
32719	432824	5	2	2	0	0	4
32719	432832	5	2	0	0	0	2
32719	432838	5	1	0	0	0	1
32719	432839	5	1	0	0	0	1
32719	432843	5	0	0	2	1	3
32719	432847	5	1	0	0	0	1
32719	432849	5	0	0	0	0	0
32719	432850	5	0	3	0	1	4
32719	432857	5	5	1	0	0	6
32719	432863	5	2	2	1	0	5
32719	432872	5	0	1	0	0	1
32719	432873	5	0	0	0	1	1
32719	432875	5	3	4	0	0	7
32719	50238	5	1	0	0	0	1
32719	54532	5	1	0	0	0	1
32719	94760	5	1	0	0	0	1
32719	96357	5	1	0	0	0	1
32719	98441	5	0	1	0	0	1
32719	102450	4	1	1	0	0	2
32719	194172	4	0	1	0	0	1
32719	201226	4	1	4	0	0	5
32719	214707	4	0	0	0	1	1
32719	217791	4	1	0	0	0	1
32719	291836	4	1	1	0	0	2
32719	406904	4	1	0	0	0	1
32719	406906	4	0	2	0	0	2
32719	406908	4	1	2	0	0	3
32719	432760	4	0	1	0	0	1
32719	432770	4	2	0	0	0	2
32719	432783	4	0	0	1	0	1
32719	432791	4	0	0	0	0	0
32719	432792	4	0	2	0	0	2
32719	432794	4	1	2	0	0	3
32719	432800	4	2	1	1	1	5
32719	432811	4	0	0	0	0	0
32719	432812	4	1	1	0	0	2
32719	432821	4	0	0	0	0	0
32719	432826	4	1	0	0	0	1
32719	432827	4	1	0	0	0	1
32719	432835	4	1	1	0	1	3
32719	432844	4	2	0	0	0	2
32719	432845	4	2	0	0	0	2
32719	432846	4	1	1	0	0	2
32719	432858	4	1	0	0	0	1
32719	432859	4	0	0	0	0	0
32719	432862	4	0	1	0	0	1
32719	432866	4	1	1	0	1	3
32719	432869	4	0	1	1	1	3
32719	51508	4	0	2	0	0	2
32719	55734	4	0	0	0	0	0
32719	61861	4	2	0	0	0	2
32719	89001	4	1	1	0	0	2
32719	99207	4	0	1	1	0	2
32719	186902	3	0	0	0	0	0
32719	189645	3	1	0	0	0	1
32719	200116	3	1	3	1	1	6
32719	215891	3	0	2	0	0	2
32719	216618	3	2	2	0	0	4
32719	291837	3	0	1	0	0	1
32719	432755	3	0	1	0	1	2
32719	432757	3	0	1	0	0	1
32719	432761	3	0	0	0	0	0
32719	432764	3	1	0	0	0	1
32719	432772	3	0	2	0	2	4
32719	432773	3	1	0	0	0	1
32719	432781	3	2	0	0	0	2
32719	432790	3	0	0	0	0	0
32719	432796	3	0	0	0	0	0
32719	432801	3	0	0	0	0	0
32719	432814	3	0	0	0	0	0
32719	432831	3	0	1	0	0	1
32719	432833	3	0	1	0	0	1
32719	432840	3	0	0	0	0	0
32719	432842	3	1	0	0	0	1
32719	432851	3	1	0	0	0	1
32719	432852	3	0	0	0	0	0
32719	432853	3	2	0	0	0	2
32719	432860	3	0	0	0	0	0
32719	432861	3	0	1	0	0	1
32719	432868	3	0	1	0	0	1
32719	63739	3	0	1	0	0	1
32719	89631	3	1	1	1	0	3
32719	96426	3	0	1	1	0	2
32719	98044	3	0	0	0	0	0
32719	98194	3	1	0	0	2	3
32719	99735	3	0	1	0	0	1
32719	189808	2	1	1	0	0	2
32719	291838	2	0	1	0	0	1
32719	432763	2	0	0	0	0	0
32719	432765	2	0	1	0	0	1
32719	432768	2	0	0	0	0	0
32719	432769	2	1	2	0	0	3
32719	432774	2	0	2	0	0	2
32719	432776	2	0	0	0	0	0
32719	432780	2	1	1	1	0	3
32719	432784	2	0	0	0	0	0
32719	432785	2	2	1	0	0	3
32719	432795	2	0	2	0	0	2
32719	432808	2	0	0	0	0	0
32719	432820	2	0	1	0	0	1
32719	432823	2	1	1	0	0	2
32719	432834	2	0	0	0	0	0
32719	432836	2	2	1	0	0	3
32719	432855	2	0	0	0	0	0
32719	432864	2	0	1	0	0	1
32719	432870	2	0	0	0	1	1
32719	432871	2	1	2	0	1	4
32719	432874	2	0	0	0	0	0
32719	73077	2	0	1	0	2	3
32719	87307	2	0	1	0	0	1
32719	87336	2	0	0	1	0	1
32719	89151	2	1	0	0	0	1
32719	96231	2	0	1	0	0	1
32719	183834	1	0	1	1	0	2
32719	201309	1	1	1	0	0	2
32719	215758	1	0	1	0	0	1
32719	432754	1	0	0	0	0	0
32719	432756	1	0	1	0	0	1
32719	432758	1	0	2	0	0	2
32719	432762	1	3	3	1	1	8
32719	432787	1	0	0	0	0	0
32719	432799	1	0	1	0	1	2
32719	432802	1	0	0	0	0	0
32719	432819	1	0	0	0	0	0
32719	432829	1	0	1	0	0	1
32719	432837	1	0	0	0	0	0
32719	432848	1	0	0	0	0	0
58654	68673	59	7	2	0	9	18
58654	198769	42	6	3	0	2	11
58654	298602	42	6	3	0	2	11
58654	74504	42	6	3	0	2	11
58654	190208	38	1	3	0	2	6
58654	96098	37	2	1	1	5	9
58654	543955	29	5	2	0	0	7
58654	73034	29	1	5	0	2	8
58654	215533	23	1	2	1	6	10
58654	198198	22	0	3	3	5	11
58654	298609	22	1	2	1	6	10
58654	65268	22	0	1	1	3	5
58654	95207	22	1	2	1	6	10
58654	298601	21	0	3	3	5	11
58654	51397	21	0	3	3	5	11
58654	543943	21	2	2	0	7	11
58654	543946	21	0	3	3	5	11
58654	58902	21	1	3	0	3	7
58654	187661	20	1	3	0	3	7
58654	106237	16	0	0	0	0	0
58654	211465	16	2	0	1	4	7
58654	219651	16	0	0	0	0	0
58654	543983	16	0	1	1	4	6
58654	543984	16	0	1	1	4	6
58654	543985	16	0	1	1	4	6
58654	543986	16	0	1	1	4	6
58654	55203	16	0	1	1	2	4
58654	219751	15	1	0	3	4	8
58654	543960	15	1	2	4	2	9
58654	543989	15	1	0	0	0	1
58654	544018	15	0	5	0	0	5
58654	543932	14	0	0	0	3	3
58654	195398	13	0	3	0	3	6
58654	543926	13	0	0	2	0	2
58654	543944	13	1	1	0	2	4
58654	543901	12	1	0	0	2	3
58654	213131	11	1	0	1	4	6
58654	543915	11	3	1	0	3	7
58654	543922	11	0	3	1	1	5
58654	543974	11	1	5	1	2	9
58654	544014	11	2	1	0	1	4
58654	191923	10	0	0	0	0	0
58654	543890	10	5	1	0	5	11
58654	543931	10	1	0	2	1	4
58654	543991	10	0	2	0	0	2
58654	543995	10	1	0	0	3	4
58654	544020	10	0	0	0	1	1
58654	183096	9	0	0	2	1	3
58654	188029	9	0	1	0	5	6
58654	298599	9	1	0	0	0	1
58654	298605	9	0	0	0	0	0
58654	298607	9	0	1	0	2	3
58654	298608	9	0	0	2	1	3
58654	543968	9	1	2	0	4	7
58654	543981	9	1	1	0	2	4
58654	543997	9	2	2	1	2	7
58654	64607	9	0	0	0	0	0
58654	80290	9	1	0	0	0	1
58654	195156	8	2	3	1	2	8
58654	213526	8	0	1	0	3	4
58654	298594	8	0	0	0	3	3
58654	543891	8	0	0	0	0	0
58654	543897	8	2	0	0	4	6
58654	543907	8	1	3	0	0	4
58654	543909	8	1	0	0	1	2
58654	543913	8	2	2	0	2	6
58654	543927	8	2	0	0	2	4
58654	543934	8	1	0	0	2	3
58654	543957	8	2	1	0	1	4
58654	543969	8	0	2	0	0	2
58654	543990	8	0	1	0	0	1
58654	544000	8	0	0	0	3	3
58654	544003	8	1	0	0	3	4
58654	55960	8	0	0	0	3	3
58654	108757	7	0	0	0	2	2
58654	186009	7	0	2	0	0	2
58654	298606	7	0	0	0	2	2
58654	543964	7	1	2	0	0	3
58654	543994	7	0	0	0	0	0
58654	544024	7	0	0	0	2	2
58654	74270	7	2	0	1	0	3
58654	197325	6	1	0	0	3	4
58654	543899	6	1	4	0	0	5
58654	543916	6	0	1	1	0	2
58654	543918	6	0	0	0	0	0
58654	543923	6	3	1	0	0	4
58654	543945	6	0	0	0	2	2
58654	543956	6	0	0	0	0	0
58654	543961	6	0	0	0	0	0
58654	543970	6	1	1	1	0	3
58654	543972	6	0	1	0	1	2
58654	544006	6	0	2	0	1	3
58654	544007	6	0	2	0	1	3
58654	544011	6	1	2	0	2	5
58654	544023	6	2	2	0	2	6
58654	298603	5	0	0	0	2	2
58654	298604	5	1	0	0	3	4
58654	543893	5	0	0	0	1	1
58654	543900	5	0	0	0	2	2
58654	543914	5	1	0	3	1	5
58654	543921	5	1	0	1	0	2
58654	543924	5	1	0	0	2	3
58654	543949	5	0	0	2	0	2
58654	543952	5	0	2	0	1	3
58654	543958	5	0	0	0	3	3
58654	543962	5	2	0	0	2	4
58654	543967	5	0	0	1	0	1
58654	543975	5	0	1	1	2	4
58654	543976	5	0	1	1	4	6
58654	543999	5	3	1	0	0	4
58654	544016	5	0	0	0	0	0
58654	84738	5	1	0	0	3	4
58654	107753	4	0	0	0	6	6
58654	204140	4	0	0	0	1	1
58654	209488	4	0	1	1	1	3
58654	543902	4	0	0	1	0	1
58654	543903	4	1	0	0	0	1
58654	543910	4	0	1	0	2	3
58654	543912	4	0	0	0	0	0
58654	543920	4	1	1	1	0	3
58654	543925	4	0	1	0	1	2
58654	543928	4	0	0	0	1	1
58654	543935	4	0	0	0	2	2
58654	543936	4	1	0	1	1	3
58654	543937	4	0	0	0	0	0
58654	543940	4	1	0	1	1	3
58654	543942	4	1	1	0	0	2
58654	543947	4	2	1	1	2	6
58654	543977	4	2	1	0	1	4
58654	543979	4	1	2	1	4	8
58654	543982	4	1	2	2	0	5
58654	543998	4	0	1	0	0	1
58654	544004	4	0	0	1	1	2
58654	544008	4	1	0	1	0	2
58654	544013	4	0	1	0	1	2
58654	544017	4	2	0	0	0	2
58654	63575	4	0	0	0	1	1
58654	71984	4	0	0	0	0	0
58654	98630	4	0	0	2	0	2
58654	184972	3	1	0	0	0	1
58654	194676	3	1	0	0	1	2
58654	298595	3	0	0	0	3	3
58654	298598	3	1	0	1	0	2
58654	298600	3	0	0	0	1	1
58654	543892	3	0	1	0	0	1
58654	543894	3	0	0	1	0	1
58654	543904	3	1	0	0	0	1
58654	543917	3	2	2	0	1	5
58654	543930	3	0	0	0	0	0
58654	543941	3	1	1	0	0	2
58654	543950	3	0	0	0	0	0
58654	543951	3	2	1	0	0	3
58654	543954	3	0	0	0	0	0
58654	543959	3	0	0	0	1	1
58654	543971	3	0	0	0	1	1
58654	543980	3	1	1	0	1	3
58654	543987	3	0	1	0	1	2
58654	543988	3	3	1	0	0	4
58654	543993	3	0	0	0	0	0
58654	544005	3	0	0	0	0	0
58654	544009	3	1	1	0	1	3
58654	544015	3	0	4	0	0	4
58654	544019	3	0	1	2	0	3
58654	544022	3	1	0	0	3	4
58654	63727	3	5	3	0	4	12
58654	73858	3	1	0	0	1	2
58654	75044	3	0	0	0	0	0
58654	79325	3	0	0	0	3	3
58654	84491	3	0	0	0	1	1
58654	103621	2	0	1	0	1	2
58654	191010	2	0	0	0	1	1
58654	298596	2	0	0	0	1	1
58654	298597	2	0	1	0	3	4
58654	543887	2	0	1	0	1	2
58654	543895	2	0	0	0	1	1
58654	543896	2	0	0	0	0	0
58654	543898	2	0	0	0	1	1
58654	543905	2	0	0	0	1	1
58654	543906	2	1	0	0	0	1
58654	543908	2	0	3	0	2	5
58654	543911	2	0	1	0	1	2
58654	543919	2	1	0	0	0	1
58654	543938	2	0	2	0	1	3
58654	543939	2	0	1	0	6	7
58654	543948	2	1	0	0	0	1
58654	543953	2	0	1	0	1	2
58654	543963	2	0	2	0	1	3
58654	543966	2	2	1	0	0	3
58654	543973	2	1	0	0	0	1
58654	543978	2	1	1	0	1	3
58654	543996	2	1	0	0	2	3
58654	544001	2	0	0	0	0	0
58654	544002	2	0	2	0	2	4
58654	544010	2	0	0	0	0	0
58654	544012	2	0	0	0	1	1
58654	544021	2	0	0	0	1	1
58654	65348	2	1	0	0	0	1
58654	67961	2	0	1	0	3	4
58654	71501	2	0	0	0	1	1
58654	72857	2	0	0	0	0	0
58654	543888	1	1	1	0	0	2
58654	543889	1	1	0	0	0	1
58654	543929	1	0	2	0	1	3
58654	543933	1	0	0	0	0	0
58654	543965	1	0	0	0	3	3
58654	543992	1	0	0	0	0	0
58654	544025	1	0	0	0	1	1
17222	540569	49	2	4	3	1	10
17222	220404	46	2	2	3	5	12
17222	540547	46	2	2	3	5	12
17222	87017	45	1	9	2	6	18
17222	79756	44	2	9	2	1	14
17222	540556	42	0	0	0	2	2
17222	63787	40	0	2	1	1	4
17222	287678	38	1	6	1	5	13
17222	540563	38	1	9	2	6	18
17222	540512	37	0	2	1	1	4
17222	81718	37	0	1	0	4	5
17222	107634	36	1	2	3	4	10
17222	198778	35	3	3	5	2	13
17222	287673	35	3	3	5	2	13
17222	74351	35	3	3	5	2	13
17222	85482	35	2	3	3	0	8
17222	49705	33	2	2	1	2	7
17222	540522	32	1	0	3	0	4
17222	220942	28	4	1	0	2	7
17222	540561	28	4	1	0	2	7
17222	540562	28	1	2	0	0	3
17222	195673	27	2	0	1	4	7
17222	69360	27	2	0	1	4	7
17222	540543	26	1	0	2	1	4
17222	540568	26	1	1	3	3	8
17222	198100	25	2	1	3	1	7
17222	206992	25	3	0	2	0	5
17222	222243	25	2	1	0	4	7
17222	540558	25	3	0	2	0	5
17222	73693	25	2	1	3	1	7
17222	216516	24	4	3	4	2	13
17222	540505	24	2	1	0	4	7
17222	69903	24	3	1	1	0	5
17222	77496	24	1	0	1	3	5
17222	195881	23	3	2	1	0	6
17222	54026	23	4	8	1	7	20
17222	540584	23	2	1	3	0	6
17222	540593	23	2	1	1	0	4
17222	200570	22	2	4	0	1	7
17222	287672	22	2	4	0	1	7
17222	540535	22	1	0	1	0	2
17222	540551	22	2	4	0	1	7
17222	540570	22	1	2	1	2	6
17222	540582	22	3	2	1	0	6
17222	72507	22	4	1	1	0	6
17222	78735	22	2	4	0	1	7
17222	190161	21	1	0	2	2	5
17222	219856	21	3	0	2	2	7
17222	540549	21	3	3	4	2	12
17222	540565	21	2	1	0	2	5
17222	540574	21	4	0	0	3	7
17222	65411	21	2	1	3	0	6
17222	65611	21	2	1	0	2	5
17222	220076	20	2	1	0	0	3
17222	540537	20	0	7	1	6	14
17222	540539	20	3	1	0	0	4
17222	540579	20	0	0	1	0	1
17222	540592	20	3	0	2	2	7
17222	107418	19	0	2	0	0	2
17222	287669	19	1	3	4	3	11
17222	540538	19	1	3	4	3	11
17222	540546	19	0	2	0	0	2
17222	540554	19	1	1	2	1	5
17222	540557	19	1	3	0	2	6
17222	540588	19	2	1	0	1	4
17222	75068	19	1	1	2	1	5
17222	76518	19	1	3	4	3	11
17222	83720	19	1	3	0	2	6
17222	105826	18	1	0	0	0	1
17222	210788	18	2	2	1	1	6
17222	219415	18	1	0	0	0	1
17222	540585	18	1	1	0	2	4
17222	540591	18	1	0	0	0	1
17222	106879	17	0	1	0	1	2
17222	184837	17	3	3	1	1	8
17222	199182	17	1	3	0	0	4
17222	287674	17	2	3	0	3	8
17222	287677	17	3	3	1	1	8
17222	540509	17	1	2	0	3	6
17222	540524	17	1	3	0	0	4
17222	540532	17	4	3	0	0	7
17222	540559	17	2	3	0	3	8
17222	540578	17	2	2	3	1	8
17222	540590	17	3	3	1	1	8
17222	58707	17	1	0	0	0	1
17222	80694	17	2	3	0	3	8
17222	103310	16	1	1	1	0	3
17222	200347	16	3	1	0	1	5
17222	216615	16	1	1	1	0	3
17222	540571	16	1	1	1	0	3
17222	540589	16	0	0	1	1	2
17222	540595	16	3	2	0	1	6
17222	54148	16	3	3	1	1	8
17222	72045	16	0	1	0	0	1
17222	105596	15	3	2	1	0	6
17222	201806	15	0	2	0	0	2
17222	202099	15	3	2	3	2	10
17222	221540	15	1	3	0	0	4
17222	287667	15	3	3	1	3	10
17222	540507	15	3	1	0	1	5
17222	540529	15	0	4	4	5	13
17222	540536	15	0	0	0	3	3
17222	540564	15	2	3	1	4	10
17222	540575	15	2	0	1	1	4
17222	540581	15	2	0	5	0	7
17222	62794	15	2	5	1	2	10
17222	183017	14	1	3	3	0	7
17222	287670	14	1	3	3	0	7
17222	540531	14	0	1	1	0	2
17222	540541	14	1	4	0	1	6
17222	540560	14	3	0	0	2	5
17222	205486	13	3	0	5	3	11
17222	207380	13	1	1	1	0	3
17222	217716	13	0	0	0	0	0
17222	287675	13	0	1	2	1	4
17222	51788	13	2	1	0	4	7
17222	540550	13	2	1	0	4	7
17222	540596	13	0	3	1	0	4
17222	540597	13	3	0	5	3	11
17222	54366	13	0	1	1	0	2
17222	62171	13	0	1	2	1	4
17222	81225	13	0	3	1	0	4
17222	85420	13	3	0	5	3	11
17222	86723	13	1	1	1	0	3
17222	89283	13	0	4	1	1	6
17222	183956	12	1	4	3	1	9
17222	540508	12	1	1	3	4	9
17222	540553	12	1	3	1	1	6
17222	540573	12	1	1	0	0	2
17222	540598	12	2	1	0	1	4
17222	183992	11	2	2	0	1	5
17222	194338	11	1	0	0	0	1
17222	218833	11	2	3	2	1	8
17222	287671	11	1	0	0	0	1
17222	287676	11	1	1	1	2	5
17222	540534	11	2	4	0	2	8
17222	540540	11	0	2	0	1	3
17222	540552	11	0	0	0	0	0
17222	540586	11	0	0	0	1	1
17222	540594	11	2	0	1	4	7
17222	54466	11	1	1	1	2	5
17222	71223	11	1	0	0	0	1
17222	77572	11	2	3	2	1	8
17222	87338	11	2	1	3	0	6
17222	95285	11	1	1	0	0	2
17222	98713	11	2	2	0	4	8
17222	104937	10	0	0	1	1	2
17222	540500	10	2	0	1	0	3
17222	540510	10	1	0	1	2	4
17222	540513	10	1	0	2	3	6
17222	540516	10	2	1	0	1	4
17222	540518	10	3	2	2	0	7
17222	540519	10	2	3	2	1	8
17222	540525	10	0	0	0	1	1
17222	540526	10	0	0	0	0	0
17222	540533	10	2	2	2	0	6
17222	540587	10	1	1	0	3	5
17222	57350	10	0	2	1	0	3
17222	183148	9	1	0	0	0	1
17222	193292	9	1	2	0	0	3
17222	207893	9	1	0	1	4	6
17222	287666	9	3	5	1	1	10
17222	50053	9	3	5	1	1	10
17222	52205	9	1	1	0	4	6
17222	540503	9	1	0	0	0	1
17222	540506	9	3	5	1	1	10
17222	540520	9	1	0	3	1	5
17222	540548	9	1	1	0	4	6
17222	540567	9	0	0	0	0	0
17222	540580	9	1	1	1	1	4
17222	67166	9	1	1	0	0	2
17222	91346	9	1	0	1	4	6
17222	194453	8	2	0	0	2	4
17222	287668	8	2	0	0	2	4
17222	49839	8	1	0	0	0	1
17222	540521	8	1	1	0	0	2
17222	540523	8	1	2	2	4	9
17222	540530	8	3	1	0	4	8
17222	540545	8	2	1	0	2	5
17222	540576	8	1	2	0	2	5
17222	540583	8	1	0	0	0	1
17222	88163	8	1	2	0	2	5
17222	91738	8	2	1	0	2	5
17222	540514	7	1	2	1	3	7
17222	540515	7	1	2	0	2	5
17222	540542	7	4	2	0	0	6
17222	540566	7	1	2	1	1	5
17222	540599	7	1	3	0	2	6
17222	77230	7	0	2	0	4	6
17222	92874	7	1	2	1	1	5
17222	540511	6	0	1	0	0	1
17222	540527	6	3	6	0	3	12
17222	540544	6	0	0	0	2	2
17222	540555	6	3	2	2	2	9
17222	540572	6	1	0	0	3	4
17222	540577	6	0	0	1	1	2
17222	208171	5	2	0	0	0	2
17222	204135	4	0	0	0	0	0
17222	540501	4	1	1	0	0	2
17222	540504	4	1	0	1	1	3
17222	540517	4	2	4	1	1	8
17222	205557	3	1	0	0	0	1
17222	540499	2	0	0	0	0	0
9668	83712	27	2	3	1	1	7
9668	108357	23	0	8	0	0	8
9668	66334	23	1	2	7	2	12
9668	54665	21	2	3	3	0	8
9668	83062	18	2	1	0	1	4
9668	505845	16	3	4	1	0	8
9668	505824	14	0	0	1	1	2
9668	49631	13	0	0	0	0	0
9668	505733	13	2	2	0	0	4
9668	84064	13	0	3	0	2	5
9668	98781	13	2	1	0	0	3
9668	505726	12	1	0	0	0	1
9668	505782	12	2	2	0	1	5
9668	505857	12	2	3	0	1	6
9668	95646	12	2	1	0	0	3
9668	505731	11	3	7	0	0	10
9668	94689	11	0	2	0	1	3
9668	505721	10	0	3	4	0	7
9668	505757	10	0	1	0	0	1
9668	505760	10	1	1	0	2	4
9668	505777	10	1	3	0	0	4
9668	505799	10	0	0	0	1	1
9668	505858	10	4	1	1	1	7
9668	65560	10	2	2	0	0	4
9668	100242	9	1	1	0	1	3
9668	108307	9	2	5	0	0	7
9668	285462	9	1	1	0	0	2
9668	505769	9	2	1	1	0	4
9668	57836	9	4	4	0	0	8
9668	74952	9	1	1	0	0	2
9668	103643	8	0	0	0	0	0
9668	505831	8	2	1	2	0	5
9668	505842	8	0	1	0	0	1
9668	67542	8	0	3	0	1	4
9668	505736	7	0	1	1	0	2
9668	505754	7	1	1	0	0	2
9668	505787	7	4	2	0	0	6
9668	505790	7	1	2	0	0	3
9668	505815	7	0	1	1	1	3
9668	505839	7	0	0	0	1	1
9668	505848	7	2	1	1	0	4
9668	505856	7	1	2	3	1	7
9668	56027	7	0	4	2	0	6
9668	66052	7	1	2	0	1	4
9668	73811	7	1	1	0	0	2
9668	195105	6	0	2	0	1	3
9668	199819	6	0	1	0	0	1
9668	505738	6	2	2	0	0	4
9668	505747	6	2	5	0	0	7
9668	505762	6	0	1	0	0	1
9668	505810	6	1	1	0	1	3
9668	505814	6	5	1	0	2	8
9668	505823	6	0	1	1	0	2
9668	505838	6	1	1	0	1	3
9668	505864	6	1	0	0	1	2
9668	56552	6	0	0	1	0	1
9668	62990	6	1	2	0	0	3
9668	98962	6	2	2	0	0	4
9668	199693	5	2	1	0	0	3
9668	202212	5	2	3	1	0	6
9668	209586	5	1	0	1	0	2
9668	505728	5	1	1	0	0	2
9668	505729	5	2	1	0	0	3
9668	505730	5	0	3	0	0	3
9668	505743	5	1	1	1	0	3
9668	505748	5	1	1	1	0	3
9668	505758	5	1	1	0	0	2
9668	505759	5	0	1	0	0	1
9668	505761	5	0	1	0	0	1
9668	505765	5	1	1	0	0	2
9668	505766	5	0	2	0	1	3
9668	505770	5	1	0	0	1	2
9668	505772	5	1	2	0	1	4
9668	505774	5	0	0	0	0	0
9668	505786	5	0	1	1	0	2
9668	505798	5	1	1	0	0	2
9668	505802	5	2	0	0	0	2
9668	505812	5	1	1	0	0	2
9668	505826	5	3	0	0	0	3
9668	505832	5	1	2	2	0	5
9668	505847	5	1	1	0	0	2
9668	505849	5	1	0	0	0	1
9668	505852	5	0	0	0	0	0
9668	505853	5	0	0	0	0	0
9668	505854	5	2	0	1	0	3
9668	505860	5	0	4	0	1	5
9668	505862	5	1	1	0	0	2
9668	505865	5	2	2	1	0	5
9668	505866	5	0	2	2	0	4
9668	505868	5	3	1	1	1	6
9668	51212	5	1	0	0	0	1
9668	56446	5	0	1	0	0	1
9668	97405	5	0	0	0	0	0
9668	102292	4	0	1	0	0	1
9668	201227	4	2	1	0	0	3
9668	505737	4	0	4	0	0	4
9668	505741	4	0	2	0	1	3
9668	505745	4	1	0	0	0	1
9668	505749	4	1	0	0	0	1
9668	505753	4	0	1	0	0	1
9668	505784	4	2	1	0	0	3
9668	505785	4	1	2	0	0	3
9668	505789	4	1	2	0	1	4
9668	505792	4	0	3	0	0	3
9668	505803	4	0	0	0	0	0
9668	505816	4	0	2	0	2	4
9668	505827	4	2	0	0	0	2
9668	505837	4	1	0	0	1	2
9668	505855	4	4	0	1	0	5
9668	81696	4	0	1	0	2	3
9668	189809	3	0	2	0	0	2
9668	195974	3	0	1	0	0	1
9668	199962	3	0	0	0	0	0
9668	206490	3	0	0	2	0	2
9668	216022	3	3	0	1	0	4
9668	217935	3	0	1	0	0	1
9668	285463	3	0	1	0	0	1
9668	505735	3	1	1	0	0	2
9668	505746	3	1	2	0	0	3
9668	505750	3	0	3	0	0	3
9668	505751	3	0	1	0	0	1
9668	505752	3	0	2	0	0	2
9668	505755	3	0	0	0	0	0
9668	505756	3	1	1	0	0	2
9668	505763	3	1	0	0	0	1
9668	505764	3	2	1	0	1	4
9668	505767	3	1	1	0	1	3
9668	505771	3	1	2	0	0	3
9668	505778	3	4	1	0	0	5
9668	505779	3	2	2	0	0	4
9668	505780	3	2	1	0	0	3
9668	505781	3	2	1	0	0	3
9668	505788	3	1	0	0	1	2
9668	505793	3	1	1	0	0	2
9668	505795	3	0	1	0	0	1
9668	505796	3	1	0	0	1	2
9668	505800	3	1	1	0	0	2
9668	505806	3	0	0	0	1	1
9668	505807	3	0	0	0	0	0
9668	505808	3	1	2	0	0	3
9668	505809	3	0	3	0	0	3
9668	505813	3	1	0	0	0	1
9668	505817	3	0	0	0	0	0
9668	505818	3	1	1	0	0	2
9668	505819	3	0	0	0	2	2
9668	505821	3	0	4	0	0	4
9668	505830	3	0	0	3	0	3
9668	505833	3	1	0	0	0	1
9668	505834	3	0	0	0	0	0
9668	505841	3	1	2	0	0	3
9668	505843	3	1	0	0	0	1
9668	505850	3	0	2	0	0	2
9668	505867	3	1	0	0	0	1
9668	59306	3	0	0	0	0	0
9668	189646	2	2	1	0	0	3
9668	210776	2	1	1	0	0	2
9668	214036	2	1	0	0	0	1
9668	214310	2	0	1	1	0	2
9668	505720	2	0	0	0	0	0
9668	505723	2	0	1	0	0	1
9668	505724	2	1	1	0	0	2
9668	505732	2	0	1	0	0	1
9668	505734	2	0	2	0	0	2
9668	505744	2	0	2	0	1	3
9668	505768	2	0	0	0	0	0
9668	505773	2	2	2	0	0	4
9668	505776	2	2	0	0	0	2
9668	505783	2	0	0	0	0	0
9668	505794	2	0	1	0	0	1
9668	505801	2	0	0	0	2	2
9668	505804	2	1	1	0	1	3
9668	505805	2	1	0	0	0	1
9668	505811	2	0	1	0	1	2
9668	505820	2	0	1	0	0	1
9668	505822	2	1	0	0	0	1
9668	505829	2	0	0	0	0	0
9668	505835	2	0	0	0	0	0
9668	505836	2	0	0	0	0	0
9668	505840	2	2	0	0	0	2
9668	505846	2	0	0	0	0	0
9668	505851	2	1	1	0	0	2
9668	505859	2	0	0	0	0	0
9668	505863	2	0	1	0	0	1
9668	67986	2	1	3	0	0	4
9668	191189	1	0	1	0	0	1
9668	195930	1	0	0	0	0	0
9668	200117	1	0	1	0	0	1
9668	206410	1	0	1	0	0	1
9668	216593	1	0	0	0	0	0
9668	217286	1	0	0	0	0	0
9668	221910	1	1	1	0	0	2
9668	505722	1	0	1	0	0	1
9668	505725	1	0	1	0	0	1
9668	505727	1	2	1	1	0	4
9668	505739	1	0	0	0	0	0
9668	505740	1	0	1	1	0	2
9668	505742	1	0	0	0	0	0
9668	505775	1	1	0	0	0	1
9668	505791	1	0	0	0	0	0
9668	505797	1	1	1	0	0	2
9668	505825	1	0	0	0	0	0
9668	505828	1	0	1	0	0	1
9668	505844	1	1	0	0	0	1
9668	505861	1	0	0	0	0	0
56520	401109	14	3	1	0	0	4
56520	401052	12	1	2	0	0	3
56520	401137	11	1	1	0	0	2
56520	401044	10	2	1	0	0	3
56520	401112	10	6	0	0	0	6
56520	401046	9	3	3	1	0	7
56520	401030	8	1	2	1	0	4
56520	401068	8	1	1	0	0	2
56520	401135	8	4	1	0	0	5
56520	401041	7	4	0	0	0	4
56520	401043	7	2	2	1	1	6
56520	401047	7	1	2	0	0	3
56520	401116	7	1	1	0	0	2
56520	401125	7	0	3	0	0	3
56520	401127	7	4	3	0	1	8
56520	401140	7	2	7	0	1	10
56520	401144	7	1	0	0	0	1
56520	401151	7	0	2	0	1	3
56520	401160	7	2	0	0	0	2
56520	401167	7	4	0	0	0	4
56520	401194	7	2	0	0	0	2
56520	401203	7	3	2	0	0	5
56520	401210	7	2	0	0	2	4
56520	401034	6	5	0	0	0	5
56520	401038	6	1	0	0	0	1
56520	401039	6	1	0	0	0	1
56520	401055	6	4	1	0	0	5
56520	401067	6	0	0	0	0	0
56520	401086	6	3	0	0	0	3
56520	401102	6	0	1	0	0	1
56520	401118	6	2	1	0	0	3
56520	401131	6	1	0	0	0	1
56520	401146	6	5	0	0	0	5
56520	401155	6	0	2	0	0	2
56520	401159	6	2	1	0	0	3
56520	401172	6	3	1	1	0	5
56520	401173	6	3	0	0	0	3
56520	401182	6	0	2	0	1	3
56520	401185	6	3	2	0	1	6
56520	401198	6	0	1	0	1	2
56520	401204	6	2	2	0	0	4
56520	216373	5	2	1	0	1	4
56520	401031	5	2	1	1	0	4
56520	401042	5	0	1	0	0	1
56520	401054	5	1	1	0	0	2
56520	401056	5	1	0	0	0	1
56520	401063	5	0	2	0	0	2
56520	401071	5	2	3	0	1	6
56520	401075	5	1	2	0	1	4
56520	401088	5	2	2	0	0	4
56520	401111	5	3	0	0	2	5
56520	401115	5	1	0	0	0	1
56520	401147	5	3	0	0	0	3
56520	401152	5	6	0	0	1	7
56520	401154	5	2	0	0	0	2
56520	401164	5	6	2	0	0	8
56520	401176	5	2	0	0	0	2
56520	401183	5	0	0	0	0	0
56520	401184	5	1	0	0	0	1
56520	401190	5	5	0	0	0	5
56520	401192	5	2	1	0	0	3
56520	401196	5	2	0	0	0	2
56520	401200	5	2	0	0	1	3
56520	401202	5	2	2	0	0	4
56520	401205	5	1	1	0	0	2
56520	401209	5	5	1	0	1	7
56520	401218	5	0	0	0	0	0
56520	183476	4	1	2	0	0	3
56520	281312	4	1	1	0	2	4
56520	401029	4	2	0	0	1	3
56520	401032	4	1	0	0	0	1
56520	401033	4	1	1	0	0	2
56520	401036	4	2	0	0	0	2
56520	401040	4	2	0	0	0	2
56520	401045	4	2	0	0	0	2
56520	401060	4	1	5	0	1	7
56520	401061	4	2	1	0	0	3
56520	401062	4	3	1	0	0	4
56520	401064	4	4	1	0	0	5
56520	401066	4	1	0	0	0	1
56520	401069	4	1	0	0	0	1
56520	401073	4	0	0	0	0	0
56520	401087	4	3	0	0	0	3
56520	401099	4	2	1	0	0	3
56520	401104	4	1	2	0	0	3
56520	401108	4	1	1	0	1	3
56520	401110	4	0	2	0	2	4
56520	401114	4	1	2	0	0	3
56520	401117	4	0	0	0	0	0
56520	401119	4	4	0	0	1	5
56520	401123	4	4	0	0	0	4
56520	401124	4	0	0	0	1	1
56520	401134	4	2	0	0	0	2
56520	401142	4	1	0	0	0	1
56520	401143	4	2	0	0	0	2
56520	401148	4	1	1	0	0	2
56520	401149	4	1	0	0	0	1
56520	401157	4	2	0	0	0	2
56520	401166	4	0	0	1	0	1
56520	401171	4	0	0	0	0	0
56520	401175	4	2	0	0	0	2
56520	401177	4	1	0	0	0	1
56520	401180	4	3	0	0	1	4
56520	401189	4	1	3	0	1	5
56520	401199	4	2	1	0	0	3
56520	401212	4	3	0	0	0	3
56520	401220	4	2	1	0	0	3
56520	186362	3	1	0	0	1	2
56520	281313	3	0	1	0	0	1
56520	401035	3	0	1	0	0	1
56520	401037	3	2	1	0	1	4
56520	401053	3	0	0	0	0	0
56520	401057	3	0	0	0	0	0
56520	401059	3	0	1	0	0	1
56520	401072	3	0	2	0	0	2
56520	401076	3	0	1	0	0	1
56520	401077	3	0	1	0	1	2
56520	401078	3	2	1	0	0	3
56520	401079	3	4	1	0	0	5
56520	401081	3	1	2	0	1	4
56520	401083	3	0	2	0	0	2
56520	401085	3	1	1	0	1	3
56520	401093	3	1	1	0	0	2
56520	401096	3	1	0	0	0	1
56520	401098	3	0	0	0	1	1
56520	401101	3	2	0	0	0	2
56520	401105	3	1	1	0	0	2
56520	401106	3	1	1	0	0	2
56520	401107	3	1	1	0	0	2
56520	401120	3	1	0	0	0	1
56520	401121	3	1	1	0	0	2
56520	401122	3	1	0	0	0	1
56520	401126	3	0	0	0	0	0
56520	401128	3	2	1	0	0	3
56520	401129	3	2	2	0	1	5
56520	401130	3	2	0	0	0	2
56520	401136	3	2	0	0	0	2
56520	401139	3	0	1	0	0	1
56520	401145	3	3	0	0	0	3
56520	401153	3	1	1	0	0	2
56520	401158	3	0	1	0	0	1
56520	401162	3	0	2	0	0	2
56520	401163	3	1	0	0	0	1
56520	401170	3	0	0	0	0	0
56520	401178	3	2	0	0	0	2
56520	401187	3	0	1	0	0	1
56520	401191	3	1	0	0	0	1
56520	401193	3	2	0	0	0	2
56520	401206	3	2	1	0	0	3
56520	401208	3	1	2	0	0	3
56520	401211	3	0	0	0	0	0
56520	401215	3	2	0	0	0	2
56520	401216	3	0	0	0	0	0
56520	401219	3	2	0	0	0	2
56520	195925	2	1	1	0	0	2
56520	198258	2	0	0	0	1	1
56520	281314	2	1	0	0	1	2
56520	401051	2	1	1	0	0	2
56520	401058	2	2	0	0	0	2
56520	401065	2	2	0	0	0	2
56520	401070	2	1	1	0	0	2
56520	401074	2	1	2	0	0	3
56520	401080	2	0	0	0	0	0
56520	401082	2	2	0	0	1	3
56520	401089	2	0	0	0	0	0
56520	401091	2	4	1	0	0	5
56520	401092	2	2	0	1	0	3
56520	401095	2	0	0	0	0	0
56520	401097	2	2	0	0	0	2
56520	401100	2	0	0	0	0	0
56520	401113	2	3	1	0	0	4
56520	401132	2	0	0	0	1	1
56520	401133	2	1	3	0	1	5
56520	401138	2	1	1	0	0	2
56520	401141	2	1	0	0	0	1
56520	401150	2	2	1	0	0	3
56520	401156	2	0	0	0	0	0
56520	401161	2	0	0	0	0	0
56520	401165	2	0	1	0	0	1
56520	401174	2	2	0	0	0	2
56520	401179	2	0	0	0	0	0
56520	401186	2	0	1	0	0	1
56520	401188	2	2	1	0	1	4
56520	401195	2	0	1	0	0	1
56520	401207	2	1	0	0	0	1
56520	401213	2	0	1	0	0	1
56520	401214	2	1	0	0	0	1
56520	211086	1	0	0	0	0	0
56520	401048	1	0	1	0	0	1
56520	401049	1	2	0	0	0	2
56520	401050	1	1	0	0	0	1
56520	401084	1	2	1	1	0	4
56520	401094	1	2	0	0	0	2
56520	401103	1	0	1	0	0	1
56520	401168	1	0	1	0	0	1
56520	401169	1	2	1	0	0	3
56520	401181	1	0	2	0	0	2
56520	401197	1	0	0	0	0	0
56520	401201	1	0	0	0	0	0
56520	401217	1	0	2	0	0	2
60368	202541	35	1	3	1	3	8
60368	299042	34	5	9	2	1	17
60368	522821	34	1	3	1	3	8
60368	522822	34	4	4	2	1	11
60368	210646	32	3	6	6	3	18
60368	522841	32	3	6	6	3	18
60368	186035	23	1	1	0	2	4
60368	193841	23	0	0	0	2	2
60368	220554	23	2	3	0	4	9
60368	522934	23	1	7	1	5	14
60368	220984	22	2	8	0	1	11
60368	299039	22	0	0	0	2	2
60368	218061	20	1	3	0	0	4
60368	211510	18	0	0	1	1	2
60368	522820	18	3	2	0	1	6
60368	522947	17	1	3	1	4	9
60368	522823	16	0	2	1	1	4
60368	522824	15	2	2	2	1	7
60368	522844	15	6	3	1	3	13
60368	522831	14	2	0	0	0	2
60368	195021	13	0	0	0	0	0
60368	522897	13	0	2	0	3	5
60368	522891	12	0	0	0	0	0
60368	522939	12	0	0	0	0	0
60368	212046	11	0	2	1	0	3
60368	522829	11	0	2	1	0	3
60368	522842	11	1	2	1	0	4
60368	522942	11	1	0	0	4	5
60368	183408	10	1	1	0	3	5
60368	183816	10	4	1	1	0	6
60368	188160	10	1	1	0	0	2
60368	211084	10	0	2	0	0	2
60368	299041	10	0	0	0	0	0
60368	522838	10	2	4	0	0	6
60368	184257	9	0	0	0	1	1
60368	522819	9	4	2	0	0	6
60368	522867	9	1	5	0	2	8
60368	522941	9	0	0	0	0	0
60368	194908	8	1	0	0	0	1
60368	299038	8	0	1	1	0	2
60368	522828	8	0	2	1	2	5
60368	522882	8	2	1	0	0	3
60368	202619	7	1	4	0	2	7
60368	217461	7	4	2	0	0	6
60368	522839	7	1	1	0	0	2
60368	522852	7	2	2	3	1	8
60368	522854	7	2	2	0	1	5
60368	522884	7	2	0	2	0	4
60368	522885	7	1	1	1	3	6
60368	522905	7	0	0	0	0	0
60368	522912	7	0	2	0	1	3
60368	522925	7	0	0	0	1	1
60368	522929	7	1	0	0	0	1
60368	522948	7	1	2	1	3	7
60368	192187	6	2	0	0	0	2
60368	197414	6	1	1	0	3	5
60368	211171	6	0	3	0	0	3
60368	212349	6	0	0	1	0	1
60368	299048	6	1	0	0	2	3
60368	522827	6	3	0	0	0	3
60368	522853	6	2	0	1	0	3
60368	522865	6	1	1	1	1	4
60368	522887	6	0	1	0	0	1
60368	522901	6	4	0	0	0	4
60368	522911	6	1	3	1	0	5
60368	192078	5	0	1	0	0	1
60368	193743	5	2	2	0	1	5
60368	194383	5	0	0	0	1	1
60368	198072	5	1	0	0	0	1
60368	199164	5	1	0	0	0	1
60368	199996	5	1	0	0	0	1
60368	210730	5	0	0	0	2	2
60368	522826	5	2	1	0	0	3
60368	522832	5	0	4	1	0	5
60368	522835	5	1	0	1	2	4
60368	522836	5	0	3	1	0	4
60368	522855	5	1	1	0	0	2
60368	522856	5	0	1	0	0	1
60368	522857	5	0	1	1	1	3
60368	522869	5	0	2	0	1	3
60368	522871	5	2	0	1	0	3
60368	522872	5	0	0	0	0	0
60368	522881	5	0	2	1	0	3
60368	522888	5	1	0	0	0	1
60368	522893	5	2	1	0	1	4
60368	522896	5	0	2	0	0	2
60368	522898	5	0	0	0	0	0
60368	522914	5	0	1	0	1	2
60368	522917	5	0	2	0	2	4
60368	522926	5	0	1	1	0	2
60368	522932	5	2	1	0	0	3
60368	522935	5	1	0	0	1	2
60368	522938	5	0	0	0	0	0
60368	522940	5	2	1	0	0	3
60368	522944	5	1	0	0	0	1
60368	522945	5	0	0	0	0	0
60368	522946	5	1	1	0	0	2
60368	522951	5	1	0	1	2	4
60368	187019	4	0	1	1	0	2
60368	192470	4	0	1	1	1	3
60368	192713	4	0	0	0	0	0
60368	196848	4	0	1	1	0	2
60368	199982	4	0	0	0	0	0
60368	202730	4	1	1	0	0	2
60368	207731	4	1	0	0	0	1
60368	217684	4	1	3	0	0	4
60368	299040	4	1	1	0	1	3
60368	299043	4	1	1	0	0	2
60368	446882	4	3	0	0	0	3
60368	522817	4	0	0	0	0	0
60368	522833	4	0	1	0	0	1
60368	522849	4	0	0	1	0	1
60368	522850	4	1	1	0	1	3
60368	522858	4	1	2	0	0	3
60368	522866	4	2	0	0	0	2
60368	522874	4	1	1	0	0	2
60368	522875	4	1	0	0	0	1
60368	522877	4	0	0	0	0	0
60368	522895	4	2	2	0	0	4
60368	522904	4	0	0	0	0	0
60368	522906	4	1	1	1	0	3
60368	522916	4	0	0	0	0	0
60368	522918	4	1	0	0	0	1
60368	522923	4	0	0	0	1	1
60368	522927	4	0	0	1	3	4
60368	522930	4	1	0	0	0	1
60368	522933	4	0	1	0	0	1
60368	522943	4	0	0	0	0	0
60368	522950	4	1	0	0	0	1
60368	186980	3	0	0	0	2	2
60368	193578	3	2	0	0	0	2
60368	200900	3	1	0	0	0	1
60368	201268	3	0	1	0	1	2
60368	201375	3	2	0	0	0	2
60368	211089	3	0	0	0	0	0
60368	215251	3	1	0	0	0	1
60368	216553	3	0	1	0	0	1
60368	217698	3	1	2	0	0	3
60368	220595	3	1	1	0	1	3
60368	299044	3	0	0	0	0	0
60368	299045	3	0	0	0	0	0
60368	299047	3	0	2	0	0	2
60368	522825	3	0	0	0	0	0
60368	522830	3	1	0	0	0	1
60368	522834	3	2	0	0	1	3
60368	522837	3	0	1	0	0	1
60368	522840	3	0	2	1	0	3
60368	522843	3	0	3	0	0	3
60368	522847	3	3	0	0	0	3
60368	522864	3	1	2	0	0	3
60368	522868	3	0	0	0	1	1
60368	522870	3	0	0	0	0	0
60368	522879	3	1	0	0	1	2
60368	522883	3	0	0	0	1	1
60368	522886	3	0	0	0	0	0
60368	522890	3	1	1	0	2	4
60368	522894	3	0	0	0	0	0
60368	522899	3	1	0	0	0	1
60368	522900	3	0	0	1	0	1
60368	522903	3	0	0	0	0	0
60368	522909	3	0	0	0	0	0
60368	522913	3	1	1	0	2	4
60368	522915	3	2	0	0	0	2
60368	522919	3	0	0	1	1	2
60368	522920	3	1	1	1	0	3
60368	522922	3	0	1	0	0	1
60368	522924	3	1	0	0	0	1
60368	522928	3	0	0	0	0	0
60368	522936	3	1	0	0	0	1
60368	522937	3	2	0	0	0	2
60368	187141	2	1	0	0	0	1
60368	195945	2	0	1	0	0	1
60368	200099	2	2	1	0	0	3
60368	208827	2	0	2	0	0	2
60368	208828	2	0	2	0	0	2
60368	299037	2	0	2	0	0	2
60368	522818	2	1	0	0	0	1
60368	522845	2	0	1	0	0	1
60368	522846	2	1	1	0	1	3
60368	522848	2	0	0	0	0	0
60368	522851	2	1	0	0	0	1
60368	522876	2	0	0	0	0	0
60368	522878	2	0	0	0	0	0
60368	522880	2	2	0	0	0	2
60368	522889	2	0	1	1	0	2
60368	522892	2	0	0	0	0	0
60368	522907	2	0	0	0	0	0
60368	522908	2	1	1	0	0	2
60368	522910	2	1	2	1	0	4
60368	522921	2	0	0	1	1	2
60368	522949	2	1	0	0	0	1
60368	208829	1	0	0	0	0	0
60368	299046	1	0	0	0	0	0
60368	465606	1	1	0	0	0	1
60368	522861	1	0	0	0	0	0
60368	522863	1	0	0	0	0	0
60368	522873	1	2	0	0	0	2
60368	522902	1	0	0	0	1	1
60368	522931	1	1	0	0	0	1
61489	198822	49	2	8	5	1	16
61489	282064	49	2	8	5	1	16
61489	74513	49	2	8	5	1	16
61489	210286	43	3	5	0	2	10
61489	282082	31	3	5	0	0	8
61489	467202	30	3	5	0	0	8
61489	186192	26	1	4	0	1	6
61489	282075	25	3	4	1	2	10
61489	282092	25	1	4	0	1	6
61489	56731	25	1	4	0	1	6
61489	85609	23	0	6	3	1	10
61489	97798	21	3	5	0	0	8
61489	77002	20	3	3	0	0	6
61489	85972	19	2	4	1	0	7
61489	217614	16	0	3	0	1	4
61489	467197	16	3	6	1	3	13
61489	57101	16	3	6	1	3	13
61489	467187	14	0	2	0	1	3
61489	85591	14	3	0	0	1	4
61489	91846	13	0	2	0	1	3
61489	184056	12	0	5	1	0	6
61489	282093	12	0	5	1	0	6
61489	467206	12	0	5	1	0	6
61489	52295	12	0	5	1	0	6
61489	51293	11	1	3	0	0	4
61489	203490	10	5	4	0	0	9
61489	216631	10	1	2	0	4	7
61489	282050	10	4	2	0	1	7
61489	282080	10	1	7	0	0	8
61489	282090	10	0	3	0	0	3
61489	467201	10	1	7	0	0	8
61489	54311	10	1	7	0	0	8
61489	74036	10	4	3	0	1	8
61489	101553	9	2	3	0	1	6
61489	185665	9	0	1	2	0	3
61489	197343	9	1	2	0	2	5
61489	214814	9	2	3	0	1	6
61489	282049	9	0	3	0	0	3
61489	282052	9	4	3	1	1	9
61489	282067	9	1	6	0	0	7
61489	282072	9	2	0	2	0	4
61489	282087	9	0	5	1	1	7
61489	282091	9	2	3	0	1	6
61489	282095	9	1	2	0	2	5
61489	467176	9	1	6	0	1	8
61489	467199	9	1	2	0	4	7
61489	65885	9	1	2	0	4	7
61489	199949	8	1	0	0	0	1
61489	208215	8	1	1	2	2	6
61489	211029	8	0	3	1	0	4
61489	211285	8	0	1	1	1	3
61489	217102	8	2	5	0	0	7
61489	220898	8	1	3	2	1	7
61489	282055	8	1	0	0	0	1
61489	282068	8	1	1	2	2	6
61489	282085	8	2	1	0	2	5
61489	467185	8	0	0	1	0	1
61489	467186	8	1	0	0	0	1
61489	467204	8	0	5	1	1	7
61489	467205	8	0	2	0	0	2
61489	82030	8	1	3	1	0	5
61489	187839	7	1	1	0	1	3
61489	188698	7	1	4	2	0	7
61489	193213	7	1	1	0	2	4
61489	194751	7	0	3	0	0	3
61489	209791	7	2	2	0	1	5
61489	282059	7	1	3	0	0	4
61489	282065	7	1	3	1	2	7
61489	282081	7	1	4	2	0	7
61489	282097	7	0	0	0	0	0
61489	467178	7	0	3	1	0	4
61489	467182	7	0	1	0	0	1
61489	467188	7	0	3	0	0	3
61489	51554	7	0	4	2	1	7
61489	55519	7	0	3	1	0	4
61489	59939	7	1	4	2	0	7
61489	70092	7	0	2	1	0	3
61489	82302	7	2	0	0	0	2
61489	183756	6	1	1	0	4	6
61489	184272	6	0	3	1	0	4
61489	188361	6	3	1	3	1	8
61489	192674	6	0	2	0	1	3
61489	203750	6	2	2	0	0	4
61489	207370	6	0	3	1	0	4
61489	215093	6	0	0	0	0	0
61489	282070	6	0	3	0	0	3
61489	282089	6	1	3	0	0	4
61489	467180	6	0	2	0	3	5
61489	63626	6	3	0	2	0	5
61489	78823	6	0	0	0	1	1
61489	104731	5	0	0	0	0	0
61489	188299	5	0	2	1	2	5
61489	196027	5	0	0	0	1	1
61489	203999	5	2	1	0	0	3
61489	204275	5	0	3	0	0	3
61489	210011	5	2	0	1	0	3
61489	220314	5	0	1	0	1	2
61489	282051	5	1	1	0	0	2
61489	282053	5	0	3	1	2	6
61489	282056	5	1	3	0	0	4
61489	282069	5	0	2	0	1	3
61489	282071	5	2	0	1	0	3
61489	282076	5	0	3	0	0	3
61489	282077	5	1	1	0	2	4
61489	282094	5	0	2	0	0	2
61489	467174	5	0	1	1	0	2
61489	467183	5	2	3	0	0	5
61489	467189	5	1	2	0	0	3
61489	467193	5	1	1	2	0	4
61489	68793	5	0	1	1	0	2
61489	98862	5	1	2	1	3	7
61489	108433	4	1	4	1	1	7
61489	184059	4	0	0	0	1	1
61489	185719	4	0	4	0	0	4
61489	185926	4	0	0	0	0	0
61489	188984	4	0	4	0	0	4
61489	192384	4	1	1	0	1	3
61489	192612	4	1	1	0	2	4
61489	193468	4	0	3	0	1	4
61489	193659	4	0	1	0	1	2
61489	194397	4	0	2	1	1	4
61489	195711	4	1	2	0	0	3
61489	196702	4	0	4	0	2	6
61489	201250	4	1	2	0	0	3
61489	211792	4	0	1	0	1	2
61489	213544	4	1	0	0	0	1
61489	213819	4	0	2	0	0	2
61489	218680	4	0	2	0	1	3
61489	221511	4	0	1	0	2	3
61489	282062	4	0	1	0	0	1
61489	282073	4	1	1	2	0	4
61489	282086	4	0	0	0	0	0
61489	282088	4	3	1	0	0	4
61489	282100	4	0	1	0	0	1
61489	467173	4	2	0	0	0	2
61489	467175	4	1	1	0	0	2
61489	467184	4	2	2	0	1	5
61489	467194	4	0	0	0	1	1
61489	467196	4	0	3	2	2	7
61489	467198	4	2	1	0	1	4
61489	467200	4	0	3	0	1	4
61489	467203	4	1	3	0	0	4
61489	56976	4	1	1	0	0	2
61489	65875	4	1	1	0	2	4
61489	66014	4	0	1	0	1	2
61489	66774	4	0	3	0	1	4
61489	79525	4	1	2	0	0	3
61489	85060	4	1	0	0	0	1
61489	182285	3	1	0	0	0	1
61489	187837	3	0	1	1	0	2
61489	196385	3	0	0	0	1	1
61489	205374	3	0	2	0	0	2
61489	207050	3	1	2	0	1	4
61489	207498	3	0	2	0	0	2
61489	208063	3	1	0	0	0	1
61489	210345	3	1	2	0	1	4
61489	218416	3	0	2	0	0	2
61489	282047	3	1	1	0	0	2
61489	282048	3	0	0	0	0	0
61489	282060	3	0	2	0	0	2
61489	282061	3	0	2	0	0	2
61489	282063	3	0	1	0	0	1
61489	282074	3	0	1	0	0	1
61489	282079	3	0	3	0	2	5
61489	282083	3	0	0	0	0	0
61489	282084	3	1	3	0	0	4
61489	282096	3	0	0	0	0	0
61489	467179	3	2	2	0	1	5
61489	467181	3	2	2	0	0	4
61489	467192	3	0	0	0	0	0
61489	467195	3	1	1	0	3	5
61489	186496	2	1	2	0	0	3
61489	187219	2	1	2	0	1	4
61489	188429	2	0	0	0	0	0
61489	200230	2	0	1	0	2	3
61489	209806	2	0	1	0	0	1
61489	219890	2	0	1	0	0	1
61489	282098	2	0	0	0	0	0
61489	282099	2	1	0	0	0	1
61489	467207	2	1	2	0	0	3
61489	81791	2	0	0	0	0	0
61489	85587	2	1	2	0	2	5
61489	185316	1	1	1	0	0	2
61489	186658	1	1	0	0	0	1
61489	190031	1	0	0	0	0	0
61489	208571	1	1	0	0	0	1
61489	209804	1	0	0	0	1	1
61489	282054	1	0	1	0	0	1
61489	282066	1	0	0	0	2	2
61489	282078	1	1	3	1	2	7
61489	467177	1	3	2	0	0	5
61489	467190	1	0	2	0	1	3
61489	467191	1	0	2	0	0	2
61489	54497	1	0	0	0	1	1
41080	72996	50	3	5	2	4	14
41080	72494	38	4	3	0	1	8
41080	87767	38	1	3	0	4	8
41080	380026	36	1	1	1	1	4
41080	68267	35	1	1	1	1	4
41080	77451	30	0	2	3	2	7
41080	294192	29	1	1	1	1	4
41080	50370	29	1	1	1	1	4
41080	62427	28	2	3	0	5	10
41080	64969	28	3	2	2	3	10
41080	294193	27	3	2	2	3	10
41080	294185	25	2	0	0	0	2
41080	294189	25	1	0	0	0	1
41080	73319	25	1	0	0	0	1
41080	90489	25	2	0	0	0	2
41080	294188	23	2	0	1	0	3
41080	56110	23	2	0	1	0	3
41080	88005	22	2	4	0	5	11
41080	85959	20	4	4	0	0	8
41080	294190	19	1	2	0	1	4
41080	106832	18	0	1	0	2	3
41080	49275	18	3	1	0	3	7
41080	92577	17	0	1	0	1	2
41080	94372	15	2	3	1	3	9
41080	95324	15	1	3	0	1	5
41080	294186	14	4	0	0	0	4
41080	80267	14	4	0	0	0	4
41080	95685	14	2	2	0	2	6
41080	294194	13	1	1	0	4	6
41080	191144	12	0	0	0	2	2
41080	219257	12	3	0	0	0	3
41080	294187	12	0	0	0	2	2
41080	55184	12	4	1	2	3	10
41080	63620	12	0	0	0	2	2
41080	87445	12	3	1	2	5	11
41080	106079	11	3	0	0	0	3
41080	107064	10	1	2	0	5	8
41080	379994	10	0	0	0	1	1
41080	379995	9	1	0	1	3	5
41080	380014	9	0	2	2	0	4
41080	380024	9	1	2	1	0	4
41080	96443	9	3	3	1	1	8
41080	380000	8	0	1	0	3	4
41080	380018	8	0	1	0	3	4
41080	380033	8	0	0	0	0	0
41080	56543	8	1	0	1	3	5
41080	58924	8	5	4	0	2	11
41080	379911	7	0	3	0	0	3
41080	379943	7	1	0	1	0	2
41080	380013	7	1	0	0	5	6
41080	380028	7	2	1	0	0	3
41080	61142	7	0	3	0	1	4
41080	92982	7	0	1	0	0	1
41080	379941	6	4	0	0	1	5
41080	379951	6	1	0	0	1	2
41080	379953	6	0	2	0	2	4
41080	379978	6	2	2	0	0	4
41080	379993	6	3	0	1	0	4
41080	380011	6	0	0	0	0	0
41080	380021	6	2	3	0	2	7
41080	380034	6	2	0	0	2	4
41080	72392	6	0	2	0	4	6
41080	379921	5	1	1	0	1	3
41080	379931	5	0	3	0	1	4
41080	379964	5	1	0	0	0	1
41080	379969	5	0	1	0	0	1
41080	379970	5	0	1	0	0	1
41080	379977	5	0	2	1	3	6
41080	379983	5	1	0	0	2	3
41080	379986	5	2	1	0	0	3
41080	380016	5	2	2	0	3	7
41080	380023	5	2	3	0	1	6
41080	380030	5	0	1	0	1	2
41080	380031	5	1	3	0	3	7
41080	380035	5	0	1	0	0	1
41080	66624	5	1	1	0	2	4
41080	86620	5	0	1	1	3	5
41080	99967	5	0	0	0	1	1
41080	108675	4	0	0	0	0	0
41080	294182	4	1	1	0	1	3
41080	294183	4	1	1	1	0	3
41080	379920	4	0	0	0	0	0
41080	379923	4	1	1	0	1	3
41080	379925	4	0	1	1	0	2
41080	379942	4	1	1	0	0	2
41080	379948	4	0	2	0	2	4
41080	379955	4	0	0	0	2	2
41080	379957	4	0	0	1	3	4
41080	379962	4	1	0	0	2	3
41080	379963	4	1	0	0	3	4
41080	379968	4	2	0	0	0	2
41080	379985	4	0	1	0	1	2
41080	379988	4	1	1	3	1	6
41080	379997	4	0	2	0	1	3
41080	379999	4	0	0	0	0	0
41080	380002	4	1	1	0	0	2
41080	380004	4	1	2	0	3	6
41080	380005	4	0	0	0	2	2
41080	380006	4	1	0	0	1	2
41080	380012	4	1	1	0	1	3
41080	380038	4	2	1	0	4	7
41080	380039	4	0	0	0	0	0
41080	67754	4	1	1	0	2	4
41080	182183	3	1	0	0	0	1
41080	189271	3	0	0	0	2	2
41080	193615	3	1	2	0	1	4
41080	294184	3	1	0	1	0	2
41080	379915	3	1	4	0	1	6
41080	379927	3	0	1	0	0	1
41080	379928	3	0	1	0	0	1
41080	379939	3	1	1	0	1	3
41080	379946	3	0	0	0	2	2
41080	379959	3	2	1	0	2	5
41080	379965	3	1	1	0	0	2
41080	379967	3	1	0	1	2	4
41080	379973	3	2	1	0	0	3
41080	379975	3	1	0	0	1	2
41080	379976	3	1	2	0	1	4
41080	379979	3	1	0	0	1	2
41080	379984	3	0	0	0	2	2
41080	379987	3	0	0	1	0	1
41080	379990	3	0	3	0	2	5
41080	379992	3	0	2	0	2	4
41080	379998	3	1	1	1	1	4
41080	380008	3	1	1	0	1	3
41080	380015	3	1	0	0	0	1
41080	380019	3	0	1	0	3	4
41080	380022	3	0	1	0	1	2
41080	380025	3	1	0	0	1	2
41080	380029	3	1	3	0	2	6
41080	380032	3	1	1	0	1	3
41080	89221	3	1	1	0	0	2
41080	194926	2	0	0	0	0	0
41080	199125	2	0	0	0	1	1
41080	206956	2	0	0	0	1	1
41080	209765	2	0	0	0	1	1
41080	220157	2	0	1	0	1	2
41080	379909	2	0	0	0	2	2
41080	379917	2	0	0	1	2	3
41080	379930	2	0	0	0	1	1
41080	379937	2	0	0	0	1	1
41080	379944	2	0	2	0	2	4
41080	379945	2	1	0	0	0	1
41080	379947	2	1	4	1	4	10
41080	379949	2	0	0	0	0	0
41080	379950	2	0	0	0	0	0
41080	379952	2	0	0	0	1	1
41080	379954	2	1	0	0	0	1
41080	379956	2	0	1	1	1	3
41080	379960	2	1	0	0	0	1
41080	379961	2	0	1	0	1	2
41080	379966	2	0	1	0	0	1
41080	379971	2	1	0	0	0	1
41080	379972	2	1	0	0	1	2
41080	379974	2	0	0	0	0	0
41080	379980	2	3	2	0	0	5
41080	379981	2	0	1	0	2	3
41080	379982	2	1	0	0	0	1
41080	379989	2	0	4	0	1	5
41080	379991	2	0	1	0	3	4
41080	379996	2	0	0	0	1	1
41080	380001	2	2	1	0	0	3
41080	380003	2	2	0	0	2	4
41080	380007	2	0	1	0	0	1
41080	380009	2	0	1	1	0	2
41080	380020	2	1	0	0	0	1
41080	380036	2	0	0	0	0	0
41080	380037	2	0	1	0	0	1
41080	73931	2	0	0	0	1	1
41080	90001	2	0	1	0	0	1
41080	107362	1	2	0	0	0	2
41080	208813	1	0	0	0	0	0
41080	379910	1	1	0	0	0	1
41080	379912	1	0	0	0	1	1
41080	379913	1	0	0	0	0	0
41080	379914	1	0	0	0	0	0
41080	379916	1	2	0	0	0	2
41080	379918	1	1	0	0	0	1
41080	379919	1	0	0	0	1	1
41080	379922	1	0	0	0	0	0
41080	379924	1	0	2	0	1	3
41080	379926	1	0	0	0	1	1
41080	379929	1	0	0	0	1	1
41080	379932	1	1	1	0	0	2
41080	379933	1	0	0	0	1	1
41080	379934	1	0	0	0	0	0
41080	379935	1	1	0	0	0	1
41080	379936	1	0	0	0	1	1
41080	379938	1	0	1	0	2	3
41080	379940	1	0	1	0	0	1
41080	379958	1	0	1	0	0	1
41080	380010	1	0	2	0	0	2
41080	380017	1	1	0	0	0	1
41080	380027	1	4	0	0	0	4
35685	568095	25	2	1	1	1	5
35685	568094	12	3	1	2	0	6
35685	568171	12	4	0	0	1	5
35685	568229	12	5	0	0	0	5
35685	568169	11	8	2	1	1	12
35685	568191	11	2	1	1	0	4
35685	568198	11	3	1	1	0	5
35685	568140	10	1	0	0	0	1
35685	568091	9	3	0	1	0	4
35685	568131	9	8	0	0	0	8
35685	568135	9	5	1	0	0	6
35685	568150	9	3	0	0	0	3
35685	568151	9	2	2	0	0	4
35685	568228	9	1	0	0	0	1
35685	568244	9	2	1	0	0	3
35685	568100	8	1	0	0	0	1
35685	568163	8	3	0	0	2	5
35685	568190	8	2	0	0	1	3
35685	568199	8	0	1	0	0	1
35685	568239	8	0	0	0	0	0
35685	568164	7	3	1	0	0	4
35685	568074	6	2	0	0	0	2
35685	568075	6	4	0	1	0	5
35685	568106	6	4	1	0	0	5
35685	568127	6	1	4	0	0	5
35685	568129	6	3	0	0	0	3
35685	568153	6	2	0	0	0	2
35685	568168	6	0	0	0	0	0
35685	568182	6	1	1	0	0	2
35685	568204	6	1	1	0	1	3
35685	568205	6	1	0	0	0	1
35685	568212	6	2	0	0	0	2
35685	568215	6	3	0	0	0	3
35685	568250	6	2	1	0	0	3
35685	568064	5	2	0	0	0	2
35685	568067	5	0	0	0	0	0
35685	568073	5	1	1	0	0	2
35685	568138	5	1	0	0	0	1
35685	568154	5	0	0	0	0	0
35685	568155	5	3	0	0	0	3
35685	568174	5	2	0	0	0	2
35685	568177	5	1	1	0	0	2
35685	568183	5	2	1	0	0	3
35685	568243	5	5	0	0	0	5
35685	568247	5	3	1	0	0	4
35685	568071	4	0	0	0	0	0
35685	568077	4	2	0	0	0	2
35685	568083	4	2	1	0	0	3
35685	568101	4	1	0	0	0	1
35685	568111	4	4	1	0	0	5
35685	568117	4	1	1	0	0	2
35685	568130	4	0	0	0	0	0
35685	568134	4	1	0	0	0	1
35685	568141	4	1	0	0	1	2
35685	568144	4	1	0	0	0	1
35685	568145	4	2	2	0	0	4
35685	568149	4	3	0	0	0	3
35685	568165	4	1	0	0	0	1
35685	568185	4	7	1	0	0	8
35685	568188	4	1	0	0	0	1
35685	568195	4	4	0	0	0	4
35685	568200	4	1	0	0	0	1
35685	568202	4	2	1	0	0	3
35685	568216	4	2	1	0	0	3
35685	568217	4	3	0	0	0	3
35685	568220	4	2	0	0	2	4
35685	568226	4	4	0	0	0	4
35685	568240	4	2	0	0	0	2
35685	568241	4	1	0	0	0	1
35685	568242	4	1	0	0	0	1
35685	568246	4	3	0	0	0	3
35685	568062	3	2	0	0	0	2
35685	568078	3	2	0	0	0	2
35685	568084	3	2	1	0	0	3
35685	568085	3	2	1	0	0	3
35685	568092	3	2	1	0	0	3
35685	568097	3	1	0	0	0	1
35685	568098	3	2	1	0	0	3
35685	568102	3	1	0	0	0	1
35685	568105	3	2	0	0	0	2
35685	568110	3	1	0	0	0	1
35685	568115	3	2	0	0	0	2
35685	568121	3	1	1	0	0	2
35685	568123	3	1	0	0	0	1
35685	568133	3	0	0	0	0	0
35685	568136	3	2	0	0	0	2
35685	568139	3	3	0	1	0	4
35685	568143	3	1	1	0	1	3
35685	568157	3	2	0	1	3	6
35685	568158	3	1	0	0	0	1
35685	568170	3	1	1	0	0	2
35685	568172	3	2	1	0	1	4
35685	568175	3	1	0	0	2	3
35685	568189	3	2	0	0	0	2
35685	568206	3	0	0	0	0	0
35685	568214	3	1	0	0	0	1
35685	568218	3	2	1	0	0	3
35685	568221	3	2	0	0	0	2
35685	568224	3	1	0	0	0	1
35685	568227	3	1	0	0	0	1
35685	568232	3	0	1	0	0	1
35685	568233	3	0	2	0	3	5
35685	568234	3	5	0	0	0	5
35685	568245	3	2	1	0	0	3
35685	568069	2	0	0	0	0	0
35685	568072	2	0	0	0	2	2
35685	568086	2	0	0	0	1	1
35685	568089	2	3	0	0	0	3
35685	568093	2	2	0	0	0	2
35685	568096	2	2	0	0	0	2
35685	568107	2	1	1	0	0	2
35685	568109	2	2	0	0	0	2
35685	568114	2	3	0	0	0	3
35685	568116	2	0	0	0	0	0
35685	568118	2	2	0	0	0	2
35685	568120	2	1	0	0	0	1
35685	568128	2	1	0	0	0	1
35685	568142	2	3	0	0	0	3
35685	568148	2	2	0	0	0	2
35685	568160	2	0	0	0	0	0
35685	568161	2	3	0	0	0	3
35685	568179	2	1	0	0	0	1
35685	568180	2	2	0	0	0	2
35685	568181	2	1	0	0	0	1
35685	568184	2	1	0	0	0	1
35685	568186	2	0	0	0	0	0
35685	568193	2	4	0	0	0	4
35685	568194	2	2	2	0	1	5
35685	568196	2	2	0	0	0	2
35685	568203	2	2	0	0	0	2
35685	568208	2	1	0	0	0	1
35685	568210	2	2	0	0	0	2
35685	568211	2	1	0	0	0	1
35685	568219	2	1	1	0	0	2
35685	568223	2	1	2	0	0	3
35685	568225	2	0	1	0	1	2
35685	568231	2	2	0	0	0	2
35685	568236	2	0	0	0	0	0
35685	568238	2	1	0	0	0	1
35685	568251	2	0	0	0	0	0
35685	568061	1	3	0	0	0	3
35685	568063	1	3	0	0	0	3
35685	568065	1	1	0	0	0	1
35685	568066	1	0	0	0	1	1
35685	568068	1	1	0	0	0	1
35685	568070	1	1	0	0	0	1
35685	568076	1	1	0	0	0	1
35685	568079	1	2	0	0	0	2
35685	568080	1	3	0	0	0	3
35685	568081	1	2	0	0	0	2
35685	568082	1	0	0	0	0	0
35685	568087	1	2	0	0	0	2
35685	568088	1	2	0	0	1	3
35685	568090	1	1	0	1	0	2
35685	568099	1	1	0	0	0	1
35685	568103	1	2	0	0	0	2
35685	568104	1	2	0	0	0	2
35685	568108	1	0	0	0	0	0
35685	568112	1	0	0	0	0	0
35685	568113	1	1	0	0	0	1
35685	568119	1	0	1	0	0	1
35685	568122	1	2	1	0	0	3
35685	568124	1	1	1	0	0	2
35685	568125	1	1	0	0	0	1
35685	568126	1	2	0	0	0	2
35685	568132	1	2	1	0	0	3
35685	568137	1	0	0	0	0	0
35685	568146	1	2	0	0	0	2
35685	568147	1	2	1	0	0	3
35685	568152	1	3	1	0	0	4
35685	568156	1	2	0	0	0	2
35685	568159	1	1	0	0	0	1
35685	568162	1	0	0	0	0	0
35685	568166	1	0	0	0	0	0
35685	568167	1	0	0	0	0	0
35685	568173	1	2	0	0	0	2
35685	568176	1	0	0	0	3	3
35685	568178	1	2	0	0	0	2
35685	568187	1	6	3	0	1	10
35685	568192	1	2	0	0	0	2
35685	568197	1	0	0	0	0	0
35685	568207	1	3	0	0	0	3
35685	568209	1	1	0	0	0	1
35685	568213	1	0	0	0	0	0
35685	568222	1	1	0	0	0	1
35685	568230	1	2	1	0	0	3
35685	568235	1	2	0	0	0	2
35685	568237	1	0	1	0	0	1
35685	568248	1	0	0	0	0	0
35685	568249	1	1	0	0	0	1
35685	568252	1	0	0	0	0	0
35685	568253	1	4	0	0	0	4
55655	297720	24	2	9	3	0	14
55655	427070	20	10	2	0	2	14
55655	297721	18	1	2	1	3	7
55655	427058	17	2	3	0	0	5
55655	427054	16	5	5	2	0	12
55655	426991	15	2	1	0	1	4
55655	427031	13	2	3	0	1	6
55655	427059	11	1	0	0	0	1
55655	297717	10	0	0	0	0	0
55655	427004	10	0	0	0	0	0
55655	427029	10	1	3	1	1	6
55655	297719	9	3	2	0	0	5
55655	427006	9	3	2	0	0	5
55655	427022	9	0	0	1	0	1
55655	427050	8	1	2	0	0	3
55655	427051	8	0	1	0	2	3
55655	427055	8	3	1	0	1	5
55655	427065	8	1	1	1	0	3
55655	297705	7	2	0	0	0	2
55655	426974	7	1	2	0	0	3
55655	426990	7	0	0	0	0	0
55655	427005	7	0	3	1	0	4
55655	427015	7	1	1	1	0	3
55655	427052	7	0	6	0	0	6
55655	427074	7	1	3	0	0	4
55655	427078	7	0	0	0	0	0
55655	427096	7	1	1	0	1	3
55655	427111	7	0	2	0	1	3
55655	198539	6	0	1	0	0	1
55655	200165	6	0	3	0	0	3
55655	214354	6	0	1	0	1	2
55655	426981	6	1	2	0	0	3
55655	426999	6	3	2	0	1	6
55655	427020	6	1	2	0	0	3
55655	427063	6	1	1	0	0	2
55655	427064	6	1	1	0	0	2
55655	427069	6	0	5	0	0	5
55655	427099	6	1	1	0	0	2
55655	427115	6	1	2	0	1	4
55655	427116	6	2	3	0	0	5
55655	189934	5	0	1	0	0	1
55655	208080	5	1	0	0	1	2
55655	297712	5	0	0	0	1	1
55655	297715	5	3	0	0	0	3
55655	297718	5	1	2	0	0	3
55655	426977	5	1	2	0	0	3
55655	426980	5	1	2	0	0	3
55655	426998	5	1	1	0	0	2
55655	427001	5	2	2	1	0	5
55655	427002	5	0	1	0	0	1
55655	427008	5	0	0	0	0	0
55655	427018	5	1	3	0	1	5
55655	427019	5	0	2	0	0	2
55655	427034	5	0	3	0	0	3
55655	427040	5	1	1	0	1	3
55655	427045	5	3	3	1	4	11
55655	427046	5	2	0	0	0	2
55655	427053	5	2	3	0	1	6
55655	427060	5	0	1	0	0	1
55655	427061	5	1	2	0	0	3
55655	427067	5	1	2	0	0	3
55655	427075	5	2	2	0	0	4
55655	427079	5	0	4	0	0	4
55655	427092	5	1	2	0	1	4
55655	427093	5	1	2	0	0	3
55655	186046	4	0	1	0	0	1
55655	199158	4	1	0	0	0	1
55655	210552	4	1	1	0	0	2
55655	210833	4	1	1	0	0	2
55655	212963	4	1	2	1	1	5
55655	214013	4	1	0	1	0	2
55655	297707	4	1	1	0	0	2
55655	297708	4	1	1	0	1	3
55655	297713	4	0	3	0	0	3
55655	297714	4	0	0	0	0	0
55655	426973	4	0	2	0	0	2
55655	426976	4	1	1	0	0	2
55655	426979	4	1	3	0	0	4
55655	426982	4	1	3	0	0	4
55655	426983	4	2	1	1	1	5
55655	427010	4	2	2	0	0	4
55655	427012	4	0	2	0	0	2
55655	427013	4	0	1	0	0	1
55655	427017	4	1	5	0	0	6
55655	427021	4	0	1	0	0	1
55655	427026	4	1	1	0	0	2
55655	427028	4	2	2	0	0	4
55655	427032	4	0	2	0	0	2
55655	427039	4	2	1	0	0	3
55655	427044	4	1	2	0	0	3
55655	427049	4	1	1	0	1	3
55655	427066	4	0	1	0	0	1
55655	427072	4	1	2	0	0	3
55655	427080	4	2	3	0	0	5
55655	427081	4	1	0	0	0	1
55655	427088	4	1	1	0	0	2
55655	427095	4	1	1	0	0	2
55655	427101	4	0	1	0	0	1
55655	427105	4	1	1	0	0	2
55655	427110	4	1	1	0	1	3
55655	187223	3	0	0	0	1	1
55655	193566	3	0	2	0	1	3
55655	200442	3	1	0	0	0	1
55655	203756	3	0	0	0	0	0
55655	205383	3	0	0	0	1	1
55655	206996	3	0	0	0	0	0
55655	214392	3	0	1	0	1	2
55655	218432	3	0	1	0	0	1
55655	219972	3	1	0	0	0	1
55655	297710	3	1	1	0	0	2
55655	297711	3	0	1	0	0	1
55655	297722	3	0	2	0	1	3
55655	426984	3	3	1	0	0	4
55655	426993	3	0	1	0	0	1
55655	426996	3	0	2	0	1	3
55655	426997	3	0	1	0	1	2
55655	427000	3	0	2	0	0	2
55655	427003	3	1	1	0	0	2
55655	427007	3	0	0	0	1	1
55655	427009	3	0	2	0	0	2
55655	427011	3	0	2	0	0	2
55655	427014	3	0	3	0	0	3
55655	427016	3	2	2	0	0	4
55655	427024	3	0	1	0	0	1
55655	427025	3	1	1	0	0	2
55655	427033	3	0	1	0	0	1
55655	427035	3	1	1	0	0	2
55655	427036	3	2	0	0	0	2
55655	427037	3	1	2	0	1	4
55655	427041	3	1	2	0	0	3
55655	427042	3	2	0	0	0	2
55655	427048	3	0	1	0	1	2
55655	427056	3	1	1	0	1	3
55655	427057	3	0	1	0	0	1
55655	427071	3	1	1	0	0	2
55655	427073	3	2	1	0	0	3
55655	427076	3	0	1	0	0	1
55655	427082	3	0	2	0	0	2
55655	427083	3	1	0	0	0	1
55655	427085	3	0	0	0	1	1
55655	427086	3	0	0	1	0	1
55655	427087	3	0	1	0	0	1
55655	427090	3	0	2	0	0	2
55655	427094	3	1	0	0	0	1
55655	427106	3	0	1	0	0	1
55655	427112	3	1	0	0	0	1
55655	427114	3	1	0	0	0	1
55655	186524	2	0	0	0	1	1
55655	193896	2	0	1	0	0	1
55655	204483	2	1	1	0	1	3
55655	205286	2	0	1	0	3	4
55655	205530	2	1	0	0	0	1
55655	215274	2	0	2	0	0	2
55655	215851	2	1	2	0	2	5
55655	216324	2	1	1	0	0	2
55655	219013	2	0	1	0	0	1
55655	297706	2	0	1	0	0	1
55655	297716	2	2	1	0	1	4
55655	426978	2	0	1	0	0	1
55655	426992	2	0	1	0	0	1
55655	426994	2	1	1	1	0	3
55655	426995	2	0	1	0	0	1
55655	427023	2	0	1	0	0	1
55655	427027	2	0	0	0	0	0
55655	427030	2	0	1	0	0	1
55655	427038	2	1	3	0	0	4
55655	427047	2	0	2	0	0	2
55655	427062	2	1	1	0	0	2
55655	427068	2	0	2	0	1	3
55655	427084	2	1	0	0	0	1
55655	427089	2	1	0	0	0	1
55655	427091	2	0	1	0	0	1
55655	427097	2	0	1	0	0	1
55655	427100	2	0	0	0	2	2
55655	427103	2	0	1	0	0	1
55655	427104	2	0	1	0	0	1
55655	427109	2	0	0	0	0	0
55655	427113	2	1	1	0	0	2
55655	189632	1	2	0	0	0	2
55655	191235	1	0	0	0	0	0
55655	192798	1	0	1	0	0	1
55655	200053	1	1	1	0	0	2
55655	203155	1	0	1	0	0	1
55655	216968	1	1	0	0	0	1
55655	217446	1	0	1	0	0	1
55655	297709	1	0	1	0	0	1
55655	426975	1	0	1	0	0	1
55655	427077	1	1	0	0	0	1
55655	427098	1	1	1	0	1	3
55655	427102	1	0	0	0	1	1
55655	427107	1	0	0	0	2	2
55655	427108	1	0	0	0	0	0
59689	181904	26	1	11	1	0	13
59689	521521	12	1	2	1	0	4
59689	298863	10	3	1	0	2	6
59689	521526	8	2	4	1	0	7
59689	521530	8	0	3	0	1	4
59689	521573	8	0	0	1	0	1
59689	521586	8	3	3	0	0	6
59689	521589	8	2	1	1	0	4
59689	521620	8	0	0	0	0	0
59689	521504	7	0	2	0	1	3
59689	521509	7	1	4	0	0	5
59689	521603	7	0	0	0	0	0
59689	521604	7	0	1	0	0	1
59689	521609	7	0	0	0	0	0
59689	521625	7	2	0	0	0	2
59689	188251	6	0	1	0	0	1
59689	203130	6	2	3	0	0	5
59689	298857	6	0	1	0	0	1
59689	298862	6	1	1	0	0	2
59689	521518	6	1	2	0	0	3
59689	521545	6	0	3	0	0	3
59689	521552	6	0	2	0	0	2
59689	521592	6	2	2	0	0	4
59689	521612	6	2	2	0	0	4
59689	521614	6	1	4	0	0	5
59689	521615	6	3	3	0	0	6
59689	521637	6	0	2	0	2	4
59689	193206	5	0	1	0	1	2
59689	212934	5	0	1	0	0	1
59689	214007	5	3	2	0	0	5
59689	214432	5	0	4	0	1	5
59689	298859	5	0	0	0	0	0
59689	521510	5	1	1	0	1	3
59689	521514	5	4	1	0	0	5
59689	521523	5	2	2	0	0	4
59689	521524	5	2	1	0	0	3
59689	521535	5	0	2	0	1	3
59689	521540	5	2	2	0	0	4
59689	521557	5	1	1	1	0	3
59689	521569	5	1	2	0	0	3
59689	521576	5	3	0	0	1	4
59689	521587	5	1	1	0	0	2
59689	521598	5	0	3	0	0	3
59689	521599	5	1	1	0	0	2
59689	521605	5	2	2	0	0	4
59689	521611	5	1	0	0	0	1
59689	521618	5	0	1	0	1	2
59689	521619	5	4	2	0	0	6
59689	521621	5	1	0	0	0	1
59689	521622	5	0	0	0	0	0
59689	521628	5	1	0	0	1	2
59689	521640	5	0	2	0	2	4
59689	521642	5	2	3	0	1	6
59689	521652	5	2	0	0	0	2
59689	195046	4	1	4	0	1	6
59689	203162	4	1	2	0	0	3
59689	205534	4	1	2	0	0	3
59689	207202	4	0	1	0	0	1
59689	217219	4	0	1	0	0	1
59689	219050	4	0	2	0	0	2
59689	298860	4	1	1	0	0	2
59689	298865	4	0	3	0	0	3
59689	521508	4	0	0	0	0	0
59689	521511	4	1	1	0	1	3
59689	521512	4	0	2	0	0	2
59689	521516	4	0	0	0	0	0
59689	521520	4	1	2	0	0	3
59689	521531	4	1	2	0	0	3
59689	521534	4	2	3	0	0	5
59689	521538	4	1	1	0	0	2
59689	521549	4	1	0	0	0	1
59689	521554	4	1	2	0	1	4
59689	521558	4	2	1	1	0	4
59689	521559	4	1	0	0	0	1
59689	521567	4	0	4	0	0	4
59689	521568	4	0	1	0	0	1
59689	521572	4	3	3	0	1	7
59689	521574	4	2	1	0	0	3
59689	521575	4	0	1	0	0	1
59689	521577	4	2	2	0	0	4
59689	521582	4	0	2	0	2	4
59689	521584	4	1	2	0	0	3
59689	521588	4	2	1	0	0	3
59689	521601	4	2	2	0	0	4
59689	521610	4	0	1	0	0	1
59689	521617	4	2	2	0	0	4
59689	521629	4	1	2	0	0	3
59689	521630	4	0	1	0	0	1
59689	521633	4	0	2	0	0	2
59689	521636	4	1	1	0	0	2
59689	521643	4	0	2	0	0	2
59689	521647	4	0	2	0	0	2
59689	521650	4	0	1	0	0	1
59689	521654	4	0	2	0	0	2
59689	521655	4	1	5	0	0	6
59689	181885	3	1	1	0	0	2
59689	182737	3	0	1	0	0	1
59689	196532	3	0	0	0	0	0
59689	199721	3	0	1	0	0	1
59689	200123	3	1	2	0	0	3
59689	206193	3	0	3	0	0	3
59689	216776	3	0	1	0	2	3
59689	216832	3	0	1	0	0	1
59689	298855	3	1	3	0	0	4
59689	298858	3	3	0	0	0	3
59689	298861	3	0	3	0	1	4
59689	521505	3	1	3	0	0	4
59689	521517	3	0	2	0	0	2
59689	521519	3	1	1	0	0	2
59689	521532	3	3	0	0	0	3
59689	521537	3	0	0	0	0	0
59689	521539	3	0	2	0	0	2
59689	521542	3	0	1	0	1	2
59689	521544	3	0	1	1	0	2
59689	521546	3	1	0	0	0	1
59689	521547	3	0	2	0	0	2
59689	521550	3	0	1	0	1	2
59689	521551	3	1	0	0	0	1
59689	521553	3	2	0	0	0	2
59689	521555	3	1	1	0	0	2
59689	521564	3	1	2	0	0	3
59689	521565	3	0	1	0	0	1
59689	521579	3	0	2	0	0	2
59689	521580	3	1	1	0	0	2
59689	521590	3	0	2	0	0	2
59689	521607	3	0	1	0	0	1
59689	521631	3	1	1	0	0	2
59689	521635	3	0	1	0	0	1
59689	521639	3	0	1	0	0	1
59689	521641	3	0	1	0	1	2
59689	521648	3	2	1	0	0	3
59689	521653	3	3	1	0	0	4
59689	521657	3	0	1	0	2	3
59689	183738	2	0	4	0	0	4
59689	186228	2	0	1	0	0	1
59689	198381	2	1	0	0	0	1
59689	198596	2	0	1	0	0	1
59689	298854	2	0	2	0	0	2
59689	298856	2	0	0	0	0	0
59689	298864	2	1	0	0	0	1
59689	521507	2	1	0	0	1	2
59689	521513	2	0	0	0	0	0
59689	521515	2	1	0	0	0	1
59689	521522	2	0	4	0	1	5
59689	521525	2	0	0	0	0	0
59689	521528	2	0	1	0	0	1
59689	521533	2	0	1	0	0	1
59689	521536	2	1	0	0	0	1
59689	521541	2	1	1	0	0	2
59689	521543	2	1	3	0	0	4
59689	521556	2	1	1	0	0	2
59689	521560	2	1	0	0	0	1
59689	521561	2	0	2	0	0	2
59689	521562	2	0	1	0	0	1
59689	521563	2	0	0	0	0	0
59689	521566	2	1	0	0	0	1
59689	521570	2	1	1	0	0	2
59689	521571	2	1	1	0	1	3
59689	521578	2	1	1	0	0	2
59689	521581	2	1	0	0	0	1
59689	521583	2	1	1	0	0	2
59689	521593	2	1	2	0	0	3
59689	521594	2	1	2	0	0	3
59689	521595	2	0	2	0	0	2
59689	521597	2	0	1	0	0	1
59689	521600	2	1	1	0	0	2
59689	521602	2	1	2	0	0	3
59689	521606	2	1	0	0	0	1
59689	521608	2	0	0	0	0	0
59689	521613	2	0	1	0	0	1
59689	521616	2	0	0	0	0	0
59689	521623	2	0	0	0	0	0
59689	521624	2	0	1	0	2	3
59689	521627	2	0	0	0	0	0
59689	521634	2	0	1	0	0	1
59689	521638	2	0	3	0	0	3
59689	521644	2	1	1	0	1	3
59689	521645	2	1	1	0	1	3
59689	521646	2	1	1	0	0	2
59689	521656	2	0	2	0	0	2
59689	521506	1	0	2	0	0	2
59689	521527	1	1	0	0	0	1
59689	521529	1	1	4	0	1	6
59689	521548	1	0	0	0	0	0
59689	521585	1	0	0	0	0	0
59689	521591	1	0	2	0	0	2
59689	521596	1	2	3	0	0	5
59689	521626	1	3	0	0	0	3
59689	521632	1	0	2	0	2	4
59689	521649	1	1	0	0	0	1
59689	521651	1	0	0	0	0	0
40025	421662	12	1	0	0	0	1
40025	421537	11	2	0	0	0	2
40025	212277	10	1	1	1	2	5
40025	421549	10	1	1	1	2	5
40025	421597	10	1	1	0	1	3
40025	207947	8	0	0	1	0	1
40025	421553	8	2	1	0	1	4
40025	421556	8	1	0	1	0	2
40025	421558	8	3	0	0	0	3
40025	421637	8	3	1	0	1	5
40025	421646	8	2	0	0	1	3
40025	421660	8	1	0	0	0	1
40025	421532	7	2	1	0	0	3
40025	421554	7	5	1	0	1	7
40025	421555	7	2	1	0	1	4
40025	421631	7	2	0	0	1	3
40025	421669	7	0	1	0	1	2
40025	421527	6	3	4	1	0	8
40025	421557	6	4	3	0	1	8
40025	421581	6	6	1	0	2	9
40025	421605	6	2	0	1	0	3
40025	421611	6	2	0	0	1	3
40025	421624	6	2	1	0	0	3
40025	421642	6	0	0	0	0	0
40025	421654	6	2	2	0	0	4
40025	421664	6	3	1	0	0	4
40025	421670	6	0	0	0	1	1
40025	211008	5	0	0	1	0	1
40025	421542	5	4	0	0	1	5
40025	421548	5	0	1	0	1	2
40025	421572	5	1	1	0	0	2
40025	421582	5	3	0	1	2	6
40025	421584	5	2	1	0	1	4
40025	421589	5	3	0	0	0	3
40025	421595	5	2	0	0	0	2
40025	421598	5	1	0	0	0	1
40025	421607	5	1	1	0	0	2
40025	421612	5	0	1	0	0	1
40025	421613	5	2	2	0	0	4
40025	421615	5	3	0	0	0	3
40025	421616	5	2	0	0	0	2
40025	421629	5	1	1	0	0	2
40025	421635	5	0	0	0	0	0
40025	421648	5	0	0	0	0	0
40025	421656	5	2	0	0	0	2
40025	421668	5	1	0	0	0	1
40025	204767	4	1	1	0	0	2
40025	205870	4	2	0	0	0	2
40025	211809	4	2	0	0	1	3
40025	213344	4	2	0	0	1	3
40025	216243	4	3	1	0	0	4
40025	293888	4	0	0	0	0	0
40025	421528	4	2	0	1	0	3
40025	421529	4	1	1	1	0	3
40025	421531	4	1	1	0	1	3
40025	421540	4	5	1	0	0	6
40025	421547	4	1	0	0	0	1
40025	421562	4	2	0	0	0	2
40025	421565	4	2	0	0	0	2
40025	421568	4	2	0	0	1	3
40025	421569	4	0	1	0	0	1
40025	421573	4	2	0	0	0	2
40025	421574	4	1	1	0	1	3
40025	421575	4	0	1	0	0	1
40025	421587	4	3	1	0	0	4
40025	421588	4	0	0	0	0	0
40025	421601	4	3	1	0	1	5
40025	421602	4	4	2	0	0	6
40025	421604	4	2	0	0	1	3
40025	421609	4	0	0	0	2	2
40025	421614	4	0	2	0	1	3
40025	421620	4	3	2	0	0	5
40025	421621	4	1	0	0	0	1
40025	421622	4	0	1	0	0	1
40025	421623	4	0	0	1	1	2
40025	421626	4	1	2	0	1	4
40025	421633	4	2	1	0	1	4
40025	421634	4	3	0	0	1	4
40025	421636	4	0	0	0	1	1
40025	421644	4	0	0	0	0	0
40025	421647	4	1	0	0	0	1
40025	421649	4	1	0	0	0	1
40025	186055	3	3	1	0	0	4
40025	189783	3	1	1	0	0	2
40025	189864	3	1	1	0	0	2
40025	194590	3	0	0	0	0	0
40025	198279	3	0	1	0	0	1
40025	200425	3	1	0	0	0	1
40025	204445	3	0	0	0	1	1
40025	206052	3	1	0	0	1	2
40025	208903	3	1	1	0	2	4
40025	293883	3	1	0	0	0	1
40025	293886	3	1	0	0	1	2
40025	293889	3	2	0	0	2	4
40025	293890	3	2	0	0	0	2
40025	421530	3	0	0	0	0	0
40025	421541	3	1	0	0	0	1
40025	421543	3	3	0	0	0	3
40025	421544	3	0	3	0	0	3
40025	421546	3	2	0	0	0	2
40025	421550	3	1	3	0	0	4
40025	421551	3	0	1	0	3	4
40025	421564	3	3	0	0	0	3
40025	421578	3	2	0	0	0	2
40025	421583	3	1	1	0	0	2
40025	421585	3	3	1	0	0	4
40025	421586	3	1	0	0	1	2
40025	421594	3	0	2	0	1	3
40025	421596	3	1	2	0	0	3
40025	421603	3	2	0	0	1	3
40025	421606	3	1	1	0	1	3
40025	421618	3	0	1	0	0	1
40025	421619	3	0	1	0	0	1
40025	421625	3	0	1	0	0	1
40025	421627	3	2	1	0	0	3
40025	421628	3	0	1	0	0	1
40025	421639	3	1	0	0	1	2
40025	421650	3	1	0	0	1	2
40025	421652	3	3	0	0	0	3
40025	421653	3	2	0	0	0	2
40025	421657	3	1	0	0	0	1
40025	421661	3	0	1	0	0	1
40025	421663	3	0	0	0	1	1
40025	421665	3	0	0	0	0	0
40025	421666	3	2	0	0	0	2
40025	421667	3	1	0	0	0	1
40025	182710	2	1	1	0	0	2
40025	186988	2	1	0	0	0	1
40025	196806	2	1	0	0	0	1
40025	199728	2	0	0	0	0	0
40025	210774	2	2	0	0	0	2
40025	214803	2	2	0	0	1	3
40025	216080	2	1	0	0	0	1
40025	221918	2	2	0	0	0	2
40025	293891	2	2	0	0	1	3
40025	293894	2	2	0	0	0	2
40025	293895	2	0	0	0	0	0
40025	421526	2	1	0	0	0	1
40025	421533	2	3	2	0	0	5
40025	421535	2	2	0	0	0	2
40025	421536	2	0	1	0	0	1
40025	421539	2	2	0	0	0	2
40025	421545	2	2	0	0	0	2
40025	421559	2	1	0	0	1	2
40025	421560	2	1	0	0	0	1
40025	421561	2	1	0	0	0	1
40025	421563	2	1	0	0	0	1
40025	421567	2	0	1	0	0	1
40025	421570	2	1	0	0	1	2
40025	421571	2	2	0	0	0	2
40025	421576	2	2	3	0	0	5
40025	421577	2	0	0	0	0	0
40025	421579	2	0	1	0	0	1
40025	421590	2	2	0	0	1	3
40025	421591	2	0	0	0	1	1
40025	421592	2	1	1	0	0	2
40025	421593	2	2	0	0	1	3
40025	421600	2	3	0	0	0	3
40025	421608	2	2	0	0	0	2
40025	421610	2	4	2	0	0	6
40025	421617	2	0	0	0	0	0
40025	421630	2	3	0	0	0	3
40025	421638	2	0	0	0	0	0
40025	421640	2	2	0	0	0	2
40025	421641	2	1	0	0	0	1
40025	421645	2	0	0	0	0	0
40025	186611	1	0	0	0	0	0
40025	186904	1	2	0	0	0	2
40025	189680	1	0	1	0	0	1
40025	203773	1	1	0	0	0	1
40025	217287	1	2	0	0	0	2
40025	293884	1	1	1	0	0	2
40025	293885	1	0	0	0	0	0
40025	293887	1	1	0	0	0	1
40025	293892	1	1	0	0	0	1
40025	293893	1	0	1	0	0	1
40025	293896	1	0	0	0	0	0
40025	421534	1	0	0	0	3	3
40025	421538	1	0	1	0	0	1
40025	421552	1	2	1	0	0	3
40025	421566	1	0	0	0	0	0
40025	421580	1	3	0	0	0	3
40025	421599	1	1	0	0	0	1
40025	421632	1	0	0	0	0	0
40025	421643	1	1	0	0	0	1
40025	421651	1	1	0	0	0	1
40025	421655	1	1	2	0	0	3
40025	421658	1	1	2	0	0	3
40025	421659	1	0	0	0	0	0
5189	284292	35	4	3	2	8	17
5189	181966	32	2	6	1	9	18
5189	618435	30	2	6	1	9	18
5189	92514	28	4	2	1	5	12
5189	187404	27	2	3	2	1	8
5189	52630	24	2	3	0	1	6
5189	217449	22	3	1	0	1	5
5189	188781	20	0	3	0	1	4
5189	284310	20	0	3	0	1	4
5189	59716	20	0	3	0	1	4
5189	618456	20	4	4	1	2	11
5189	77492	19	3	2	0	2	7
5189	105067	18	1	2	0	0	3
5189	72887	18	1	4	0	0	5
5189	89641	18	1	4	0	2	7
5189	618476	17	2	2	0	2	6
5189	618474	16	2	3	1	2	8
5189	202381	14	1	1	0	0	2
5189	618433	14	1	0	0	2	3
5189	618516	14	1	4	1	0	6
5189	75782	14	3	2	2	1	8
5189	212238	13	3	1	0	1	5
5189	284293	13	1	1	0	0	2
5189	618428	13	3	1	0	1	5
5189	618434	13	1	0	3	0	4
5189	618436	13	1	1	0	0	2
5189	82615	13	1	1	0	0	2
5189	284301	11	2	1	0	1	4
5189	284308	11	1	1	0	2	4
5189	618460	11	0	0	1	1	2
5189	618494	11	1	3	0	3	7
5189	618503	11	1	4	1	2	8
5189	63178	11	1	1	0	2	4
5189	71210	11	2	1	0	1	4
5189	197195	10	0	0	0	0	0
5189	618461	10	2	1	0	1	4
5189	618466	10	3	1	0	3	7
5189	618479	10	0	0	1	0	1
5189	618510	10	0	0	0	1	1
5189	618424	9	1	1	0	1	3
5189	618463	9	1	3	0	0	4
5189	618470	9	3	0	0	5	8
5189	618498	9	0	2	0	0	2
5189	182776	8	0	2	1	0	3
5189	193491	8	1	3	1	1	6
5189	214179	8	6	3	0	4	13
5189	284305	8	0	2	1	0	3
5189	284309	8	0	1	0	0	1
5189	618440	8	2	2	1	2	7
5189	618446	8	0	0	0	0	0
5189	618458	8	1	3	2	1	7
5189	618468	8	0	0	0	0	0
5189	618492	8	2	0	0	0	2
5189	70739	8	0	1	0	0	1
5189	108496	7	0	1	2	2	5
5189	198331	7	3	5	0	0	8
5189	203512	7	0	0	0	0	0
5189	209254	7	1	3	0	1	5
5189	213369	7	0	0	0	0	0
5189	284303	7	0	1	2	2	5
5189	618431	7	0	0	0	0	0
5189	618447	7	0	0	0	0	0
5189	618469	7	3	1	1	0	5
5189	618482	7	0	1	0	0	1
5189	618500	7	1	0	0	0	1
5189	618509	7	1	0	0	4	5
5189	618515	7	0	0	0	1	1
5189	618517	7	1	0	0	0	1
5189	618519	7	1	0	1	0	2
5189	184276	6	2	1	0	0	3
5189	192156	6	0	2	0	1	3
5189	194775	6	0	1	0	2	3
5189	198493	6	1	0	0	0	1
5189	207508	6	0	0	1	1	2
5189	213460	6	2	3	0	3	8
5189	284302	6	0	1	0	2	3
5189	284307	6	0	0	1	0	1
5189	618420	6	0	0	0	1	1
5189	618423	6	0	1	1	0	2
5189	618427	6	0	2	1	0	3
5189	618430	6	0	2	0	1	3
5189	618441	6	0	0	0	0	0
5189	618451	6	1	1	0	2	4
5189	618454	6	1	0	0	0	1
5189	618462	6	1	0	0	1	2
5189	618489	6	0	4	1	1	6
5189	618505	6	1	1	1	0	3
5189	618506	6	2	1	0	0	3
5189	618507	6	0	0	0	0	0
5189	618514	6	0	2	1	0	3
5189	618518	6	0	2	0	0	2
5189	618520	6	3	4	0	2	9
5189	618521	6	2	3	0	0	5
5189	64236	6	0	0	1	0	1
5189	95707	6	1	1	0	3	5
5189	183778	5	0	0	0	0	0
5189	192616	5	0	1	0	1	2
5189	194406	5	1	0	0	0	1
5189	197353	5	3	1	1	1	6
5189	202002	5	1	2	0	0	3
5189	202003	5	1	2	0	0	3
5189	205435	5	3	1	0	0	4
5189	207272	5	0	0	0	0	0
5189	218068	5	0	0	0	0	0
5189	284295	5	1	0	0	1	2
5189	284297	5	1	1	0	0	2
5189	284304	5	3	1	1	1	6
5189	55120	5	3	0	1	0	4
5189	618419	5	1	2	0	0	3
5189	618444	5	0	1	0	0	1
5189	618445	5	1	1	1	2	5
5189	618449	5	0	0	0	0	0
5189	618455	5	2	1	0	0	3
5189	618457	5	2	1	0	2	5
5189	618459	5	0	0	0	1	1
5189	618487	5	1	1	0	2	4
5189	618493	5	0	0	0	0	0
5189	618497	5	0	1	0	1	2
5189	618504	5	1	1	0	2	4
5189	618511	5	0	1	0	2	3
5189	618512	5	2	1	2	0	5
5189	68303	5	2	0	0	0	2
5189	70696	5	1	1	0	0	2
5189	72821	5	3	1	1	1	6
5189	194400	4	0	0	0	0	0
5189	210054	4	0	1	0	0	1
5189	214064	4	0	0	2	2	4
5189	284299	4	3	2	0	1	6
5189	618422	4	2	3	1	0	6
5189	618432	4	1	0	0	1	2
5189	618437	4	1	0	0	0	1
5189	618443	4	3	0	0	2	5
5189	618450	4	0	0	0	0	0
5189	618453	4	0	1	0	0	1
5189	618464	4	0	2	0	0	2
5189	618473	4	1	0	0	1	2
5189	618480	4	0	0	1	0	1
5189	618481	4	1	0	0	0	1
5189	618495	4	2	2	0	0	4
5189	618501	4	1	2	0	0	3
5189	95739	4	1	0	0	0	1
5189	186776	3	1	1	1	0	3
5189	187179	3	1	0	0	0	1
5189	189182	3	0	1	0	0	1
5189	213828	3	0	1	0	0	1
5189	214382	3	0	0	0	0	0
5189	618421	3	1	1	1	0	3
5189	618425	3	0	3	0	0	3
5189	618429	3	0	0	0	0	0
5189	618438	3	1	1	0	1	3
5189	618442	3	0	1	0	1	2
5189	618452	3	0	0	0	1	1
5189	618475	3	0	3	0	1	4
5189	618477	3	1	0	0	0	1
5189	618478	3	0	1	0	1	2
5189	618483	3	0	0	0	4	4
5189	618484	3	0	0	0	0	0
5189	618485	3	1	0	1	0	2
5189	618488	3	1	2	1	1	5
5189	618490	3	0	1	0	1	2
5189	618491	3	0	0	0	2	2
5189	618496	3	0	0	0	0	0
5189	618502	3	2	0	1	0	3
5189	618508	3	0	0	0	0	0
5189	618513	3	0	1	0	2	3
5189	62442	3	0	0	0	0	0
5189	182340	2	1	1	0	0	2
5189	191507	2	0	1	0	0	1
5189	197263	2	0	0	0	0	0
5189	200238	2	0	0	0	1	1
5189	206682	2	0	0	0	0	0
5189	216338	2	0	1	0	0	1
5189	217084	2	0	0	0	1	1
5189	284291	2	0	0	0	1	1
5189	284294	2	0	0	0	0	0
5189	284296	2	0	0	1	0	1
5189	284298	2	0	0	0	0	0
5189	284306	2	0	0	0	0	0
5189	618426	2	0	0	0	0	0
5189	618448	2	0	0	0	0	0
5189	618467	2	1	0	0	0	1
5189	618471	2	1	2	0	4	7
5189	618472	2	0	1	0	0	1
5189	618486	2	0	0	0	0	0
5189	618499	2	1	0	0	1	2
5189	70862	2	0	0	0	0	0
5189	192552	1	0	0	0	0	0
5189	618439	1	0	0	0	0	0
5189	618465	1	1	0	0	0	1
28658	551876	25	3	5	2	7	17
28658	551992	12	2	1	1	0	4
28658	551925	10	1	1	0	0	2
28658	552033	10	3	2	1	2	8
28658	551874	8	4	1	2	0	7
28658	551978	8	2	2	0	0	4
28658	552013	8	2	0	0	0	2
28658	552024	8	0	0	0	0	0
28658	551880	7	0	1	1	0	2
28658	551919	7	1	0	0	0	1
28658	551970	7	0	1	0	0	1
28658	551979	7	2	1	0	1	4
28658	551997	7	3	1	0	0	4
28658	196903	6	0	0	1	0	1
28658	278241	6	2	1	0	0	3
28658	551881	6	1	0	0	2	3
28658	551886	6	1	1	1	0	3
28658	551896	6	0	0	1	1	2
28658	551923	6	1	0	0	0	1
28658	551950	6	2	1	0	1	4
28658	551952	6	2	2	0	0	4
28658	551972	6	1	0	0	2	3
28658	551975	6	3	2	0	0	5
28658	551990	6	0	1	0	2	3
28658	551998	6	1	2	1	0	4
28658	552003	6	1	3	2	0	6
28658	552017	6	1	2	0	0	3
28658	552020	6	4	0	0	2	6
28658	552027	6	0	1	0	0	1
28658	552028	6	2	1	1	0	4
28658	212339	5	0	0	0	0	0
28658	551867	5	0	1	0	0	1
28658	551869	5	2	1	0	0	3
28658	551882	5	2	0	0	0	2
28658	551905	5	0	1	0	1	2
28658	551907	5	1	2	0	0	3
28658	551913	5	1	0	0	0	1
28658	551915	5	2	1	0	0	3
28658	551932	5	1	2	0	0	3
28658	551938	5	2	1	0	0	3
28658	551948	5	0	0	0	0	0
28658	551951	5	1	3	0	0	4
28658	551961	5	0	0	0	0	0
28658	551973	5	2	0	0	4	6
28658	551989	5	2	1	0	0	3
28658	552000	5	1	1	0	0	2
28658	552009	5	1	0	0	0	1
28658	552011	5	2	0	1	0	3
28658	552030	5	1	1	0	0	2
28658	278242	4	2	0	1	2	5
28658	278244	4	1	0	0	2	3
28658	551873	4	0	1	0	2	3
28658	551894	4	1	0	0	0	1
28658	551899	4	2	0	0	0	2
28658	551901	4	2	2	0	0	4
28658	551909	4	1	1	0	0	2
28658	551920	4	0	0	0	0	0
28658	551921	4	0	0	0	0	0
28658	551928	4	1	1	1	0	3
28658	551946	4	0	1	0	0	1
28658	551954	4	0	1	0	0	1
28658	551965	4	1	0	0	1	2
28658	551966	4	1	0	0	0	1
28658	551981	4	0	2	0	0	2
28658	551983	4	4	1	0	1	6
28658	551986	4	2	0	0	1	3
28658	551987	4	2	0	0	0	2
28658	551993	4	0	1	0	0	1
28658	551995	4	2	0	0	1	3
28658	552008	4	1	1	0	0	2
28658	552012	4	0	1	0	0	1
28658	552016	4	0	0	0	2	2
28658	552019	4	1	1	0	0	2
28658	552022	4	0	0	0	0	0
28658	184289	3	0	0	0	0	0
28658	278246	3	1	0	0	1	2
28658	551870	3	0	1	0	0	1
28658	551871	3	1	0	0	0	1
28658	551878	3	0	0	0	0	0
28658	551883	3	3	1	0	0	4
28658	551884	3	2	0	0	0	2
28658	551887	3	1	0	0	0	1
28658	551888	3	0	2	0	0	2
28658	551890	3	0	0	0	1	1
28658	551892	3	1	1	0	1	3
28658	551895	3	1	1	0	0	2
28658	551903	3	1	1	0	1	3
28658	551906	3	0	0	0	1	1
28658	551908	3	0	1	0	0	1
28658	551916	3	1	0	0	1	2
28658	551922	3	0	1	0	0	1
28658	551929	3	2	0	0	0	2
28658	551930	3	1	0	0	1	2
28658	551931	3	1	0	0	0	1
28658	551939	3	0	0	0	1	1
28658	551942	3	0	0	0	1	1
28658	551943	3	3	0	0	0	3
28658	551947	3	1	1	0	1	3
28658	551953	3	1	1	0	1	3
28658	551956	3	1	0	0	0	1
28658	551958	3	2	2	0	0	4
28658	551959	3	0	1	0	0	1
28658	551964	3	2	1	0	0	3
28658	551967	3	1	1	0	0	2
28658	551968	3	0	0	0	1	1
28658	551969	3	0	1	0	0	1
28658	551977	3	0	1	1	0	2
28658	551980	3	1	0	0	0	1
28658	551985	3	1	0	0	0	1
28658	551991	3	1	0	0	3	4
28658	551996	3	0	0	0	0	0
28658	551999	3	0	1	0	0	1
28658	552001	3	0	2	0	1	3
28658	552002	3	2	0	0	0	2
28658	552004	3	0	1	0	1	2
28658	552006	3	0	0	0	0	0
28658	552025	3	0	1	0	1	2
28658	552029	3	0	1	0	0	1
28658	552034	3	1	2	0	1	4
28658	552040	3	2	0	0	0	2
28658	205802	2	0	1	0	0	1
28658	278243	2	0	0	0	0	0
28658	278245	2	2	0	0	1	3
28658	551864	2	0	0	0	0	0
28658	551865	2	0	1	0	0	1
28658	551866	2	0	1	0	0	1
28658	551868	2	4	1	0	0	5
28658	551872	2	4	0	0	1	5
28658	551877	2	0	1	0	0	1
28658	551879	2	0	1	0	0	1
28658	551885	2	0	1	0	1	2
28658	551891	2	0	0	0	1	1
28658	551900	2	0	0	0	1	1
28658	551911	2	1	0	0	0	1
28658	551912	2	1	0	0	0	1
28658	551917	2	1	1	0	0	2
28658	551918	2	1	0	0	0	1
28658	551924	2	1	0	0	0	1
28658	551926	2	1	0	0	0	1
28658	551927	2	1	1	0	0	2
28658	551933	2	1	0	0	0	1
28658	551934	2	0	0	0	0	0
28658	551935	2	2	2	0	0	4
28658	551936	2	3	0	0	0	3
28658	551940	2	0	0	0	0	0
28658	551941	2	0	0	0	0	0
28658	551945	2	0	0	0	0	0
28658	551949	2	1	0	0	2	3
28658	551957	2	0	1	0	0	1
28658	551962	2	1	0	0	1	2
28658	551963	2	0	1	0	0	1
28658	551982	2	0	0	0	0	0
28658	551984	2	0	0	0	0	0
28658	551988	2	1	0	0	0	1
28658	551994	2	0	1	0	2	3
28658	552005	2	0	3	0	0	3
28658	552010	2	0	0	0	0	0
28658	552014	2	1	1	0	0	2
28658	552015	2	1	0	0	0	1
28658	552018	2	2	2	0	0	4
28658	552023	2	0	2	0	0	2
28658	552031	2	1	0	0	3	4
28658	552035	2	0	0	0	0	0
28658	552036	2	0	0	0	0	0
28658	552037	2	0	0	0	0	0
28658	552039	2	0	0	0	0	0
28658	204606	1	0	0	0	0	0
28658	551875	1	0	0	0	0	0
28658	551889	1	1	2	0	0	3
28658	551893	1	0	2	0	0	2
28658	551897	1	4	0	0	0	4
28658	551898	1	1	0	0	0	1
28658	551902	1	1	0	0	1	2
28658	551904	1	0	0	0	0	0
28658	551910	1	1	0	0	0	1
28658	551914	1	1	0	0	0	1
28658	551937	1	0	0	0	1	1
28658	551944	1	0	0	0	0	0
28658	551955	1	0	0	0	0	0
28658	551960	1	1	1	0	2	4
28658	551971	1	0	0	0	0	0
28658	551974	1	0	1	0	0	1
28658	551976	1	0	0	0	0	0
28658	552007	1	0	0	0	0	0
28658	552021	1	1	1	0	0	2
28658	552026	1	0	1	1	0	2
28658	552032	1	1	0	0	0	1
28658	552038	1	0	1	0	0	1
43387	68269	52	2	3	2	1	8
43387	72598	42	0	1	3	7	11
43387	95435	30	4	1	0	2	7
43387	72670	23	1	4	2	6	13
43387	482001	22	1	3	3	3	10
43387	294875	20	2	3	2	2	9
43387	97756	20	2	3	2	2	9
43387	294874	19	0	2	1	2	5
43387	83370	19	0	2	1	2	5
43387	294876	17	2	4	0	3	9
43387	482068	17	0	1	2	3	6
43387	482084	17	2	4	0	3	9
43387	92736	17	2	4	0	3	9
43387	482036	16	3	3	1	2	9
43387	80800	16	2	2	0	3	7
43387	219128	15	3	1	0	0	4
43387	102895	14	1	1	1	0	3
43387	106102	14	3	1	0	0	4
43387	481987	14	0	3	4	0	7
43387	481988	14	10	5	3	2	20
43387	482106	14	2	3	3	3	11
43387	90130	14	0	2	2	3	7
43387	100141	13	0	0	0	0	0
43387	482009	13	4	1	2	3	10
43387	481999	12	0	1	2	2	5
43387	100730	11	0	2	1	5	8
43387	198306	11	0	2	1	5	8
43387	294877	11	0	2	1	5	8
43387	482085	11	0	2	1	5	8
43387	57377	10	0	5	0	0	5
43387	61268	10	1	3	0	1	5
43387	101500	9	1	0	0	0	1
43387	482000	9	0	1	0	2	3
43387	482111	9	2	2	1	1	6
43387	482114	9	0	3	1	2	6
43387	95543	9	1	0	0	3	4
43387	482047	8	1	2	2	1	6
43387	482109	8	2	1	0	2	5
43387	85163	8	2	3	2	0	7
43387	98142	8	0	0	0	1	1
43387	101556	7	2	2	0	0	4
43387	107987	7	2	0	1	2	5
43387	211715	7	1	0	1	0	2
43387	482016	7	0	0	3	0	3
43387	482032	7	0	0	0	1	1
43387	482035	7	0	1	1	0	2
43387	482038	7	0	1	0	0	1
43387	482069	7	0	1	0	1	2
43387	482076	7	0	0	0	0	0
43387	68786	7	0	0	3	0	3
43387	481978	6	0	1	2	1	4
43387	482006	6	2	1	1	4	8
43387	482008	6	2	1	1	0	4
43387	482028	6	3	0	1	3	7
43387	482031	6	0	3	0	2	5
43387	482039	6	1	1	0	1	3
43387	482075	6	2	1	0	0	3
43387	67670	6	0	1	0	1	2
43387	79494	6	0	1	0	0	1
43387	83532	6	0	1	0	0	1
43387	96403	6	1	2	0	0	3
43387	99835	6	0	1	0	3	4
43387	193338	5	1	1	2	1	5
43387	203991	5	0	2	0	0	2
43387	294879	5	0	1	0	0	1
43387	481997	5	1	0	1	2	4
43387	482024	5	1	2	2	1	6
43387	482029	5	0	0	0	2	2
43387	482040	5	0	1	0	0	1
43387	482058	5	1	1	0	4	6
43387	482090	5	0	1	0	2	3
43387	482096	5	0	2	0	2	4
43387	482101	5	0	1	1	1	3
43387	482107	5	0	4	0	0	4
43387	482112	5	1	2	1	4	8
43387	50462	5	0	0	0	0	0
43387	71506	5	0	1	0	0	1
43387	105251	4	0	0	1	2	3
43387	208280	4	2	2	0	1	5
43387	481986	4	0	1	0	0	1
43387	482005	4	1	2	1	2	6
43387	482010	4	0	2	0	1	3
43387	482017	4	1	2	0	1	4
43387	482018	4	2	1	0	0	3
43387	482027	4	2	3	0	1	6
43387	482041	4	0	1	0	1	2
43387	482042	4	0	3	0	1	4
43387	482046	4	0	3	0	0	3
43387	482053	4	1	1	0	1	3
43387	482055	4	1	1	0	0	2
43387	482056	4	0	1	0	0	1
43387	482057	4	0	1	0	3	4
43387	482064	4	0	0	0	1	1
43387	482065	4	0	2	0	2	4
43387	482074	4	1	2	0	1	4
43387	482080	4	2	1	0	2	5
43387	482082	4	1	1	1	3	6
43387	482083	4	0	0	1	0	1
43387	482086	4	1	1	0	1	3
43387	482087	4	3	3	0	1	7
43387	482089	4	0	2	0	0	2
43387	482098	4	1	3	1	2	7
43387	482099	4	1	1	1	1	4
43387	482108	4	0	2	0	1	3
43387	55187	4	1	2	0	0	3
43387	63920	4	0	1	0	3	4
43387	81925	4	5	4	1	1	11
43387	82231	4	2	1	0	1	4
43387	194600	3	0	0	1	2	3
43387	195695	3	1	2	0	3	6
43387	196599	3	0	1	0	1	2
43387	481979	3	1	0	0	0	1
43387	481991	3	0	1	1	3	5
43387	481992	3	0	1	0	4	5
43387	481993	3	1	1	0	1	3
43387	481995	3	0	2	1	2	5
43387	481996	3	3	0	0	1	4
43387	482002	3	0	0	2	2	4
43387	482004	3	0	1	1	1	3
43387	482011	3	0	2	0	0	2
43387	482013	3	1	1	0	0	2
43387	482015	3	0	0	0	1	1
43387	482019	3	0	0	0	0	0
43387	482025	3	1	1	0	2	4
43387	482026	3	0	1	0	1	2
43387	482030	3	0	1	0	0	1
43387	482034	3	0	0	0	0	0
43387	482037	3	2	0	0	0	2
43387	482044	3	2	0	1	1	4
43387	482048	3	1	0	0	4	5
43387	482050	3	0	2	0	0	2
43387	482051	3	0	2	0	2	4
43387	482052	3	1	0	0	1	2
43387	482059	3	0	2	0	1	3
43387	482060	3	1	0	0	1	2
43387	482066	3	1	0	0	0	1
43387	482067	3	0	0	1	0	1
43387	482070	3	0	1	1	2	4
43387	482071	3	1	1	0	0	2
43387	482081	3	0	1	0	1	2
43387	482100	3	0	1	0	2	3
43387	482102	3	0	0	0	1	1
43387	482105	3	0	0	0	1	1
43387	482113	3	0	0	0	0	0
43387	481981	2	0	1	0	0	1
43387	481983	2	1	2	0	0	3
43387	481990	2	1	1	0	1	3
43387	481998	2	4	0	0	0	4
43387	482007	2	0	0	0	1	1
43387	482012	2	0	1	0	1	2
43387	482023	2	1	0	0	0	1
43387	482043	2	1	0	1	0	2
43387	482045	2	0	1	0	1	2
43387	482054	2	1	1	0	2	4
43387	482061	2	0	1	0	3	4
43387	482062	2	0	1	0	0	1
43387	482063	2	0	0	0	0	0
43387	482072	2	0	1	0	0	1
43387	482077	2	0	0	0	1	1
43387	482078	2	0	0	0	0	0
43387	482079	2	1	0	0	1	2
43387	482088	2	1	0	0	0	1
43387	482092	2	0	0	1	0	1
43387	482093	2	1	2	1	2	6
43387	482095	2	0	0	0	1	1
43387	482097	2	1	0	1	2	4
43387	482104	2	0	0	0	0	0
43387	482110	2	2	0	1	4	7
43387	182045	1	0	0	0	0	0
43387	208812	1	0	0	0	0	0
43387	481980	1	0	0	0	3	3
43387	481982	1	0	0	0	1	1
43387	481984	1	0	0	0	0	0
43387	481985	1	0	0	0	0	0
43387	481989	1	0	0	0	0	0
43387	481994	1	0	2	0	1	3
43387	482003	1	1	1	0	1	3
43387	482014	1	0	0	1	0	1
43387	482020	1	0	1	0	0	1
43387	482021	1	1	2	0	0	3
43387	482022	1	0	0	0	0	0
43387	482033	1	0	1	0	0	1
43387	482049	1	0	1	1	1	3
43387	482073	1	0	0	0	2	2
43387	482091	1	0	0	0	0	0
43387	482094	1	0	0	0	0	0
43387	482103	1	4	2	0	0	6
27764	219735	37	1	5	0	0	6
27764	183380	18	1	2	1	3	7
27764	456579	17	1	2	1	3	7
27764	191066	16	4	2	0	0	6
27764	456572	16	4	2	0	0	6
27764	290457	13	4	2	0	3	9
27764	290471	13	1	3	2	0	6
27764	186044	11	1	4	0	0	5
27764	290473	10	2	1	0	0	3
27764	456578	10	0	1	0	0	1
27764	456626	10	4	3	0	0	7
27764	217002	9	1	2	0	0	3
27764	290474	9	1	2	0	0	3
27764	456583	9	1	2	0	0	3
27764	456590	9	4	3	0	1	8
27764	456611	9	2	1	0	2	5
27764	456618	9	1	2	0	0	3
27764	197229	8	2	0	1	0	3
27764	290472	8	0	1	0	0	1
27764	456570	8	2	4	0	0	6
27764	456576	8	2	0	0	1	3
27764	456582	8	1	0	0	0	1
27764	456637	8	0	4	0	0	4
27764	195684	7	1	4	0	0	5
27764	207277	7	2	0	0	0	2
27764	216395	7	1	0	0	0	1
27764	216690	7	2	1	0	0	3
27764	290464	7	0	1	0	1	2
27764	456568	7	2	3	0	1	6
27764	456577	7	0	1	0	0	1
27764	456640	7	1	0	0	0	1
27764	456648	7	1	1	0	1	3
27764	456656	7	0	1	0	0	1
27764	192212	6	0	1	0	0	1
27764	193548	6	3	2	0	0	5
27764	205264	6	0	3	0	0	3
27764	214124	6	2	3	0	0	5
27764	290466	6	1	2	1	0	4
27764	456585	6	3	2	0	0	5
27764	456602	6	1	3	0	1	5
27764	456609	6	1	1	0	0	2
27764	456617	6	1	1	0	0	2
27764	456632	6	1	0	0	0	1
27764	456643	6	3	0	0	0	3
27764	456644	6	2	1	0	0	3
27764	456659	6	1	3	0	0	4
27764	182657	5	0	1	0	1	2
27764	190480	5	1	0	0	0	1
27764	193128	5	1	3	1	0	5
27764	195568	5	2	3	0	0	5
27764	196082	5	0	1	0	0	1
27764	200700	5	0	3	0	0	3
27764	205889	5	2	1	1	0	4
27764	207449	5	0	0	0	0	0
27764	212383	5	1	0	0	0	1
27764	213562	5	0	0	0	1	1
27764	215870	5	0	2	0	0	2
27764	216003	5	1	5	0	1	7
27764	456561	5	0	0	1	0	1
27764	456563	5	1	2	1	0	4
27764	456567	5	2	2	0	0	4
27764	456569	5	2	1	1	2	6
27764	456584	5	0	2	1	0	3
27764	456593	5	2	3	0	0	5
27764	456594	5	0	0	0	0	0
27764	456598	5	0	0	0	1	1
27764	456599	5	0	0	0	0	0
27764	456603	5	2	0	0	0	2
27764	456605	5	0	2	0	0	2
27764	456607	5	2	4	0	2	8
27764	456608	5	1	1	0	0	2
27764	456610	5	2	3	0	0	5
27764	456612	5	1	1	0	0	2
27764	456625	5	0	2	0	0	2
27764	456631	5	1	1	0	0	2
27764	456635	5	2	1	0	0	3
27764	456642	5	1	0	0	0	1
27764	188442	4	0	1	0	0	1
27764	188500	4	1	0	0	0	1
27764	193036	4	1	0	0	0	1
27764	200147	4	0	1	0	0	1
27764	201301	4	1	3	0	0	4
27764	203195	4	4	0	0	0	4
27764	207587	4	0	2	0	0	2
27764	211315	4	0	3	0	0	3
27764	214482	4	0	0	0	1	1
27764	217143	4	0	1	0	0	1
27764	290456	4	0	3	0	0	3
27764	290459	4	0	3	0	0	3
27764	290475	4	1	1	0	0	2
27764	456560	4	0	0	0	1	1
27764	456573	4	0	1	0	0	1
27764	456574	4	0	0	0	0	0
27764	456581	4	0	1	0	1	2
27764	456586	4	0	1	2	0	3
27764	456592	4	0	1	0	0	1
27764	456595	4	1	2	0	0	3
27764	456601	4	1	1	0	0	2
27764	456604	4	0	1	0	0	1
27764	456606	4	0	1	0	4	5
27764	456614	4	2	2	0	0	4
27764	456620	4	2	0	0	0	2
27764	456622	4	1	1	0	0	2
27764	456636	4	1	1	0	0	2
27764	456638	4	1	0	0	2	3
27764	456641	4	0	0	0	0	0
27764	456645	4	2	1	1	0	4
27764	456646	4	1	1	0	0	2
27764	456649	4	1	1	0	0	2
27764	456650	4	1	0	0	0	1
27764	456654	4	0	1	0	0	1
27764	456658	4	0	0	0	0	0
27764	185440	3	0	1	0	0	1
27764	185767	3	0	2	0	1	3
27764	190452	3	2	2	0	1	5
27764	201979	3	1	1	0	0	2
27764	204509	3	1	1	0	1	3
27764	206466	3	2	2	0	0	4
27764	206919	3	0	3	0	0	3
27764	207182	3	1	1	0	0	2
27764	209595	3	2	1	0	0	3
27764	210752	3	1	1	0	0	2
27764	211976	3	1	1	0	0	2
27764	212683	3	0	0	0	0	0
27764	219625	3	1	2	0	0	3
27764	220378	3	1	0	0	0	1
27764	290455	3	2	0	0	0	2
27764	290458	3	0	0	0	0	0
27764	290460	3	0	1	0	0	1
27764	290462	3	0	0	0	0	0
27764	290463	3	0	1	0	1	2
27764	290467	3	0	1	0	0	1
27764	290468	3	1	1	0	0	2
27764	290469	3	1	1	0	0	2
27764	290470	3	0	0	0	0	0
27764	290477	3	1	0	0	0	1
27764	456562	3	0	0	0	0	0
27764	456564	3	2	1	0	0	3
27764	456571	3	0	1	0	0	1
27764	456575	3	0	1	0	0	1
27764	456587	3	0	0	0	0	0
27764	456589	3	1	1	0	0	2
27764	456591	3	0	1	0	0	1
27764	456596	3	1	0	0	0	1
27764	456597	3	0	1	0	1	2
27764	456615	3	1	2	0	0	3
27764	456616	3	1	2	0	0	3
27764	456619	3	0	1	0	1	2
27764	456624	3	0	0	0	0	0
27764	456627	3	1	1	0	0	2
27764	456633	3	0	0	0	0	0
27764	456655	3	0	3	0	0	3
27764	456657	3	1	2	0	0	3
27764	182178	2	0	1	0	0	1
27764	186907	2	0	1	0	2	3
27764	192836	2	1	1	0	0	2
27764	198051	2	1	0	0	0	1
27764	203423	2	3	1	0	0	4
27764	214231	2	1	1	0	0	2
27764	290461	2	0	1	0	0	1
27764	290465	2	0	0	0	0	0
27764	290476	2	0	0	0	0	0
27764	456565	2	2	2	0	0	4
27764	456580	2	0	1	0	0	1
27764	456621	2	0	1	0	0	1
27764	456628	2	0	2	0	0	2
27764	456629	2	1	2	0	0	3
27764	456630	2	1	0	0	1	2
27764	456639	2	0	2	0	0	2
27764	456647	2	1	0	0	0	1
27764	456651	2	0	0	0	0	0
27764	456652	2	0	0	0	0	0
27764	456653	2	1	0	0	0	1
27764	186680	1	0	0	0	0	0
27764	187119	1	0	0	0	0	0
27764	204898	1	0	0	0	0	0
27764	207077	1	0	0	0	1	1
27764	218609	1	0	0	0	1	1
27764	290478	1	0	0	0	0	0
27764	456566	1	1	1	0	1	3
27764	456588	1	0	0	0	0	0
27764	456600	1	0	0	0	0	0
27764	456613	1	1	0	0	0	1
27764	456623	1	0	0	0	0	0
27764	456634	1	1	1	0	0	2
27764	456660	1	0	0	0	0	0
7485	202323	29	2	3	1	5	11
7485	284869	28	2	3	1	5	11
7485	445490	28	2	3	1	5	11
7485	445514	22	1	1	0	1	3
7485	195324	16	3	1	0	1	5
7485	284889	15	0	1	0	1	2
7485	203066	14	1	3	0	2	6
7485	284888	14	2	1	0	0	3
7485	445489	14	0	2	1	0	3
7485	445518	14	1	3	0	2	6
7485	445541	14	1	3	0	2	6
7485	445510	13	0	0	1	1	2
7485	284884	12	1	0	2	1	4
7485	193106	10	1	2	0	3	6
7485	214009	10	0	1	0	1	2
7485	284880	10	0	2	0	2	4
7485	284887	10	1	1	0	2	4
7485	445529	10	1	0	0	1	2
7485	186048	9	1	0	0	0	1
7485	201671	9	1	0	0	0	1
7485	203826	9	1	1	1	0	3
7485	284874	9	1	0	1	2	4
7485	284893	9	4	1	0	0	5
7485	445496	9	0	1	0	1	2
7485	445498	9	3	2	0	0	5
7485	445527	9	1	0	1	2	4
7485	219858	8	1	3	0	0	4
7485	284875	8	2	0	1	3	6
7485	284878	8	3	4	1	0	8
7485	445492	8	0	2	0	5	7
7485	445545	8	3	4	1	0	8
7485	201975	7	1	1	1	0	3
7485	204172	7	1	3	0	0	4
7485	208036	7	1	2	0	0	3
7485	214834	7	4	1	0	0	5
7485	284872	7	1	1	0	1	3
7485	445484	7	1	1	1	0	3
7485	445540	7	0	1	0	0	1
7485	445543	7	2	0	1	3	6
7485	445576	7	0	1	0	0	1
7485	445591	7	1	3	0	0	4
7485	194858	6	0	3	1	3	7
7485	204817	6	1	1	0	2	4
7485	284871	6	2	3	0	4	9
7485	284883	6	1	1	1	0	3
7485	284892	6	1	1	0	1	3
7485	445494	6	0	1	1	0	2
7485	445524	6	0	3	0	0	3
7485	445526	6	2	0	0	1	3
7485	445536	6	2	0	0	0	2
7485	445565	6	1	3	2	0	6
7485	445572	6	2	3	0	0	5
7485	445581	6	5	1	0	2	8
7485	445588	6	1	1	1	1	4
7485	187771	5	1	0	0	0	1
7485	190070	5	2	1	1	0	4
7485	196492	5	1	1	0	1	3
7485	207203	5	1	1	0	3	5
7485	208932	5	0	1	0	0	1
7485	212969	5	0	1	0	2	3
7485	217259	5	2	1	0	1	4
7485	219988	5	0	2	0	1	3
7485	284870	5	2	1	1	0	4
7485	284873	5	3	1	0	1	5
7485	284881	5	1	1	0	0	2
7485	284886	5	3	0	0	0	3
7485	284894	5	0	0	0	0	0
7485	445491	5	2	1	0	1	4
7485	445504	5	3	1	0	1	5
7485	445511	5	0	1	0	0	1
7485	445516	5	0	3	0	2	5
7485	445520	5	0	1	1	0	2
7485	445530	5	1	0	0	0	1
7485	445533	5	1	2	0	2	5
7485	445538	5	1	2	1	2	6
7485	445544	5	1	2	0	0	3
7485	445561	5	0	1	0	0	1
7485	445575	5	0	1	0	1	2
7485	445584	5	1	1	0	2	4
7485	185532	4	4	4	0	0	8
7485	187955	4	0	2	0	1	3
7485	201444	4	1	2	0	1	4
7485	203963	4	1	2	0	1	4
7485	205537	4	1	1	0	0	2
7485	206037	4	0	0	0	2	2
7485	207648	4	0	4	0	0	4
7485	214204	4	0	0	0	0	0
7485	221582	4	0	0	0	0	0
7485	284876	4	2	1	0	1	4
7485	284879	4	1	0	0	0	1
7485	284885	4	2	0	0	1	3
7485	445486	4	0	0	0	1	1
7485	445503	4	1	0	1	0	2
7485	445505	4	0	1	0	1	2
7485	445508	4	1	1	0	0	2
7485	445513	4	0	4	0	1	5
7485	445532	4	2	1	0	0	3
7485	445535	4	2	0	0	0	2
7485	445548	4	1	1	0	0	2
7485	445550	4	1	0	0	0	1
7485	445551	4	0	1	0	1	2
7485	445560	4	1	0	0	0	1
7485	445562	4	1	1	1	0	3
7485	445564	4	0	2	0	0	2
7485	445566	4	2	1	0	0	3
7485	445574	4	1	2	0	0	3
7485	445578	4	1	3	0	0	4
7485	445579	4	0	1	0	0	1
7485	445583	4	0	0	0	0	0
7485	445587	4	1	1	0	1	3
7485	445593	4	0	0	0	1	1
7485	445595	4	1	3	1	0	5
7485	185878	3	1	2	0	0	3
7485	186587	3	0	0	0	1	1
7485	189926	3	0	0	0	0	0
7485	204880	3	0	1	0	0	1
7485	217916	3	2	0	0	0	2
7485	284877	3	1	0	0	2	3
7485	445485	3	0	1	0	0	1
7485	445488	3	0	0	0	0	0
7485	445502	3	0	0	0	0	0
7485	445507	3	0	0	0	0	0
7485	445512	3	0	2	0	1	3
7485	445515	3	2	2	0	0	4
7485	445523	3	0	1	0	1	2
7485	445534	3	1	3	0	0	4
7485	445542	3	0	1	0	1	2
7485	445546	3	0	1	0	1	2
7485	445549	3	1	1	0	0	2
7485	445552	3	1	0	0	1	2
7485	445553	3	0	0	0	0	0
7485	445554	3	0	1	0	0	1
7485	445556	3	0	1	0	2	3
7485	445557	3	1	1	2	1	5
7485	445559	3	0	2	0	0	2
7485	445567	3	3	0	1	1	5
7485	445568	3	0	0	0	0	0
7485	445569	3	2	0	0	0	2
7485	445570	3	0	0	0	2	2
7485	445571	3	1	0	0	1	2
7485	445573	3	2	1	0	2	5
7485	445577	3	0	0	0	0	0
7485	445580	3	1	1	0	0	2
7485	445582	3	1	1	0	0	2
7485	445589	3	0	0	0	0	0
7485	445590	3	0	0	0	1	1
7485	445592	3	1	0	1	1	3
7485	445594	3	1	1	0	0	2
7485	191601	2	0	0	0	0	0
7485	200121	2	1	2	0	0	3
7485	211630	2	1	0	0	0	1
7485	214644	2	1	0	0	1	2
7485	220095	2	1	1	0	0	2
7485	284868	2	0	1	0	0	1
7485	284890	2	1	1	0	0	2
7485	284891	2	0	0	0	0	0
7485	445493	2	0	1	0	0	1
7485	445497	2	0	1	0	1	2
7485	445499	2	1	2	0	0	3
7485	445501	2	2	1	0	3	6
7485	445509	2	2	1	0	1	4
7485	445517	2	0	2	0	0	2
7485	445525	2	2	2	0	0	4
7485	445528	2	0	0	0	0	0
7485	445537	2	2	0	0	0	2
7485	445539	2	1	0	0	0	1
7485	445547	2	1	0	0	0	1
7485	445558	2	2	1	0	0	3
7485	445563	2	1	2	0	1	4
7485	445585	2	0	1	0	1	2
7485	445586	2	0	0	0	0	0
7485	284882	1	1	0	0	2	3
7485	445483	1	0	1	0	1	2
7485	445487	1	1	1	0	0	2
7485	445495	1	0	1	0	0	1
7485	445500	1	1	2	0	0	3
7485	445506	1	0	0	0	0	0
7485	445519	1	0	0	1	1	2
7485	445521	1	1	2	0	0	3
7485	445522	1	0	2	0	1	3
7485	445531	1	0	0	0	0	0
7485	445555	1	1	1	0	0	2
66730	82190	47	2	3	0	3	8
66730	77696	37	2	2	2	0	6
66730	84986	29	2	5	0	2	9
66730	199048	26	2	4	0	4	10
66730	301013	26	2	4	0	4	10
66730	77625	26	1	1	0	1	3
66730	94584	25	2	5	0	0	7
66730	61627	20	1	5	0	4	10
66730	101206	17	2	4	1	0	7
66730	301022	17	2	4	1	0	7
66730	203064	14	1	5	0	0	6
66730	542590	14	1	5	0	0	6
66730	542598	14	1	5	0	0	6
66730	216138	13	2	5	0	0	7
66730	301015	12	0	0	2	0	2
66730	103273	11	2	5	0	0	7
66730	217397	11	2	5	0	1	8
66730	301021	11	1	0	0	0	1
66730	301023	11	2	5	0	0	7
66730	542592	11	1	3	0	0	4
66730	542602	11	0	1	0	1	2
66730	97813	11	1	0	0	0	1
66730	301012	9	1	2	0	1	4
66730	301018	9	2	2	1	0	5
66730	542609	9	1	4	1	0	6
66730	73805	9	1	2	0	1	4
66730	542621	8	0	5	0	0	5
66730	542629	8	3	4	0	0	7
66730	68232	8	1	3	1	0	5
66730	189761	7	0	1	0	1	2
66730	201225	7	5	1	0	0	6
66730	542588	7	0	0	0	0	0
66730	542612	7	1	1	0	0	2
66730	542614	7	0	6	0	0	6
66730	542642	7	0	1	1	0	2
66730	542644	7	0	2	0	0	2
66730	542669	7	1	4	2	2	9
66730	212678	6	0	1	1	0	2
66730	542596	6	2	2	0	0	4
66730	542635	6	1	0	0	0	1
66730	542651	6	1	1	0	0	2
66730	542668	6	3	2	1	1	7
66730	542682	6	1	3	0	1	5
66730	83978	6	0	1	0	0	1
66730	192205	5	0	1	0	0	1
66730	192362	5	0	0	0	0	0
66730	206282	5	0	0	0	3	3
66730	214808	5	0	2	0	0	2
66730	216661	5	0	0	0	0	0
66730	301019	5	1	0	0	0	1
66730	301020	5	0	2	0	0	2
66730	542616	5	1	1	0	0	2
66730	542618	5	3	1	0	0	4
66730	542622	5	0	0	0	0	0
66730	542623	5	1	0	0	0	1
66730	542633	5	2	1	1	0	4
66730	542636	5	0	2	0	0	2
66730	542637	5	1	0	0	0	1
66730	542643	5	1	0	0	0	1
66730	542650	5	1	1	0	0	2
66730	542664	5	1	2	0	0	3
66730	542675	5	3	2	0	0	5
66730	542676	5	1	0	0	0	1
66730	542686	5	0	0	0	0	0
66730	542688	5	1	1	0	0	2
66730	102222	4	0	2	0	0	2
66730	186864	4	0	0	0	0	0
66730	187919	4	0	3	0	1	4
66730	191558	4	0	0	0	1	1
66730	198250	4	1	4	0	0	5
66730	203097	4	0	2	0	0	2
66730	209608	4	2	1	0	0	3
66730	214121	4	0	0	0	0	0
66730	215206	4	0	0	0	0	0
66730	218889	4	0	0	1	0	1
66730	301008	4	0	4	0	0	4
66730	301009	4	1	3	0	0	4
66730	301011	4	0	2	0	0	2
66730	542585	4	2	2	0	0	4
66730	542586	4	0	2	0	4	6
66730	542587	4	1	1	0	0	2
66730	542589	4	0	1	0	0	1
66730	542593	4	1	0	0	0	1
66730	542601	4	2	5	0	1	8
66730	542606	4	1	1	0	0	2
66730	542611	4	1	4	0	0	5
66730	542617	4	1	2	0	0	3
66730	542624	4	0	0	0	0	0
66730	542628	4	0	3	0	0	3
66730	542641	4	2	2	0	0	4
66730	542653	4	0	3	0	0	3
66730	542663	4	1	3	0	0	4
66730	542666	4	1	1	0	0	2
66730	542673	4	0	0	1	1	2
66730	542674	4	1	2	0	1	4
66730	542680	4	1	1	1	0	3
66730	542684	4	0	0	0	0	0
66730	542687	4	0	1	0	0	1
66730	542693	4	0	1	0	0	1
66730	84756	4	1	3	0	0	4
66730	187156	3	0	1	0	0	1
66730	192665	3	1	1	0	0	2
66730	195950	3	1	0	0	0	1
66730	216770	3	0	0	0	0	0
66730	219843	3	1	2	0	0	3
66730	221073	3	0	0	0	0	0
66730	301010	3	1	2	0	0	3
66730	301017	3	1	0	0	0	1
66730	301024	3	0	0	0	1	1
66730	542594	3	1	0	0	0	1
66730	542600	3	2	3	0	0	5
66730	542608	3	1	0	0	0	1
66730	542610	3	0	0	0	0	0
66730	542625	3	0	0	0	0	0
66730	542626	3	0	0	0	0	0
66730	542630	3	0	0	0	0	0
66730	542631	3	0	2	0	1	3
66730	542634	3	2	1	0	0	3
66730	542638	3	1	0	0	0	1
66730	542645	3	0	0	0	0	0
66730	542648	3	1	1	0	0	2
66730	542649	3	2	1	0	0	3
66730	542652	3	3	0	0	0	3
66730	542656	3	2	1	0	0	3
66730	542657	3	2	3	0	0	5
66730	542662	3	2	0	0	2	4
66730	542665	3	0	0	0	0	0
66730	542667	3	0	0	0	0	0
66730	542692	3	1	0	0	0	1
66730	542695	3	0	0	0	0	0
66730	542697	3	0	1	0	0	1
66730	98016	3	1	2	0	0	3
66730	190380	2	0	0	0	0	0
66730	200066	2	0	0	0	0	0
66730	204586	2	0	1	0	0	1
66730	205918	2	0	3	0	0	3
66730	218600	2	0	0	0	0	0
66730	301014	2	1	1	0	0	2
66730	301016	2	0	2	0	0	2
66730	542584	2	0	1	0	0	1
66730	542591	2	1	1	0	0	2
66730	542595	2	1	1	0	0	2
66730	542597	2	0	2	0	0	2
66730	542603	2	0	1	0	0	1
66730	542604	2	0	2	0	0	2
66730	542605	2	0	0	0	0	0
66730	542607	2	0	2	1	0	3
66730	542613	2	0	1	0	0	1
66730	542619	2	0	1	0	0	1
66730	542620	2	0	0	0	0	0
66730	542632	2	0	0	0	2	2
66730	542654	2	0	0	0	0	0
66730	542655	2	0	2	0	1	3
66730	542660	2	1	2	0	0	3
66730	542661	2	0	0	0	2	2
66730	542670	2	1	1	0	1	3
66730	542672	2	0	0	0	0	0
66730	542677	2	0	3	0	0	3
66730	542678	2	0	0	0	0	0
66730	542679	2	1	1	0	1	3
66730	542685	2	1	0	0	0	1
66730	542691	2	0	0	0	0	0
66730	542694	2	1	2	0	1	4
66730	66021	2	1	1	0	0	2
66730	185208	1	0	1	0	0	1
66730	187070	1	0	1	0	0	1
66730	203345	1	0	0	0	0	0
66730	542599	1	0	0	0	1	1
66730	542615	1	0	0	0	0	0
66730	542627	1	1	1	0	1	3
66730	542639	1	1	0	0	0	1
66730	542640	1	1	0	0	0	1
66730	542646	1	1	0	0	0	1
66730	542647	1	0	1	0	0	1
66730	542658	1	0	1	0	0	1
66730	542659	1	1	2	0	0	3
66730	542671	1	0	0	0	0	0
66730	542681	1	0	1	0	0	1
66730	542683	1	0	1	0	2	3
66730	542689	1	0	0	0	0	0
66730	542690	1	0	1	0	0	1
66730	542696	1	0	0	0	0	0
15152	276623	50	3	2	1	3	9
15152	215520	43	3	8	6	3	20
15152	276619	43	3	8	7	3	21
15152	589819	37	6	0	2	2	10
15152	589769	31	4	4	3	2	13
15152	213642	26	0	4	2	2	8
15152	589773	19	2	1	1	0	4
15152	207551	16	1	2	0	0	3
15152	589814	16	4	0	2	2	8
15152	192690	14	2	1	0	0	3
15152	589793	14	2	1	1	2	6
15152	589805	14	4	0	1	1	6
15152	276624	13	2	1	0	0	3
15152	276625	13	1	1	4	2	8
15152	371830	13	2	1	0	0	3
15152	589796	13	2	1	0	0	3
15152	589799	13	2	1	0	2	5
15152	186318	12	7	2	0	2	11
15152	589834	12	0	0	1	2	3
15152	589840	12	1	2	1	3	7
15152	371828	11	2	0	1	0	3
15152	589798	11	0	1	1	0	2
15152	589807	11	2	1	2	0	5
15152	589784	10	3	0	1	0	4
15152	194430	9	0	0	0	0	0
15152	589780	9	0	1	1	0	2
15152	589781	9	0	1	1	0	2
15152	589782	9	0	1	1	0	2
15152	589811	9	0	0	0	0	0
15152	589818	9	1	0	0	0	1
15152	589865	9	1	1	0	0	2
15152	183412	8	0	5	0	3	8
15152	589810	8	1	1	0	1	3
15152	589870	8	2	0	0	1	3
15152	195940	7	0	0	2	1	3
15152	589792	7	1	0	2	0	3
15152	589808	7	4	0	3	0	7
15152	589838	7	2	0	1	0	3
15152	589868	7	0	1	0	0	1
15152	199493	6	1	0	0	0	1
15152	206103	6	0	1	3	4	8
15152	209632	6	3	1	0	5	9
15152	276620	6	2	1	1	2	6
15152	371829	6	3	2	0	2	7
15152	371831	6	0	0	0	0	0
15152	371832	6	1	1	1	0	3
15152	589790	6	1	1	0	2	4
15152	589797	6	0	1	1	1	3
15152	589813	6	0	1	0	1	2
15152	589820	6	2	0	1	1	4
15152	589823	6	0	0	1	2	3
15152	589872	6	0	0	0	1	1
15152	589877	6	0	1	0	0	1
15152	193595	5	0	0	0	1	1
15152	195275	5	0	0	1	1	2
15152	207667	5	1	0	1	0	2
15152	215382	5	0	0	0	0	0
15152	589772	5	1	1	0	0	2
15152	589783	5	1	2	0	1	4
15152	589787	5	1	1	2	3	7
15152	589788	5	0	2	2	0	4
15152	589802	5	2	1	0	1	4
15152	589825	5	2	1	0	4	7
15152	589842	5	1	1	0	0	2
15152	589843	5	1	0	0	2	3
15152	589845	5	2	0	0	0	2
15152	589849	5	2	1	0	2	5
15152	589866	5	0	0	0	1	1
15152	589871	5	3	1	0	0	4
15152	589873	5	3	0	0	0	3
15152	589875	5	2	0	1	0	3
15152	589878	5	1	0	3	2	6
15152	589879	5	0	0	0	1	1
15152	589891	5	2	0	0	1	3
15152	189685	4	2	1	0	1	4
15152	203142	4	0	0	0	2	2
15152	203346	4	0	0	0	0	0
15152	215229	4	0	0	0	2	2
15152	276628	4	0	0	0	1	1
15152	276629	4	0	0	0	1	1
15152	589770	4	0	1	0	1	2
15152	589794	4	1	0	0	0	1
15152	589806	4	0	1	0	1	2
15152	589822	4	1	2	0	0	3
15152	589824	4	1	0	0	4	5
15152	589833	4	1	0	0	1	2
15152	589835	4	1	1	1	1	4
15152	589839	4	0	1	0	0	1
15152	589848	4	2	0	0	1	3
15152	589852	4	0	0	0	0	0
15152	589853	4	1	0	0	2	3
15152	589859	4	0	1	0	0	1
15152	589861	4	1	0	0	0	1
15152	589889	4	0	0	0	1	1
15152	589893	4	0	0	0	1	1
15152	589894	4	0	1	0	0	1
15152	185553	3	0	0	0	2	2
15152	191337	3	2	0	1	0	3
15152	193749	3	1	1	0	0	2
15152	196106	3	0	0	0	1	1
15152	199941	3	1	0	0	0	1
15152	202968	3	0	1	0	0	1
15152	206711	3	1	0	0	1	2
15152	211845	3	0	0	0	1	1
15152	219025	3	1	1	0	1	3
15152	219817	3	1	0	0	1	2
15152	276621	3	0	0	0	2	2
15152	276622	3	2	1	1	0	4
15152	276626	3	1	1	0	0	2
15152	276627	3	1	0	0	0	1
15152	589764	3	0	0	0	0	0
15152	589767	3	0	0	0	0	0
15152	589768	3	1	2	0	0	3
15152	589791	3	0	0	0	0	0
15152	589800	3	1	2	0	1	4
15152	589803	3	2	1	0	0	3
15152	589812	3	0	0	0	0	0
15152	589817	3	0	0	0	0	0
15152	589821	3	1	2	0	0	3
15152	589836	3	2	1	0	0	3
15152	589841	3	0	0	0	0	0
15152	589844	3	0	0	2	0	2
15152	589846	3	0	0	0	0	0
15152	589850	3	1	1	1	0	3
15152	589851	3	1	0	0	0	1
15152	589867	3	0	0	0	0	0
15152	589869	3	0	1	0	0	1
15152	589876	3	0	0	0	0	0
15152	589880	3	0	1	0	1	2
15152	589881	3	1	0	0	0	1
15152	589882	3	2	0	0	0	2
15152	589885	3	2	2	0	1	5
15152	589887	3	0	0	0	0	0
15152	589888	3	0	0	0	1	1
15152	589890	3	0	0	0	0	0
15152	183982	2	0	0	0	0	0
15152	191403	2	0	1	0	1	2
15152	214413	2	1	2	0	1	4
15152	216530	2	0	0	0	2	2
15152	217416	2	0	0	0	0	0
15152	217441	2	0	0	0	0	0
15152	218900	2	1	0	0	0	1
15152	219106	2	2	0	0	0	2
15152	589765	2	0	0	0	2	2
15152	589766	2	0	0	0	0	0
15152	589771	2	1	2	0	1	4
15152	589785	2	0	1	0	1	2
15152	589786	2	1	0	0	0	1
15152	589789	2	1	0	1	0	2
15152	589801	2	2	3	0	3	8
15152	589804	2	0	1	0	1	2
15152	589809	2	0	1	0	0	1
15152	589826	2	2	0	0	0	2
15152	589827	2	0	0	0	1	1
15152	589829	2	1	0	0	0	1
15152	589830	2	0	1	0	0	1
15152	589832	2	1	2	0	0	3
15152	589837	2	1	0	0	0	1
15152	589854	2	0	2	0	0	2
15152	589857	2	0	1	0	0	1
15152	589860	2	1	0	0	0	1
15152	589862	2	1	0	0	0	1
15152	589863	2	0	0	0	1	1
15152	589864	2	1	0	0	0	1
15152	589874	2	1	3	1	0	5
15152	589883	2	0	0	0	0	0
15152	589886	2	0	1	0	2	3
15152	589892	2	0	1	1	0	2
15152	190088	1	0	0	0	1	1
15152	195652	1	0	0	0	0	0
15152	195660	1	0	0	0	2	2
15152	208357	1	1	0	0	1	2
15152	212481	1	1	0	0	0	1
15152	589815	1	1	1	2	0	4
15152	589816	1	0	1	0	2	3
15152	589828	1	1	1	0	0	2
15152	589831	1	1	0	0	0	1
15152	589847	1	2	0	0	0	2
15152	589855	1	0	0	0	0	0
15152	589856	1	0	0	0	0	0
15152	589858	1	0	0	0	1	1
15152	589884	1	1	2	0	0	3
26945	290234	76	5	14	2	4	25
26945	56769	76	5	14	2	4	25
26945	290242	54	2	3	0	0	5
26945	57517	54	2	5	0	1	8
26945	92203	54	2	3	0	0	5
26945	81805	50	5	12	4	2	23
26945	75006	46	0	2	5	5	12
26945	457438	43	2	3	0	0	5
26945	95998	41	1	11	3	3	18
26945	457420	38	2	11	1	4	18
26945	83576	38	0	4	2	1	7
26945	89186	36	2	1	4	0	7
26945	94636	34	0	4	0	1	5
26945	202321	32	5	3	2	0	10
26945	67311	32	1	0	2	1	4
26945	290230	31	5	3	2	0	10
26945	457410	31	5	3	2	0	10
26945	82742	31	5	3	2	0	10
26945	69980	30	3	1	2	1	7
26945	81720	30	3	2	1	1	7
26945	212938	29	2	3	0	2	7
26945	64961	28	2	1	0	0	3
26945	457427	27	1	10	2	1	14
26945	49720	27	0	5	1	6	12
26945	93056	27	3	0	0	3	6
26945	107517	26	1	8	1	3	13
26945	93392	26	0	0	0	2	2
26945	290240	25	3	4	0	1	8
26945	290243	25	1	6	0	2	9
26945	457437	25	1	1	0	1	3
26945	52230	25	1	6	0	2	9
26945	91398	25	3	4	0	1	8
26945	457407	24	2	4	0	1	7
26945	457426	24	0	0	0	2	2
26945	457432	24	3	4	0	1	8
26945	457439	24	1	6	0	2	9
26945	83637	24	1	1	1	1	4
26945	102703	23	2	1	0	0	3
26945	290229	23	2	1	0	0	3
26945	457429	23	0	3	0	1	4
26945	73699	23	2	1	0	0	3
26945	78759	23	2	2	0	0	4
26945	207884	22	3	4	0	1	8
26945	457430	22	7	5	1	2	15
26945	457419	21	1	8	2	3	14
26945	97341	21	3	3	1	2	9
26945	290228	20	1	3	1	0	5
26945	457397	20	1	1	0	0	2
26945	457403	20	1	3	1	0	5
26945	457412	20	4	7	0	1	12
26945	51835	20	1	1	1	1	4
26945	61973	20	1	3	1	0	5
26945	91765	20	4	7	0	1	12
26945	103465	19	1	2	2	1	6
26945	58078	19	4	5	0	1	10
26945	99170	19	1	0	1	0	2
26945	105936	18	0	0	0	0	0
26945	108450	18	7	2	2	2	13
26945	219427	18	0	0	0	0	0
26945	92956	18	2	2	2	2	8
26945	290236	17	3	1	1	2	7
26945	72062	17	0	5	3	1	9
26945	97723	17	3	1	1	2	7
26945	104391	16	2	4	0	0	6
26945	107430	16	0	1	0	0	1
26945	192667	16	3	5	2	3	13
26945	95633	16	0	3	2	0	5
26945	290237	15	3	4	2	3	12
26945	65617	15	0	0	0	1	1
26945	65960	15	3	4	2	3	12
26945	67194	15	2	1	0	0	3
26945	457422	14	2	2	1	1	6
26945	58713	14	2	0	0	0	2
26945	59315	14	0	1	0	0	1
26945	103316	13	1	4	0	2	7
26945	106889	13	1	2	1	1	5
26945	290231	13	1	1	0	0	2
26945	290233	13	0	1	1	0	2
26945	290235	13	0	1	0	0	1
26945	290239	13	4	4	0	1	9
26945	457415	13	0	1	1	0	2
26945	457418	13	3	3	0	1	7
26945	457431	13	4	4	0	1	9
26945	50069	13	4	4	0	1	9
26945	56932	13	0	1	0	0	1
26945	59531	13	2	1	0	3	6
26945	80733	13	0	1	1	0	2
26945	81743	13	0	1	0	1	2
26945	82962	13	1	3	1	1	6
26945	457424	12	1	2	1	0	4
26945	457433	12	1	3	0	2	6
26945	457436	12	1	6	1	1	9
26945	58964	12	2	1	0	2	5
26945	290241	11	1	3	0	2	6
26945	457428	11	6	4	1	1	12
26945	57669	11	0	1	2	0	3
26945	70447	11	1	3	0	2	6
26945	73622	11	1	3	1	0	5
26945	99883	11	1	3	0	0	4
26945	183145	10	0	0	0	0	0
26945	290232	10	2	1	0	0	3
26945	457416	10	0	0	0	0	0
26945	56067	10	0	3	0	0	3
26945	59261	10	2	1	1	0	4
26945	68842	10	0	3	2	0	5
26945	68871	10	0	0	0	0	0
26945	74602	10	0	1	0	0	1
26945	85621	10	2	1	0	0	3
26945	85993	10	0	4	0	2	6
26945	88510	10	1	2	0	2	5
26945	457411	9	1	4	1	0	6
26945	457423	9	0	0	0	0	0
26945	50657	9	2	0	0	0	2
26945	53250	9	0	0	0	0	0
26945	81232	9	1	3	0	0	4
26945	83989	9	0	1	0	0	1
26945	85426	9	0	2	2	0	4
26945	87354	9	1	0	0	1	2
26945	457413	8	0	0	0	3	3
26945	457434	8	1	3	2	0	6
26945	50505	8	1	2	0	3	6
26945	53343	8	0	0	0	3	3
26945	67168	8	0	1	1	0	2
26945	72514	8	1	1	0	0	2
26945	72643	8	3	2	0	0	5
26945	75582	8	2	3	0	1	6
26945	100606	7	3	3	0	1	7
26945	103682	7	3	0	0	0	3
26945	107739	7	1	1	0	0	2
26945	457408	7	2	1	0	0	3
26945	457435	7	1	5	0	1	7
26945	54517	7	0	6	0	0	6
26945	68350	7	2	2	0	0	4
26945	92215	7	0	2	1	0	3
26945	100888	6	1	2	0	2	5
26945	193620	6	0	1	0	2	3
26945	457399	6	1	2	0	1	4
26945	457401	6	2	2	0	0	4
26945	54473	6	0	4	1	0	5
26945	58652	6	3	1	0	1	5
26945	92136	6	0	3	1	1	5
26945	457421	5	0	0	0	1	1
26945	49843	5	0	4	0	0	4
26945	69487	5	0	0	0	1	1
26945	83445	5	0	3	0	2	5
26945	92533	5	0	0	0	2	2
26945	100162	4	1	2	0	2	5
26945	457398	4	0	2	0	0	2
26945	457402	4	1	0	0	0	1
26945	457404	4	0	2	0	0	2
26945	457405	4	0	2	0	0	2
26945	457406	4	0	2	0	0	2
26945	50007	4	1	2	0	0	3
26945	61029	4	1	2	0	0	3
26945	84196	4	0	1	0	0	1
26945	95287	4	2	4	0	0	6
26945	100858	3	0	3	0	0	3
26945	104522	3	1	1	0	0	2
26945	214154	3	2	0	0	1	3
26945	290238	3	0	1	0	1	2
26945	457394	3	1	3	0	0	4
26945	457414	3	0	2	0	1	3
26945	457417	3	2	2	0	0	4
26945	457425	3	0	2	0	0	2
26945	50880	3	0	1	0	1	2
26945	56296	3	0	2	1	0	3
26945	65537	3	0	1	0	0	1
26945	68818	3	0	1	0	0	1
26945	89247	3	1	2	0	0	3
26945	182014	2	0	1	0	1	2
26945	191259	2	0	0	0	0	0
26945	457392	2	1	2	0	0	3
26945	457393	2	1	2	0	0	3
26945	457396	2	0	1	0	0	1
26945	457409	2	0	1	0	2	3
26945	63714	2	0	5	0	0	5
26945	195826	1	0	2	0	0	2
26945	457395	1	0	0	0	0	0
26945	457400	1	0	0	0	1	1
372	283033	41	2	0	1	1	4
372	51235	41	2	0	1	1	4
372	199991	27	7	8	2	4	21
372	554253	22	2	0	0	1	3
372	185348	17	0	1	0	2	3
372	554265	17	0	1	0	2	3
372	203561	15	1	0	0	0	1
372	554189	14	3	1	2	1	7
372	554186	13	0	1	0	3	4
372	554268	13	6	3	0	6	15
372	221102	12	1	3	0	5	9
372	554162	12	0	0	1	0	1
372	554199	12	0	1	0	0	1
372	554236	12	4	1	0	6	11
372	554241	12	3	1	1	3	8
372	554254	12	3	2	1	1	7
372	204025	11	1	1	0	0	2
372	554190	11	1	0	1	0	2
372	554200	11	2	0	1	1	4
372	554234	11	2	3	0	1	6
372	554251	11	3	1	1	7	12
372	554275	11	2	3	0	5	10
372	189151	10	3	5	0	1	9
372	198278	10	2	1	1	1	5
372	207060	10	2	3	0	1	6
372	554174	10	1	0	0	0	1
372	554179	10	1	3	0	4	8
372	554193	10	0	0	0	0	0
372	554226	10	1	1	0	1	3
372	554242	10	1	0	0	2	3
372	554246	10	3	0	0	5	8
372	554249	10	0	1	0	3	4
372	554252	10	2	2	1	1	6
372	67745	10	1	2	0	0	3
372	206915	9	0	2	0	1	3
372	220323	9	1	1	0	0	2
372	554155	9	1	2	3	1	7
372	554267	9	1	0	0	2	3
372	554286	9	5	4	0	1	10
372	283037	8	1	1	0	0	2
372	554160	8	1	1	1	4	7
372	554196	8	1	0	0	3	4
372	554211	8	2	3	0	2	7
372	554216	8	2	0	0	0	2
372	554217	8	1	0	0	0	1
372	554224	8	1	1	0	1	3
372	554231	8	1	1	0	1	3
372	554260	8	2	4	0	1	7
372	554261	8	2	1	1	1	5
372	554266	8	0	1	1	0	2
372	64204	8	1	1	0	0	2
372	197162	7	0	1	0	1	2
372	197163	7	0	1	0	1	2
372	200612	7	2	0	0	1	3
372	203132	7	1	2	0	1	4
372	203459	7	0	1	1	1	3
372	283034	7	2	0	0	0	2
372	554184	7	1	1	0	1	3
372	554197	7	2	0	0	1	3
372	554198	7	2	0	0	1	3
372	554202	7	1	1	1	1	4
372	554206	7	0	0	0	1	1
372	554210	7	1	1	1	2	5
372	554214	7	0	1	0	1	2
372	554228	7	0	0	0	0	0
372	554235	7	2	1	2	0	5
372	554240	7	2	1	0	1	4
372	554250	7	1	2	0	0	3
372	554264	7	2	0	0	1	3
372	554270	7	2	0	0	2	4
372	554291	7	0	4	0	1	5
372	71592	7	2	0	0	0	2
372	196830	6	0	0	0	0	0
372	199232	6	3	2	0	2	7
372	212647	6	1	1	0	0	2
372	217439	6	2	1	0	2	5
372	554167	6	2	1	0	1	4
372	554168	6	0	1	0	1	2
372	554172	6	0	3	2	1	6
372	554173	6	1	0	0	2	3
372	554178	6	0	1	1	3	5
372	554183	6	1	1	0	0	2
372	554188	6	0	0	1	0	1
372	554194	6	0	0	0	0	0
372	554201	6	0	0	1	1	2
372	554204	6	0	1	0	0	1
372	554209	6	1	1	0	1	3
372	554257	6	1	0	1	1	3
372	554258	6	0	0	0	1	1
372	554278	6	7	2	0	5	14
372	188991	5	1	0	0	2	3
372	195513	5	2	1	0	2	5
372	198170	5	3	0	0	1	4
372	203769	5	1	1	0	0	2
372	213907	5	1	2	0	0	3
372	283035	5	1	1	0	2	4
372	51302	5	1	1	0	2	4
372	554159	5	0	1	0	1	2
372	554164	5	1	1	0	3	5
372	554191	5	2	1	0	0	3
372	554207	5	0	0	0	2	2
372	554212	5	1	1	0	1	3
372	554227	5	1	3	0	1	5
372	554232	5	2	1	0	2	5
372	554238	5	2	1	0	0	3
372	554239	5	1	1	0	0	2
372	554243	5	1	0	0	0	1
372	554248	5	1	0	0	2	3
372	554259	5	0	1	0	0	1
372	554269	5	2	2	0	0	4
372	554274	5	2	0	0	0	2
372	554284	5	1	2	0	1	4
372	554285	5	1	0	2	0	3
372	554287	5	1	2	0	0	3
372	554292	5	1	2	0	0	3
372	190040	4	2	2	1	0	5
372	202064	4	0	1	0	1	2
372	208921	4	1	3	1	1	6
372	554158	4	0	2	0	0	2
372	554165	4	0	0	0	0	0
372	554169	4	1	0	0	0	1
372	554170	4	3	1	0	1	5
372	554181	4	1	0	0	3	4
372	554213	4	1	1	0	0	2
372	554215	4	0	4	0	3	7
372	554219	4	1	0	0	0	1
372	554229	4	1	0	0	2	3
372	554230	4	0	2	0	0	2
372	554237	4	0	0	0	1	1
372	554244	4	1	1	0	0	2
372	554245	4	2	0	1	2	5
372	554247	4	1	2	1	0	4
372	554256	4	1	0	1	0	2
372	554262	4	0	1	0	2	3
372	554272	4	0	0	0	1	1
372	554280	4	5	0	0	3	8
372	554281	4	1	0	0	2	3
372	554282	4	2	2	1	0	5
372	554283	4	0	1	0	0	1
372	201494	3	1	0	0	2	3
372	206961	3	1	1	0	5	7
372	208009	3	4	1	0	2	7
372	213007	3	1	1	0	1	3
372	554154	3	0	0	0	0	0
372	554156	3	1	1	0	0	2
372	554157	3	1	1	0	0	2
372	554161	3	0	0	0	2	2
372	554166	3	1	0	1	1	3
372	554171	3	1	0	0	0	1
372	554177	3	2	1	0	0	3
372	554180	3	1	1	0	0	2
372	554182	3	0	3	0	0	3
372	554185	3	0	0	0	1	1
372	554187	3	0	1	1	1	3
372	554192	3	3	2	0	1	6
372	554195	3	0	1	0	2	3
372	554203	3	0	2	0	0	2
372	554221	3	0	1	1	0	2
372	554222	3	1	0	0	0	1
372	554223	3	0	1	0	1	2
372	554255	3	0	2	0	0	2
372	554263	3	3	1	0	1	5
372	554271	3	0	0	0	1	1
372	554276	3	4	1	0	2	7
372	554279	3	0	1	1	1	3
372	554288	3	1	1	0	0	2
372	220782	2	0	1	0	2	3
372	554163	2	0	0	0	0	0
372	554176	2	1	1	0	2	4
372	554205	2	1	1	0	0	2
372	554208	2	0	0	0	0	0
372	554218	2	1	1	0	0	2
372	554220	2	0	2	0	0	2
372	554273	2	1	3	0	0	4
372	554277	2	0	3	0	3	6
372	554289	2	1	1	0	1	3
372	554290	2	0	1	0	2	3
372	554225	1	2	0	0	0	2
372	554233	1	1	0	0	1	2
31563	492254	31	3	5	1	1	10
31563	492253	19	1	0	1	2	4
31563	492283	15	2	0	0	0	2
31563	492287	13	2	1	3	4	10
31563	492337	13	5	6	2	0	13
31563	291524	11	2	0	1	2	5
31563	492329	11	1	1	1	0	3
31563	217065	10	0	4	0	1	5
31563	492333	10	3	2	1	0	6
31563	492354	10	0	0	0	2	2
31563	291525	9	3	0	0	4	7
31563	492274	9	4	1	0	2	7
31563	492310	9	0	1	1	0	2
31563	492376	9	0	1	0	0	1
31563	291523	8	0	0	1	1	2
31563	492277	8	4	0	0	0	4
31563	492317	8	2	0	0	2	4
31563	492327	8	0	0	1	2	3
31563	492366	8	2	0	0	0	2
31563	492370	8	1	0	0	0	1
31563	492390	8	3	0	0	2	5
31563	527622	8	1	2	0	1	4
31563	291521	7	2	1	0	0	3
31563	291522	7	0	0	0	0	0
31563	492250	7	1	1	0	1	3
31563	492262	7	1	3	1	0	5
31563	492361	7	1	2	0	0	3
31563	492367	7	1	0	0	1	2
31563	492374	7	1	0	0	0	1
31563	492409	7	0	1	0	1	2
31563	186694	6	2	1	0	0	3
31563	492265	6	1	3	0	0	4
31563	492267	6	1	1	0	0	2
31563	492294	6	0	0	0	0	0
31563	492299	6	0	0	0	0	0
31563	492304	6	0	2	0	0	2
31563	492341	6	2	0	0	0	2
31563	492343	6	3	0	0	0	3
31563	492355	6	0	0	0	0	0
31563	492359	6	3	0	0	0	3
31563	492387	6	0	0	0	0	0
31563	492394	6	2	1	0	0	3
31563	492406	6	1	1	1	1	4
31563	492260	5	2	1	0	0	3
31563	492297	5	1	1	0	1	3
31563	492307	5	0	0	0	0	0
31563	492312	5	3	0	0	0	3
31563	492325	5	1	0	0	0	1
31563	492330	5	2	1	0	0	3
31563	492335	5	0	1	0	1	2
31563	492344	5	1	1	0	0	2
31563	492362	5	0	2	1	1	4
31563	492365	5	4	2	0	1	7
31563	492371	5	3	0	0	0	3
31563	492386	5	2	1	0	0	3
31563	492399	5	1	1	0	0	2
31563	492402	5	0	3	0	0	3
31563	188943	4	1	1	0	0	2
31563	189866	4	1	0	0	0	1
31563	291520	4	0	0	0	0	0
31563	492255	4	2	0	0	0	2
31563	492263	4	2	0	0	0	2
31563	492264	4	2	1	0	2	5
31563	492268	4	2	2	0	0	4
31563	492269	4	2	2	0	0	4
31563	492271	4	0	4	1	0	5
31563	492276	4	0	0	0	1	1
31563	492279	4	0	0	0	0	0
31563	492282	4	2	2	0	0	4
31563	492286	4	3	0	0	0	3
31563	492292	4	3	2	0	0	5
31563	492301	4	0	0	1	0	1
31563	492302	4	1	1	1	0	3
31563	492308	4	1	0	0	1	2
31563	492311	4	2	2	0	0	4
31563	492313	4	1	0	0	0	1
31563	492314	4	2	2	0	0	4
31563	492321	4	1	1	0	0	2
31563	492322	4	1	1	2	0	4
31563	492334	4	1	0	0	1	2
31563	492340	4	2	1	0	0	3
31563	492345	4	0	2	1	1	4
31563	492360	4	1	2	0	0	3
31563	492368	4	0	1	2	1	4
31563	492369	4	1	2	0	1	4
31563	492372	4	0	1	1	0	2
31563	492377	4	0	0	0	0	0
31563	492378	4	2	0	0	0	2
31563	492384	4	2	0	0	0	2
31563	492389	4	4	1	0	0	5
31563	492398	4	2	0	0	0	2
31563	492400	4	1	0	0	0	1
31563	492404	4	0	1	0	0	1
31563	492256	3	0	1	0	0	1
31563	492258	3	0	0	0	0	0
31563	492259	3	0	2	0	1	3
31563	492272	3	2	1	0	2	5
31563	492273	3	0	0	0	1	1
31563	492275	3	0	1	0	0	1
31563	492278	3	2	1	0	0	3
31563	492280	3	1	0	0	0	1
31563	492284	3	3	0	0	0	3
31563	492288	3	0	0	0	0	0
31563	492289	3	1	2	0	1	4
31563	492291	3	1	2	0	1	4
31563	492296	3	4	1	0	1	6
31563	492298	3	0	0	0	0	0
31563	492305	3	0	1	1	1	3
31563	492306	3	0	1	0	0	1
31563	492316	3	0	1	0	1	2
31563	492318	3	3	0	0	0	3
31563	492319	3	3	0	0	0	3
31563	492323	3	2	2	0	0	4
31563	492338	3	2	1	0	0	3
31563	492339	3	0	1	0	0	1
31563	492342	3	1	0	0	2	3
31563	492347	3	1	0	0	3	4
31563	492348	3	0	2	1	0	3
31563	492349	3	0	1	0	0	1
31563	492351	3	0	0	0	1	1
31563	492356	3	1	3	1	0	5
31563	492357	3	0	0	0	0	0
31563	492358	3	1	1	1	0	3
31563	492375	3	0	0	0	0	0
31563	492381	3	1	0	0	2	3
31563	492382	3	1	0	0	0	1
31563	492383	3	1	1	0	2	4
31563	492391	3	1	1	0	0	2
31563	492393	3	0	0	0	0	0
31563	492395	3	1	1	0	1	3
31563	492396	3	0	0	0	0	0
31563	492397	3	1	1	0	0	2
31563	492410	3	0	0	0	1	1
31563	181877	2	0	0	0	0	0
31563	185847	2	1	0	0	0	1
31563	291519	2	1	0	0	0	1
31563	492257	2	0	1	0	0	1
31563	492261	2	1	0	0	0	1
31563	492266	2	2	0	0	0	2
31563	492270	2	0	0	0	0	0
31563	492281	2	0	1	0	1	2
31563	492285	2	0	0	0	0	0
31563	492290	2	2	0	0	0	2
31563	492295	2	0	1	0	0	1
31563	492315	2	0	0	0	3	3
31563	492320	2	0	0	0	0	0
31563	492326	2	0	1	1	0	2
31563	492328	2	1	0	0	1	2
31563	492331	2	3	1	0	1	5
31563	492332	2	1	0	0	0	1
31563	492336	2	0	0	0	0	0
31563	492350	2	1	1	1	0	3
31563	492352	2	0	0	0	0	0
31563	492363	2	1	2	1	0	4
31563	492364	2	0	0	0	0	0
31563	492373	2	0	3	1	0	4
31563	492380	2	0	0	0	0	0
31563	492385	2	1	1	0	0	2
31563	492388	2	1	0	0	0	1
31563	492392	2	1	1	0	0	2
31563	492401	2	0	0	0	0	0
31563	492403	2	1	1	0	0	2
31563	492407	2	0	1	0	1	2
31563	492408	2	0	0	0	0	0
31563	492411	2	0	0	0	0	0
31563	527621	2	0	0	0	0	0
31563	527623	2	2	0	0	0	2
31563	492251	1	0	0	0	0	0
31563	492252	1	0	0	0	0	0
31563	492293	1	0	0	0	2	2
31563	492300	1	0	0	0	0	0
31563	492303	1	1	0	0	0	1
31563	492309	1	1	1	0	2	4
31563	492324	1	2	0	0	0	2
31563	492346	1	0	0	0	0	0
31563	492353	1	0	0	0	0	0
31563	492379	1	0	0	0	0	0
31563	492405	1	0	0	0	0	0
31563	492412	1	1	1	0	1	3
58929	298672	22	3	1	2	0	6
58929	455814	16	1	3	1	0	5
58929	455841	16	3	0	0	0	3
58929	217392	14	1	4	0	0	5
58929	220560	14	1	2	1	1	5
58929	455799	14	0	4	1	0	5
58929	455874	14	3	4	1	1	9
58929	298667	13	1	1	1	0	3
58929	298690	13	0	4	1	0	5
58929	455855	13	1	1	1	0	3
58929	455803	12	1	1	0	2	4
58929	455863	12	1	3	1	0	5
58929	206529	11	0	3	1	0	4
58929	455880	11	3	1	1	0	5
58929	197119	10	1	1	0	3	5
58929	210958	10	3	2	0	0	5
58929	219655	10	0	0	0	0	0
58929	455809	10	3	2	0	0	5
58929	455886	10	0	0	2	4	6
58929	216129	9	2	0	0	2	4
58929	298670	9	1	1	1	2	5
58929	298680	9	1	5	1	2	9
58929	298684	9	1	6	1	1	9
58929	298685	9	1	4	0	0	5
58929	455815	9	2	1	0	0	3
58929	455851	9	2	2	0	1	5
58929	214825	8	1	4	0	0	5
58929	298681	8	1	4	0	0	5
58929	298694	8	2	0	0	2	4
58929	455808	8	3	2	0	0	5
58929	455856	8	3	3	0	0	6
58929	455860	8	1	2	0	0	3
58929	182648	7	2	1	0	1	4
58929	215205	7	1	1	0	0	2
58929	298653	7	0	1	0	0	1
58929	298668	7	1	1	0	1	3
58929	298669	7	3	2	0	0	5
58929	298687	7	1	2	0	1	4
58929	298688	7	1	1	0	0	2
58929	455810	7	0	0	0	1	1
58929	455813	7	2	0	0	0	2
58929	455819	7	2	2	0	0	4
58929	455838	7	2	5	0	1	8
58929	455878	7	1	4	1	0	6
58929	455879	7	0	3	0	0	3
58929	455884	7	1	4	1	1	7
58929	188868	6	0	0	2	0	2
58929	190461	6	0	0	0	1	1
58929	208187	6	1	1	0	0	2
58929	213348	6	3	3	0	5	11
58929	218519	6	0	0	0	0	0
58929	298652	6	1	1	0	1	3
58929	298660	6	0	4	0	1	5
58929	298664	6	1	0	0	0	1
58929	298666	6	0	2	1	0	3
58929	298673	6	0	1	0	0	1
58929	298676	6	0	0	0	0	0
58929	298678	6	2	0	1	1	4
58929	298683	6	0	0	2	0	2
58929	455820	6	1	2	0	0	3
58929	455821	6	1	2	0	1	4
58929	455822	6	1	3	0	0	4
58929	455829	6	1	2	1	1	5
58929	455832	6	3	4	0	0	7
58929	455836	6	0	3	0	0	3
58929	455840	6	0	0	2	0	2
58929	455842	6	1	5	0	0	6
58929	455870	6	0	0	0	0	0
58929	455877	6	4	1	1	2	8
58929	455881	6	1	1	0	1	3
58929	204554	5	1	0	0	0	1
58929	206887	5	0	2	0	0	2
58929	214688	5	1	1	0	0	2
58929	219049	5	3	3	1	0	7
58929	298649	5	0	1	1	0	2
58929	298661	5	1	0	0	0	1
58929	298665	5	1	0	2	1	4
58929	298674	5	1	0	0	0	1
58929	298675	5	1	3	0	0	4
58929	298679	5	0	0	0	0	0
58929	298692	5	1	4	0	0	5
58929	455801	5	1	0	0	0	1
58929	455805	5	1	1	0	0	2
58929	455807	5	0	4	0	0	4
58929	455812	5	0	1	0	0	1
58929	455826	5	1	2	0	0	3
58929	455827	5	1	2	0	0	3
58929	455828	5	1	0	0	2	3
58929	455837	5	0	1	0	0	1
58929	455844	5	2	3	0	4	9
58929	455846	5	1	1	0	0	2
58929	455848	5	2	3	2	2	9
58929	455854	5	0	1	0	1	2
58929	455857	5	3	0	1	2	6
58929	455864	5	1	0	0	1	2
58929	455869	5	2	1	0	0	3
58929	455876	5	2	1	2	1	6
58929	455882	5	1	1	0	1	3
58929	182719	4	0	0	1	0	1
58929	186146	4	0	0	0	0	0
58929	192365	4	0	0	0	0	0
58929	195808	4	0	0	0	0	0
58929	197189	4	0	1	0	0	1
58929	205492	4	0	0	1	1	2
58929	298648	4	2	2	0	1	5
58929	298651	4	0	0	0	0	0
58929	298655	4	0	0	0	0	0
58929	298656	4	1	2	0	0	3
58929	298657	4	4	1	1	1	7
58929	298659	4	1	1	2	0	4
58929	298686	4	0	0	0	0	0
58929	298689	4	0	1	0	1	2
58929	455798	4	0	3	0	2	5
58929	455804	4	2	0	0	0	2
58929	455816	4	0	3	0	1	4
58929	455818	4	0	0	0	1	1
58929	455830	4	0	1	1	0	2
58929	455834	4	2	4	0	0	6
58929	455839	4	2	1	0	0	3
58929	455843	4	0	0	0	0	0
58929	455847	4	2	2	1	1	6
58929	455849	4	0	2	0	0	2
58929	455850	4	2	1	0	0	3
58929	455859	4	1	2	0	1	4
58929	455865	4	0	0	0	1	1
58929	455867	4	0	3	0	1	4
58929	455868	4	1	0	1	0	2
58929	455885	4	0	1	0	1	2
58929	184061	3	1	0	0	0	1
58929	189454	3	0	1	0	0	1
58929	190604	3	0	2	0	0	2
58929	214032	3	0	0	0	0	0
58929	219838	3	0	2	0	0	2
58929	298650	3	0	0	1	0	1
58929	298658	3	0	0	0	0	0
58929	298662	3	2	0	0	1	3
58929	298663	3	1	0	0	1	2
58929	431012	3	1	0	0	0	1
58929	455800	3	0	0	0	0	0
58929	455811	3	0	2	0	0	2
58929	455817	3	1	1	0	0	2
58929	455823	3	0	1	0	0	1
58929	455845	3	2	0	1	0	3
58929	455852	3	0	2	0	0	2
58929	455858	3	0	0	0	0	0
58929	455861	3	2	0	1	0	3
58929	455862	3	0	1	1	0	2
58929	455871	3	2	1	0	1	4
58929	455872	3	0	0	0	2	2
58929	455873	3	0	1	0	1	2
58929	455875	3	2	2	0	0	4
58929	455883	3	1	1	0	0	2
58929	455887	3	0	3	0	0	3
58929	455888	3	1	3	2	0	6
58929	196415	2	0	0	0	2	2
58929	206296	2	1	1	0	0	2
58929	216423	2	0	2	3	1	6
58929	298654	2	1	0	0	0	1
58929	298671	2	0	0	0	0	0
58929	298677	2	0	1	0	0	1
58929	298682	2	1	0	0	0	1
58929	298691	2	0	0	0	0	0
58929	298693	2	2	0	0	0	2
58929	455806	2	1	0	0	0	1
58929	455824	2	0	0	0	0	0
58929	455825	2	2	1	0	1	4
58929	455831	2	1	2	0	0	3
58929	455833	2	1	0	0	1	2
58929	455835	2	2	1	0	0	3
58929	455853	2	1	0	0	0	1
58929	455866	2	3	2	0	2	7
58929	186948	1	0	0	0	0	0
58929	191054	1	1	1	1	1	4
58929	193730	1	2	3	0	0	5
58929	203120	1	0	1	0	0	1
58929	203774	1	0	0	1	0	1
58929	211689	1	0	0	0	0	0
58929	455802	1	0	0	0	0	0
9190	103617	59	5	6	2	7	20
9190	88173	56	8	10	3	4	25
9190	104670	21	0	3	1	3	7
9190	506850	17	2	10	0	0	12
9190	76120	17	1	2	0	1	4
9190	506884	14	3	2	0	1	6
9190	77186	14	5	3	0	1	9
9190	93361	14	1	0	0	0	1
9190	66089	12	5	1	0	4	10
9190	208044	11	4	2	0	2	8
9190	275906	11	0	1	0	2	3
9190	50041	11	0	1	0	2	3
9190	506853	11	0	1	0	2	3
9190	506867	11	1	2	0	0	3
9190	506906	11	0	2	0	1	3
9190	75168	11	0	2	0	1	3
9190	85823	11	0	2	0	0	2
9190	87685	11	1	1	1	0	3
9190	506871	10	2	1	0	2	5
9190	506851	9	1	1	0	1	3
9190	506870	9	1	0	0	1	2
9190	506889	9	0	3	0	0	3
9190	506842	8	1	3	0	0	4
9190	506854	8	1	1	0	0	2
9190	506863	8	1	2	1	0	4
9190	506886	8	1	3	2	0	6
9190	56229	8	1	2	0	1	4
9190	63012	8	0	1	0	1	2
9190	85136	8	0	2	0	0	2
9190	187778	7	0	1	0	0	1
9190	188975	7	1	1	0	0	2
9190	275918	7	2	1	0	0	3
9190	275919	7	0	2	0	0	2
9190	506878	7	1	1	0	1	3
9190	506902	7	1	1	0	0	2
9190	88176	7	1	1	0	0	2
9190	92505	7	0	1	0	0	1
9190	102845	6	0	1	0	0	1
9190	192573	6	2	1	1	1	5
9190	200766	6	0	2	0	0	2
9190	217299	6	3	2	0	1	6
9190	275908	6	0	3	0	0	3
9190	506877	6	3	3	0	1	7
9190	506888	6	1	1	1	0	3
9190	506916	6	0	2	0	0	2
9190	86901	6	0	2	0	0	2
9190	105728	5	0	1	0	1	2
9190	108052	5	0	1	0	0	1
9190	186465	5	0	1	0	0	1
9190	203072	5	0	1	0	0	1
9190	204613	5	1	1	0	0	2
9190	209309	5	1	1	0	0	2
9190	209610	5	0	1	1	0	2
9190	219616	5	0	1	0	1	2
9190	275920	5	0	2	0	0	2
9190	506872	5	2	3	0	0	5
9190	506879	5	0	1	0	0	1
9190	506880	5	1	2	0	1	4
9190	506881	5	0	3	0	0	3
9190	506883	5	0	1	0	0	1
9190	62384	5	0	2	0	1	3
9190	63103	5	2	0	2	0	4
9190	98297	5	0	4	0	1	5
9190	98533	5	0	0	0	1	1
9190	104098	4	2	1	1	0	4
9190	105040	4	0	1	0	0	1
9190	105575	4	0	0	0	0	0
9190	108390	4	2	2	0	0	4
9190	182708	4	0	0	0	0	0
9190	187048	4	1	1	0	0	2
9190	189463	4	0	1	0	0	1
9190	191993	4	0	2	0	0	2
9190	200518	4	0	1	1	0	2
9190	203984	4	0	1	0	1	2
9190	209655	4	1	2	0	0	3
9190	211375	4	1	1	0	1	3
9190	212961	4	0	2	1	0	3
9190	214352	4	1	3	0	0	4
9190	215996	4	0	3	0	0	3
9190	216620	4	0	3	0	1	4
9190	275907	4	0	1	0	1	2
9190	275910	4	0	1	0	0	1
9190	275911	4	1	3	0	0	4
9190	275915	4	2	2	0	0	4
9190	275916	4	0	2	0	0	2
9190	275922	4	0	0	0	0	0
9190	506843	4	0	1	0	0	1
9190	506844	4	1	2	0	1	4
9190	506855	4	1	2	0	0	3
9190	506856	4	0	3	0	0	3
9190	506859	4	0	1	0	0	1
9190	506860	4	2	2	0	0	4
9190	506876	4	0	0	0	0	0
9190	506882	4	2	0	0	1	3
9190	506887	4	0	1	0	0	1
9190	506892	4	0	1	1	0	2
9190	506895	4	0	0	0	0	0
9190	506897	4	0	3	0	0	3
9190	506900	4	0	2	0	0	2
9190	506904	4	1	0	0	0	1
9190	506914	4	0	0	0	1	1
9190	506915	4	0	0	0	0	0
9190	51415	4	2	1	0	0	3
9190	55443	4	1	5	0	0	6
9190	55718	4	0	1	0	0	1
9190	68755	4	0	1	0	0	1
9190	85092	4	0	0	0	0	0
9190	92160	4	1	1	0	0	2
9190	99709	4	0	1	0	1	2
9190	107963	3	1	2	0	0	3
9190	184269	3	0	1	0	0	1
9190	190429	3	0	0	0	0	0
9190	194255	3	0	0	0	0	0
9190	215710	3	0	2	0	0	2
9190	275904	3	0	0	0	0	0
9190	275909	3	0	0	0	0	0
9190	275914	3	0	3	0	0	3
9190	275921	3	1	1	0	0	2
9190	506845	3	0	1	0	1	2
9190	506847	3	0	0	0	1	1
9190	506857	3	0	2	0	0	2
9190	506861	3	0	1	0	0	1
9190	506862	3	1	1	0	0	2
9190	506865	3	0	2	0	0	2
9190	506868	3	0	2	0	0	2
9190	506869	3	0	1	0	0	1
9190	506873	3	1	0	0	0	1
9190	506890	3	1	1	0	0	2
9190	506893	3	1	1	0	0	2
9190	506894	3	0	1	0	0	1
9190	506896	3	1	3	0	0	4
9190	506899	3	0	1	0	0	1
9190	506903	3	1	1	0	0	2
9190	506905	3	3	1	0	0	4
9190	506907	3	2	2	0	0	4
9190	506908	3	2	1	0	0	3
9190	506909	3	0	1	0	0	1
9190	506910	3	1	3	0	0	4
9190	506912	3	1	1	0	0	2
9190	506913	3	2	2	0	0	4
9190	67113	3	1	1	0	0	2
9190	79584	3	1	0	0	0	1
9190	84091	3	1	0	0	0	1
9190	85279	3	0	1	1	0	2
9190	85581	3	0	1	0	0	1
9190	182217	2	1	3	0	0	4
9190	194390	2	0	0	0	0	0
9190	203870	2	0	1	0	0	1
9190	207583	2	0	2	0	0	2
9190	275912	2	1	1	0	0	2
9190	275913	2	0	1	0	0	1
9190	275917	2	1	1	0	0	2
9190	506846	2	1	1	0	0	2
9190	506849	2	0	2	0	0	2
9190	506852	2	0	1	0	0	1
9190	506858	2	0	1	0	0	1
9190	506864	2	0	0	0	0	0
9190	506875	2	0	1	0	0	1
9190	506885	2	1	0	0	0	1
9190	506891	2	1	0	0	2	3
9190	506901	2	0	3	1	1	5
9190	57218	2	0	1	0	0	1
9190	66756	2	0	2	0	0	2
9190	81939	2	1	2	0	0	3
9190	84821	2	0	0	0	0	0
9190	97181	2	1	0	0	0	1
9190	102788	1	1	1	0	0	2
9190	204398	1	0	0	0	0	0
9190	506841	1	0	1	0	0	1
9190	506848	1	0	0	0	0	0
9190	506866	1	2	1	0	0	3
9190	506874	1	0	3	0	0	3
9190	506898	1	0	1	0	0	1
9190	506911	1	0	1	1	0	2
9190	72553	1	2	0	0	0	2
47023	93071	41	3	6	1	1	11
47023	92549	35	8	9	0	7	24
47023	295697	32	1	2	0	2	5
47023	210195	31	4	10	0	6	20
47023	295700	31	4	10	0	6	20
47023	93231	31	4	10	0	6	20
47023	76842	30	1	2	0	2	5
47023	448501	25	1	1	1	1	4
47023	107277	20	1	5	0	1	7
47023	448485	19	2	3	1	1	7
47023	58292	18	1	0	0	2	3
47023	102147	17	1	2	1	4	8
47023	68994	17	2	4	2	0	8
47023	102951	16	5	4	1	0	10
47023	295692	16	5	4	1	0	10
47023	295695	16	2	1	0	1	4
47023	448435	16	5	4	1	0	10
47023	56957	16	2	1	0	1	4
47023	448495	15	2	1	0	1	4
47023	82272	15	1	3	0	1	5
47023	106127	12	0	2	0	0	2
47023	59280	12	0	2	0	1	3
47023	448491	11	1	6	0	1	8
47023	80393	11	2	5	1	4	12
47023	295698	10	0	2	0	0	2
47023	97759	10	0	2	0	0	2
47023	448471	9	1	5	0	1	7
47023	448487	9	2	2	1	0	5
47023	49962	9	1	2	0	0	3
47023	204454	8	0	1	0	0	1
47023	448494	8	0	2	0	1	3
47023	90132	8	0	0	0	2	2
47023	102391	7	1	5	1	0	7
47023	295694	7	0	1	0	0	1
47023	448405	7	1	1	0	0	2
47023	448410	7	0	0	0	0	0
47023	448431	7	0	2	0	2	4
47023	448450	7	0	4	0	0	4
47023	448457	7	0	5	0	0	5
47023	448482	7	0	1	1	4	6
47023	448499	7	2	2	0	0	4
47023	61270	7	0	0	0	1	1
47023	66631	7	0	2	0	2	4
47023	84458	7	0	1	0	0	1
47023	86306	7	1	1	1	1	4
47023	448399	6	0	1	0	0	1
47023	448447	6	0	3	0	0	3
47023	448460	6	1	3	1	0	5
47023	448473	6	2	0	0	2	4
47023	448500	6	2	2	0	1	5
47023	51199	6	2	0	0	3	5
47023	51944	6	1	3	0	0	4
47023	56364	6	0	1	0	2	3
47023	57371	6	0	3	0	1	4
47023	57470	6	0	1	0	0	1
47023	74718	6	1	3	1	0	5
47023	207155	5	0	1	0	0	1
47023	295699	5	0	2	0	0	2
47023	448398	5	0	1	0	0	1
47023	448402	5	0	3	0	0	3
47023	448427	5	0	1	0	0	1
47023	448436	5	1	1	0	0	2
47023	448446	5	1	2	0	2	5
47023	448459	5	1	2	0	1	4
47023	448466	5	0	0	0	0	0
47023	448492	5	0	1	0	0	1
47023	448505	5	2	2	0	0	4
47023	448507	5	1	0	0	0	1
47023	53150	5	0	1	0	0	1
47023	61780	5	0	2	0	0	2
47023	77147	5	1	0	0	0	1
47023	448406	4	1	2	0	3	6
47023	448407	4	0	0	0	1	1
47023	448409	4	0	0	0	0	0
47023	448414	4	1	2	0	0	3
47023	448416	4	0	1	0	0	1
47023	448418	4	0	0	0	1	1
47023	448421	4	2	1	0	1	4
47023	448425	4	2	1	0	0	3
47023	448429	4	1	2	0	0	3
47023	448433	4	2	2	0	0	4
47023	448434	4	1	1	0	1	3
47023	448437	4	1	2	0	0	3
47023	448439	4	1	1	0	0	2
47023	448441	4	0	0	0	0	0
47023	448442	4	0	1	1	2	4
47023	448449	4	0	0	0	0	0
47023	448458	4	2	0	1	1	4
47023	448463	4	1	0	0	1	2
47023	448472	4	0	0	0	0	0
47023	448476	4	2	2	0	0	4
47023	448477	4	2	2	0	0	4
47023	448483	4	2	2	0	0	4
47023	448484	4	1	1	0	0	2
47023	448489	4	1	0	0	0	1
47023	448504	4	1	0	0	0	1
47023	86399	4	0	1	0	0	1
47023	96660	4	0	0	0	0	0
47023	108706	3	0	0	0	0	0
47023	183950	3	1	0	0	0	1
47023	193605	3	0	0	0	0	0
47023	295690	3	1	2	0	1	4
47023	295693	3	0	2	0	0	2
47023	295696	3	0	0	0	0	0
47023	448408	3	0	3	0	0	3
47023	448413	3	0	3	0	0	3
47023	448415	3	0	0	0	0	0
47023	448419	3	2	3	0	0	5
47023	448422	3	0	1	0	0	1
47023	448423	3	0	3	0	0	3
47023	448424	3	2	1	0	0	3
47023	448426	3	1	1	0	0	2
47023	448443	3	0	1	0	0	1
47023	448445	3	0	3	0	0	3
47023	448451	3	2	1	0	0	3
47023	448454	3	0	4	0	0	4
47023	448455	3	1	5	0	0	6
47023	448456	3	1	2	0	0	3
47023	448474	3	1	0	0	0	1
47023	448478	3	0	1	0	0	1
47023	448480	3	0	1	0	0	1
47023	448481	3	1	2	0	0	3
47023	448486	3	1	1	0	0	2
47023	448488	3	2	1	0	1	4
47023	448490	3	0	1	0	0	1
47023	448509	3	0	0	1	0	1
47023	67671	3	0	3	0	1	4
47023	71634	3	0	2	0	0	2
47023	72488	3	2	0	0	1	3
47023	73850	3	0	0	0	0	0
47023	76257	3	2	2	0	0	4
47023	92824	3	0	0	0	0	0
47023	182252	2	2	1	0	0	3
47023	448400	2	0	1	0	0	1
47023	448412	2	0	1	0	0	1
47023	448420	2	0	1	0	0	1
47023	448428	2	0	1	0	0	1
47023	448430	2	0	0	0	0	0
47023	448432	2	0	2	0	0	2
47023	448452	2	0	2	0	0	2
47023	448461	2	0	2	0	1	3
47023	448462	2	0	1	0	0	1
47023	448464	2	0	1	0	0	1
47023	448465	2	1	1	0	0	2
47023	448468	2	0	2	0	0	2
47023	448469	2	2	1	0	0	3
47023	448475	2	0	0	0	0	0
47023	448479	2	0	0	0	2	2
47023	448493	2	0	1	0	0	1
47023	448498	2	0	1	0	0	1
47023	448502	2	1	0	0	0	1
47023	56365	2	4	0	0	0	4
47023	62386	2	0	2	0	0	2
47023	67755	2	2	1	1	1	5
47023	83503	2	0	1	0	2	3
47023	295691	1	0	0	0	0	0
47023	448397	1	0	0	0	1	1
47023	448401	1	1	2	0	0	3
47023	448403	1	0	1	0	0	1
47023	448404	1	1	1	0	0	2
47023	448411	1	0	0	0	0	0
47023	448417	1	0	1	0	0	1
47023	448438	1	0	0	0	0	0
47023	448440	1	0	1	0	0	1
47023	448444	1	0	2	0	0	2
47023	448448	1	0	3	0	0	3
47023	448453	1	0	1	0	0	1
47023	448467	1	1	1	0	1	3
47023	448470	1	0	3	0	0	3
47023	448496	1	1	3	0	1	5
47023	448497	1	0	0	0	1	1
47023	448503	1	1	1	0	0	2
47023	448506	1	0	0	0	0	0
47023	448508	1	1	2	0	0	3
47023	78440	1	0	0	1	1	2
40931	189002	21	1	0	1	0	2
40931	501340	20	3	5	1	3	12
40931	501251	15	2	3	1	2	8
40931	501277	13	0	0	1	0	1
40931	501313	13	0	0	1	1	2
40931	501275	12	2	0	0	1	3
40931	205246	11	0	1	1	0	2
40931	501211	11	2	0	0	0	2
40931	501229	11	2	0	1	2	5
40931	501257	11	0	1	1	1	3
40931	501270	11	0	1	1	2	4
40931	501282	11	0	3	3	0	6
40931	501293	11	0	2	0	1	3
40931	195243	10	0	1	0	2	3
40931	196886	10	0	3	0	0	3
40931	501281	10	4	5	0	3	12
40931	501299	10	3	3	1	0	7
40931	501202	9	0	2	0	0	2
40931	501213	9	2	1	0	0	3
40931	501214	9	0	4	1	0	5
40931	501217	9	0	1	1	2	4
40931	501226	9	3	1	0	1	5
40931	501236	9	2	1	1	0	4
40931	501252	9	0	0	0	1	1
40931	501256	9	1	0	0	1	2
40931	501267	9	0	1	1	3	5
40931	501289	9	1	2	0	3	6
40931	501294	9	0	2	0	3	5
40931	501298	9	4	1	0	0	5
40931	501312	9	0	0	0	2	2
40931	501315	9	1	2	0	1	4
40931	501330	9	3	0	0	0	3
40931	294144	8	1	0	0	0	1
40931	501210	8	0	0	2	2	4
40931	501215	8	1	1	0	1	3
40931	501216	8	0	0	0	1	1
40931	501233	8	0	1	0	1	2
40931	501266	8	1	2	0	0	3
40931	501272	8	0	0	0	1	1
40931	501314	8	0	3	0	0	3
40931	501322	8	1	2	0	0	3
40931	501326	8	1	0	0	0	1
40931	501331	8	2	1	0	1	4
40931	209260	7	3	1	0	0	4
40931	501221	7	1	2	0	4	7
40931	501230	7	0	0	0	1	1
40931	501254	7	1	0	0	0	1
40931	501269	7	1	0	0	0	1
40931	501291	7	1	0	0	1	2
40931	501306	7	2	0	2	1	5
40931	501307	7	1	0	0	2	3
40931	501327	7	0	4	0	2	6
40931	501329	7	0	0	0	0	0
40931	501332	7	1	0	0	2	3
40931	195001	6	0	1	0	1	2
40931	203263	6	1	1	0	0	2
40931	215365	6	0	1	0	0	1
40931	215381	6	0	1	0	0	1
40931	294150	6	4	0	0	0	4
40931	294151	6	0	0	0	3	3
40931	501228	6	1	2	0	3	6
40931	501232	6	2	1	0	2	5
40931	501238	6	0	1	0	0	1
40931	501241	6	1	1	0	0	2
40931	501258	6	0	1	0	2	3
40931	501304	6	0	1	1	2	4
40931	501308	6	1	0	1	0	2
40931	501317	6	2	1	0	2	5
40931	501325	6	0	0	1	0	1
40931	501335	6	1	3	0	2	6
40931	208005	5	0	1	0	0	1
40931	210746	5	1	3	0	0	4
40931	501204	5	0	1	1	2	4
40931	501206	5	3	0	1	1	5
40931	501218	5	0	1	0	0	1
40931	501225	5	1	0	0	0	1
40931	501235	5	1	1	0	1	3
40931	501237	5	2	0	0	0	2
40931	501255	5	0	6	1	0	7
40931	501263	5	0	0	0	0	0
40931	501271	5	2	1	0	1	4
40931	501280	5	1	0	1	0	2
40931	501287	5	3	0	0	0	3
40931	501300	5	1	1	0	0	2
40931	501302	5	2	1	0	0	3
40931	501311	5	1	2	0	1	4
40931	501320	5	0	1	0	3	4
40931	501323	5	1	0	0	1	2
40931	501328	5	2	0	0	0	2
40931	501337	5	0	2	0	4	6
40931	210420	4	1	0	0	0	1
40931	221101	4	1	5	0	1	7
40931	294146	4	1	1	0	0	2
40931	294149	4	2	2	0	0	4
40931	501203	4	1	0	0	0	1
40931	501219	4	1	0	0	1	2
40931	501220	4	1	0	2	0	3
40931	501223	4	1	2	1	1	5
40931	501224	4	0	0	0	0	0
40931	501227	4	2	1	0	1	4
40931	501231	4	0	1	0	1	2
40931	501239	4	1	1	0	0	2
40931	501243	4	0	2	0	0	2
40931	501244	4	0	4	0	0	4
40931	501246	4	1	0	0	0	1
40931	501249	4	1	0	1	0	2
40931	501250	4	0	0	0	0	0
40931	501253	4	2	3	0	2	7
40931	501260	4	0	1	0	1	2
40931	501261	4	1	0	0	1	2
40931	501262	4	0	0	0	0	0
40931	501273	4	0	0	0	2	2
40931	501276	4	0	1	0	0	1
40931	501278	4	1	0	0	0	1
40931	501292	4	1	0	0	1	2
40931	501303	4	1	0	0	1	2
40931	501305	4	0	0	0	1	1
40931	501310	4	1	1	0	0	2
40931	501316	4	0	0	0	2	2
40931	501333	4	2	0	0	0	2
40931	501339	4	0	0	0	0	0
40931	191884	3	1	0	0	0	1
40931	197503	3	0	2	2	1	5
40931	215162	3	0	1	0	1	2
40931	215880	3	0	0	0	0	0
40931	216363	3	0	1	1	0	2
40931	216761	3	0	1	0	1	2
40931	217675	3	0	0	0	1	1
40931	294145	3	0	2	2	1	5
40931	501201	3	0	2	0	0	2
40931	501205	3	0	2	0	0	2
40931	501207	3	0	0	0	1	1
40931	501208	3	0	1	0	0	1
40931	501212	3	0	0	1	1	2
40931	501245	3	0	1	0	1	2
40931	501259	3	0	0	0	0	0
40931	501265	3	0	0	1	0	1
40931	501279	3	1	1	0	0	2
40931	501284	3	1	0	0	0	1
40931	501285	3	0	0	0	0	0
40931	501286	3	1	0	3	2	6
40931	501288	3	1	0	0	0	1
40931	501301	3	1	0	0	1	2
40931	501318	3	1	0	1	0	2
40931	501321	3	0	0	1	0	1
40931	501324	3	2	1	1	0	4
40931	501336	3	0	2	0	0	2
40931	501338	3	0	1	0	1	2
40931	190093	2	0	1	0	0	1
40931	200115	2	0	0	1	0	1
40931	217694	2	0	2	0	2	4
40931	218948	2	0	1	0	0	1
40931	294147	2	0	1	0	0	1
40931	294148	2	1	0	0	0	1
40931	501209	2	1	0	0	2	3
40931	501234	2	1	1	0	0	2
40931	501242	2	1	0	0	1	2
40931	501248	2	0	0	1	0	1
40931	501264	2	0	0	1	2	3
40931	501268	2	2	0	0	0	2
40931	501283	2	0	2	0	0	2
40931	501290	2	2	0	0	0	2
40931	501334	2	0	0	0	0	0
40931	501197	1	1	0	0	0	1
40931	501198	1	0	0	0	0	0
40931	501199	1	0	0	0	1	1
40931	501200	1	0	1	0	1	2
40931	501222	1	0	0	0	0	0
40931	501240	1	0	0	0	0	0
40931	501247	1	0	0	0	0	0
40931	501274	1	1	0	0	1	2
40931	501295	1	1	0	0	1	2
40931	501296	1	0	1	0	0	1
40931	501297	1	0	0	1	0	1
40931	501309	1	0	0	0	0	0
40931	501319	1	0	0	0	0	0
17852	562226	13	0	1	0	1	2
17852	199418	11	1	0	0	0	1
17852	287847	11	0	2	0	0	2
17852	562232	11	0	2	0	0	2
17852	454698	10	0	0	0	0	0
17852	562256	10	1	1	0	0	2
17852	562236	9	1	0	1	0	2
17852	562253	9	2	0	0	0	2
17852	562308	9	1	2	0	0	3
17852	562270	8	1	3	0	0	4
17852	562273	8	1	1	0	1	3
17852	562277	8	0	0	0	0	0
17852	562337	8	0	0	0	0	0
17852	423166	7	2	2	0	0	4
17852	562328	7	0	3	0	0	3
17852	562343	7	3	1	0	0	4
17852	211337	6	2	0	0	1	3
17852	287844	6	3	2	0	2	7
17852	287846	6	1	1	0	0	2
17852	423175	6	1	5	0	0	6
17852	562235	6	1	2	0	0	3
17852	562245	6	2	2	0	0	4
17852	562246	6	1	2	0	0	3
17852	562264	6	0	0	0	1	1
17852	562298	6	0	0	0	0	0
17852	562299	6	2	1	0	0	3
17852	562300	6	0	1	0	0	1
17852	562302	6	2	0	0	2	4
17852	562316	6	0	0	0	2	2
17852	562338	6	3	2	0	0	5
17852	562359	6	2	0	0	0	2
17852	216854	5	2	1	0	1	4
17852	220721	5	1	1	0	0	2
17852	423172	5	0	2	0	0	2
17852	423173	5	0	3	0	0	3
17852	454701	5	1	3	0	0	4
17852	454703	5	0	1	0	0	1
17852	562241	5	1	0	0	0	1
17852	562252	5	0	2	0	0	2
17852	562271	5	0	0	0	0	0
17852	562278	5	0	0	0	0	0
17852	562288	5	0	1	2	0	3
17852	562334	5	1	1	0	0	2
17852	562335	5	3	0	0	0	3
17852	562340	5	3	0	0	1	4
17852	562344	5	1	3	0	0	4
17852	562345	5	2	1	0	0	3
17852	562352	5	1	1	0	0	2
17852	562354	5	1	1	0	0	2
17852	187044	4	3	1	0	0	4
17852	206259	4	2	2	0	0	4
17852	221079	4	0	3	0	0	3
17852	423164	4	0	2	0	0	2
17852	423167	4	1	4	0	0	5
17852	423174	4	1	1	0	0	2
17852	423176	4	3	1	0	0	4
17852	454699	4	1	1	0	0	2
17852	562225	4	1	3	0	0	4
17852	562227	4	1	2	1	0	4
17852	562231	4	1	2	0	0	3
17852	562233	4	0	0	0	0	0
17852	562239	4	2	2	0	0	4
17852	562242	4	1	1	0	0	2
17852	562248	4	0	2	0	2	4
17852	562262	4	0	1	1	0	2
17852	562267	4	0	0	0	0	0
17852	562276	4	0	2	0	1	3
17852	562285	4	1	0	0	0	1
17852	562291	4	2	2	0	0	4
17852	562295	4	0	1	0	0	1
17852	562296	4	1	2	0	0	3
17852	562310	4	1	1	0	1	3
17852	562317	4	1	0	0	1	2
17852	562318	4	1	0	0	0	1
17852	562322	4	1	1	0	0	2
17852	562323	4	2	1	0	0	3
17852	562329	4	2	0	1	0	3
17852	562330	4	0	1	1	0	2
17852	562331	4	1	0	0	0	1
17852	562332	4	0	0	0	1	1
17852	562347	4	0	1	0	0	1
17852	562350	4	1	2	0	0	3
17852	562353	4	1	0	0	0	1
17852	562356	4	1	1	0	0	2
17852	181886	3	0	1	0	0	1
17852	287845	3	0	2	0	0	2
17852	423170	3	0	2	0	1	3
17852	423171	3	0	0	0	0	0
17852	454700	3	1	2	0	0	3
17852	562228	3	1	2	1	0	4
17852	562240	3	0	1	0	0	1
17852	562244	3	0	3	0	0	3
17852	562251	3	0	1	0	0	1
17852	562255	3	0	7	0	1	8
17852	562257	3	0	2	0	0	2
17852	562258	3	0	2	0	0	2
17852	562259	3	0	2	0	0	2
17852	562261	3	0	0	0	0	0
17852	562268	3	0	1	0	0	1
17852	562272	3	2	1	0	0	3
17852	562275	3	0	0	0	0	0
17852	562281	3	0	1	0	0	1
17852	562282	3	0	1	0	0	1
17852	562283	3	0	3	0	0	3
17852	562284	3	0	0	0	0	0
17852	562289	3	0	1	0	0	1
17852	562290	3	2	1	0	0	3
17852	562294	3	0	0	0	0	0
17852	562305	3	1	0	0	0	1
17852	562309	3	0	3	0	0	3
17852	562312	3	1	1	0	0	2
17852	562313	3	0	1	0	0	1
17852	562314	3	0	0	0	0	0
17852	562315	3	1	1	0	0	2
17852	562321	3	1	1	0	0	2
17852	562324	3	0	2	0	0	2
17852	562325	3	0	1	0	0	1
17852	562326	3	1	3	0	0	4
17852	562327	3	0	0	0	0	0
17852	562336	3	0	1	0	0	1
17852	562341	3	1	1	0	0	2
17852	562348	3	2	1	0	0	3
17852	562357	3	0	1	0	0	1
17852	287848	2	0	1	0	0	1
17852	423168	2	0	1	0	0	1
17852	423177	2	1	1	0	0	2
17852	423178	2	0	3	0	0	3
17852	423179	2	0	1	0	0	1
17852	454702	2	1	1	0	0	2
17852	562237	2	1	1	0	0	2
17852	562238	2	1	0	0	0	1
17852	562247	2	2	1	0	0	3
17852	562249	2	0	1	0	2	3
17852	562250	2	0	1	0	0	1
17852	562260	2	0	1	0	0	1
17852	562263	2	0	0	0	0	0
17852	562265	2	0	2	0	0	2
17852	562274	2	0	0	0	0	0
17852	562279	2	0	0	0	0	0
17852	562280	2	0	0	0	0	0
17852	562286	2	0	0	0	0	0
17852	562292	2	1	1	0	1	3
17852	562293	2	1	1	0	0	2
17852	562297	2	1	0	0	0	1
17852	562301	2	0	1	0	0	1
17852	562303	2	0	0	0	0	0
17852	562306	2	1	0	0	0	1
17852	562311	2	0	1	0	0	1
17852	562319	2	0	0	0	0	0
17852	562333	2	1	1	0	0	2
17852	562339	2	1	2	0	0	3
17852	562346	2	1	0	0	0	1
17852	562351	2	1	0	1	0	2
17852	562358	2	2	1	0	0	3
17852	197750	1	0	0	0	0	0
17852	200061	1	0	0	0	0	0
17852	204347	1	0	1	0	0	1
17852	218662	1	0	0	0	0	0
17852	423165	1	0	2	0	0	2
17852	423169	1	0	1	0	0	1
17852	454697	1	0	1	0	0	1
17852	562230	1	0	0	0	0	0
17852	562234	1	0	1	0	2	3
17852	562243	1	0	0	0	0	0
17852	562254	1	1	1	0	0	2
17852	562266	1	1	0	0	0	1
17852	562269	1	2	2	0	0	4
17852	562287	1	0	0	0	0	0
17852	562304	1	0	0	0	1	1
17852	562307	1	0	0	0	0	0
17852	562320	1	0	0	0	0	0
17852	562342	1	0	0	0	0	0
17852	562349	1	0	0	1	0	1
17852	562355	1	2	0	0	0	2
62642	405128	44	3	2	1	4	10
62642	405127	39	3	4	4	4	15
62642	405133	39	3	4	4	4	15
62642	405135	38	1	4	1	6	12
62642	405125	32	2	3	0	9	14
62642	405126	32	3	9	1	4	17
62642	405129	31	6	2	0	3	11
62642	405130	31	1	9	1	5	16
62642	63334	30	2	7	2	7	18
62642	405132	29	1	3	2	1	7
62642	405200	25	1	6	0	2	9
62642	106267	20	0	1	0	0	1
62642	219482	20	0	1	0	0	1
62642	405124	13	1	0	0	2	3
62642	107073	11	0	1	0	2	3
62642	405142	11	2	0	0	1	3
62642	101510	10	1	1	0	1	3
62642	405121	10	0	2	0	3	5
62642	405144	10	1	0	0	2	3
62642	94430	10	1	3	1	0	5
62642	299660	9	4	2	0	1	7
62642	405172	9	4	2	0	1	7
62642	405186	9	0	0	0	1	1
62642	56720	9	4	2	0	1	7
62642	405101	8	2	2	0	0	4
62642	405197	8	2	3	0	1	6
62642	63329	8	1	3	0	1	5
62642	89591	8	1	2	0	2	5
62642	299659	7	0	2	0	0	2
62642	405096	7	1	3	0	1	5
62642	405137	7	1	2	1	0	4
62642	405154	7	1	0	0	2	3
62642	405157	7	1	1	0	2	4
62642	405193	7	2	3	0	0	5
62642	86424	7	0	1	0	0	1
62642	405097	6	0	0	0	1	1
62642	405138	6	1	2	0	0	3
62642	405158	6	1	1	0	2	4
62642	405160	6	3	1	0	0	4
62642	405198	6	3	1	0	2	6
62642	194940	5	1	0	0	0	1
62642	405072	5	0	0	0	0	0
62642	405073	5	4	1	0	3	8
62642	405084	5	0	0	1	3	4
62642	405093	5	0	0	0	0	0
62642	405117	5	1	2	0	2	5
62642	405118	5	2	0	0	2	4
62642	405139	5	0	3	0	3	6
62642	405156	5	1	0	0	0	1
62642	405159	5	2	0	0	1	3
62642	405169	5	0	0	0	2	2
62642	405171	5	4	0	0	0	4
62642	405175	5	2	6	0	3	11
62642	220713	4	0	2	0	1	3
62642	299658	4	1	0	0	5	6
62642	299662	4	1	1	0	9	11
62642	299663	4	0	0	0	1	1
62642	405056	4	0	0	0	2	2
62642	405080	4	2	3	0	0	5
62642	405083	4	0	0	0	2	2
62642	405092	4	0	1	0	0	1
62642	405098	4	2	1	0	0	3
62642	405099	4	1	1	0	0	2
62642	405108	4	1	0	0	0	1
62642	405113	4	0	1	0	0	1
62642	405119	4	1	1	0	1	3
62642	405122	4	0	0	0	0	0
62642	405131	4	0	0	0	3	3
62642	405136	4	0	1	0	0	1
62642	405147	4	1	0	0	2	3
62642	405148	4	2	0	0	1	3
62642	405149	4	1	0	0	0	1
62642	405151	4	1	2	0	1	4
62642	405163	4	0	0	1	1	2
62642	405165	4	0	0	0	1	1
62642	405166	4	1	0	0	1	2
62642	405176	4	2	0	0	2	4
62642	405182	4	1	2	0	1	4
62642	405183	4	1	3	0	1	5
62642	405192	4	0	2	0	2	4
62642	405195	4	1	1	0	2	4
62642	405199	4	3	2	0	1	6
62642	66694	4	0	0	0	1	1
62642	70495	4	2	0	0	0	2
62642	71626	4	1	1	0	9	11
62642	84527	4	0	3	0	1	4
62642	220308	3	1	0	0	2	3
62642	405052	3	0	0	0	1	1
62642	405059	3	0	0	0	1	1
62642	405060	3	0	1	1	1	3
62642	405062	3	0	0	0	1	1
62642	405066	3	0	1	0	1	2
62642	405067	3	0	3	0	1	4
62642	405068	3	1	1	0	1	3
62642	405069	3	1	0	0	4	5
62642	405088	3	1	0	0	3	4
62642	405089	3	0	0	0	0	0
62642	405090	3	0	1	1	1	3
62642	405102	3	1	1	0	1	3
62642	405106	3	1	0	0	2	3
62642	405109	3	0	1	0	0	1
62642	405110	3	1	3	1	1	6
62642	405114	3	0	0	0	4	4
62642	405115	3	0	0	0	1	1
62642	405116	3	0	1	0	1	2
62642	405120	3	0	1	0	0	1
62642	405152	3	1	0	1	3	5
62642	405162	3	1	0	0	1	2
62642	405167	3	0	2	0	0	2
62642	405168	3	0	2	1	4	7
62642	405173	3	1	0	0	1	2
62642	405174	3	0	1	0	1	2
62642	405179	3	3	0	0	0	3
62642	405181	3	1	1	0	3	5
62642	405185	3	0	1	0	1	2
62642	405188	3	0	0	0	2	2
62642	405189	3	1	0	0	2	3
62642	405191	3	0	2	0	0	2
62642	405196	3	1	1	0	0	2
62642	405201	3	0	2	0	0	2
62642	199120	2	0	1	0	1	2
62642	206809	2	0	0	0	1	1
62642	405055	2	1	0	0	0	1
62642	405061	2	0	0	0	0	0
62642	405063	2	0	1	0	1	2
62642	405064	2	1	1	0	0	2
62642	405094	2	0	0	0	3	3
62642	405100	2	1	0	0	0	1
62642	405105	2	0	0	0	1	1
62642	405112	2	0	0	0	0	0
62642	405123	2	0	3	1	1	5
62642	405140	2	1	1	0	2	4
62642	405141	2	0	1	0	1	2
62642	405145	2	0	0	0	2	2
62642	405146	2	0	0	0	0	0
62642	405150	2	1	0	0	1	2
62642	405153	2	0	0	0	0	0
62642	405155	2	0	0	0	1	1
62642	405161	2	0	0	1	1	2
62642	405170	2	0	0	0	1	1
62642	405177	2	2	0	0	3	5
62642	405178	2	0	0	0	1	1
62642	405180	2	0	0	0	0	0
62642	405187	2	1	1	0	1	3
62642	405190	2	0	0	0	1	1
62642	405194	2	1	0	0	0	1
62642	107375	1	1	1	0	1	3
62642	405053	1	0	0	0	1	1
62642	405054	1	0	1	0	1	2
62642	405057	1	0	0	1	1	2
62642	405058	1	0	0	0	0	0
62642	405065	1	0	1	0	1	2
62642	405070	1	1	1	0	0	2
62642	405071	1	0	0	0	2	2
62642	405074	1	0	2	0	1	3
62642	405075	1	0	0	0	0	0
62642	405076	1	0	0	0	0	0
62642	405077	1	0	0	0	0	0
62642	405078	1	0	0	0	1	1
62642	405079	1	0	0	0	0	0
62642	405081	1	0	1	0	1	2
62642	405082	1	0	0	0	0	0
62642	405085	1	0	0	0	0	0
62642	405086	1	0	0	0	0	0
62642	405087	1	1	0	0	0	1
62642	405091	1	0	0	0	0	0
62642	405095	1	0	0	0	0	0
62642	405103	1	1	0	0	1	2
62642	405104	1	0	0	0	0	0
62642	405107	1	0	0	0	1	1
62642	405111	1	0	1	0	4	5
62642	405143	1	1	1	0	2	4
62642	405164	1	0	0	0	1	1
62642	405184	1	0	0	0	2	2
64868	485626	17	1	1	0	0	2
64868	192652	15	1	0	1	2	4
64868	485686	15	1	0	2	2	5
64868	485687	15	1	1	0	0	2
64868	485642	14	3	1	0	2	6
64868	485637	12	1	0	0	0	1
64868	485573	11	2	3	0	0	5
64868	485625	11	0	2	1	0	3
64868	485670	11	0	0	0	1	1
64868	485602	10	1	1	0	0	2
64868	485697	10	1	1	0	0	2
64868	485549	9	0	2	0	3	5
64868	485551	9	1	2	1	0	4
64868	485586	9	1	1	0	0	2
64868	485634	9	1	3	0	0	4
64868	485643	9	1	1	0	1	3
64868	485662	9	0	0	0	1	1
64868	485676	9	1	1	0	0	2
64868	189152	8	0	1	0	1	2
64868	485547	8	0	1	0	1	2
64868	485576	8	2	2	0	2	6
64868	485644	8	2	2	0	0	4
64868	485647	8	1	1	1	0	3
64868	485669	8	0	0	1	1	2
64868	485685	8	0	2	1	0	3
64868	485695	8	0	0	1	0	1
64868	485704	8	0	0	0	0	0
64868	485569	7	1	1	0	0	2
64868	485585	7	2	3	0	0	5
64868	485596	7	3	1	0	0	4
64868	485601	7	0	2	0	0	2
64868	485605	7	1	0	0	0	1
64868	485638	7	1	2	0	2	5
64868	485639	7	4	3	0	2	9
64868	485661	7	0	0	0	0	0
64868	485665	7	1	0	0	0	1
64868	485672	7	1	1	1	0	3
64868	485675	7	0	1	1	2	4
64868	485698	7	1	0	0	1	2
64868	485706	7	0	1	0	0	1
64868	485559	6	1	1	0	0	2
64868	485568	6	4	2	0	1	7
64868	485570	6	0	0	0	0	0
64868	485604	6	1	3	0	0	4
64868	485607	6	1	1	0	0	2
64868	485631	6	1	0	2	1	4
64868	485650	6	0	0	0	1	1
64868	485652	6	2	2	0	1	5
64868	485654	6	0	1	0	1	2
64868	485684	6	1	0	0	0	1
64868	485689	6	0	0	0	0	0
64868	485694	6	2	1	0	1	4
64868	485700	6	0	0	0	0	0
64868	485541	5	0	2	0	2	4
64868	485555	5	2	0	0	0	2
64868	485566	5	1	1	0	1	3
64868	485571	5	1	1	0	2	4
64868	485572	5	1	1	0	1	3
64868	485574	5	2	1	0	1	4
64868	485575	5	0	0	0	0	0
64868	485577	5	2	1	0	0	3
64868	485580	5	0	0	0	0	0
64868	485581	5	0	1	0	0	1
64868	485582	5	1	3	0	0	4
64868	485590	5	0	0	0	1	1
64868	485611	5	2	1	0	0	3
64868	485612	5	2	1	0	0	3
64868	485617	5	1	1	0	2	4
64868	485630	5	0	0	0	0	0
64868	485640	5	1	0	0	0	1
64868	485648	5	1	1	1	0	3
64868	485666	5	0	3	0	1	4
64868	485674	5	1	0	0	0	1
64868	485677	5	2	2	0	1	5
64868	485680	5	1	2	0	1	4
64868	485690	5	0	2	0	0	2
64868	485691	5	1	0	0	0	1
64868	485699	5	0	0	0	0	0
64868	485701	5	0	0	0	1	1
64868	485707	5	0	1	0	1	2
64868	485542	4	0	2	0	0	2
64868	485548	4	2	1	0	0	3
64868	485558	4	2	0	0	0	2
64868	485562	4	2	1	0	0	3
64868	485563	4	0	1	0	0	1
64868	485565	4	0	1	0	0	1
64868	485579	4	0	0	0	1	1
64868	485584	4	2	1	0	0	3
64868	485591	4	1	2	0	0	3
64868	485592	4	1	1	0	0	2
64868	485597	4	1	3	0	0	4
64868	485613	4	1	1	0	1	3
64868	485614	4	0	3	0	0	3
64868	485623	4	2	0	0	0	2
64868	485627	4	1	0	0	1	2
64868	485632	4	0	0	1	0	1
64868	485633	4	1	1	0	0	2
64868	485635	4	0	0	0	0	0
64868	485636	4	0	1	1	0	2
64868	485641	4	1	0	0	0	1
64868	485646	4	1	2	0	0	3
64868	485651	4	1	2	0	0	3
64868	485659	4	1	1	0	1	3
64868	485679	4	1	0	0	2	3
64868	485681	4	1	0	0	0	1
64868	485692	4	1	2	0	0	3
64868	186519	3	0	2	0	0	2
64868	485545	3	1	2	0	0	3
64868	485550	3	0	0	0	1	1
64868	485552	3	1	1	0	0	2
64868	485554	3	0	1	0	0	1
64868	485561	3	1	0	0	0	1
64868	485587	3	0	2	0	0	2
64868	485588	3	2	2	0	0	4
64868	485600	3	0	1	1	0	2
64868	485603	3	0	0	0	0	0
64868	485606	3	0	2	1	0	3
64868	485608	3	0	0	0	0	0
64868	485609	3	1	1	0	0	2
64868	485615	3	1	1	0	0	2
64868	485616	3	0	1	0	0	1
64868	485618	3	0	1	0	0	1
64868	485619	3	1	0	1	0	2
64868	485621	3	0	0	0	0	0
64868	485653	3	0	0	0	2	2
64868	485655	3	0	1	0	0	1
64868	485667	3	0	1	0	1	2
64868	485668	3	1	1	0	1	3
64868	485682	3	0	1	1	0	2
64868	485688	3	3	0	0	0	3
64868	485696	3	0	2	0	0	2
64868	485702	3	0	1	0	0	1
64868	485703	3	0	3	1	3	7
64868	485708	3	0	1	0	1	2
64868	485709	3	1	1	0	0	2
64868	485710	3	0	2	0	0	2
64868	485543	2	1	1	0	0	2
64868	485553	2	0	3	0	0	3
64868	485556	2	1	0	0	0	1
64868	485560	2	1	1	0	1	3
64868	485564	2	1	1	0	0	2
64868	485578	2	0	2	0	1	3
64868	485589	2	1	1	0	0	2
64868	485593	2	0	3	0	0	3
64868	485599	2	0	0	0	0	0
64868	485610	2	1	0	0	0	1
64868	485620	2	1	2	0	2	5
64868	485629	2	1	1	0	0	2
64868	485645	2	3	0	0	2	5
64868	485649	2	1	0	0	0	1
64868	485656	2	1	1	0	0	2
64868	485657	2	1	0	0	0	1
64868	485658	2	0	2	0	0	2
64868	485660	2	1	2	0	0	3
64868	485663	2	1	0	0	0	1
64868	485664	2	0	1	0	0	1
64868	485671	2	0	0	0	0	0
64868	485673	2	0	1	0	0	1
64868	485678	2	0	0	0	0	0
64868	485693	2	1	0	1	0	2
64868	485705	2	0	0	0	0	0
64868	485544	1	0	0	0	1	1
64868	485546	1	1	1	0	0	2
64868	485557	1	0	0	0	0	0
64868	485567	1	0	2	0	0	2
64868	485583	1	0	0	0	0	0
64868	485594	1	0	1	0	0	1
64868	485598	1	0	1	0	1	2
64868	485622	1	0	2	0	0	2
64868	485624	1	1	1	0	3	5
64868	485628	1	0	1	0	0	1
64868	485683	1	0	0	0	1	1
34751	596854	40	3	0	1	0	4
34751	68566	30	5	0	0	2	7
34751	202407	29	2	3	1	0	6
34751	87556	29	4	2	0	5	11
34751	292485	28	2	3	1	0	6
34751	596747	28	2	3	1	0	6
34751	82789	28	2	3	1	0	6
34751	83118	24	3	6	0	3	12
34751	98976	24	3	4	3	1	11
34751	292484	23	1	2	2	4	9
34751	596793	23	7	4	1	1	13
34751	83366	23	1	2	2	4	9
34751	77294	21	6	0	2	0	8
34751	596755	20	10	4	3	0	17
34751	72565	20	1	1	1	6	9
34751	107852	19	2	1	0	1	4
34751	56587	17	3	2	0	1	6
34751	106828	14	2	2	0	4	8
34751	210989	12	1	1	0	1	3
34751	50243	12	4	2	1	0	7
34751	596771	11	2	3	1	0	6
34751	596812	11	4	0	0	0	4
34751	596836	11	1	2	0	4	7
34751	596849	11	2	1	0	1	4
34751	99126	11	0	1	0	2	3
34751	596799	10	1	4	0	1	6
34751	596820	10	1	0	0	1	2
34751	292489	9	0	1	0	1	2
34751	596756	9	2	2	0	1	5
34751	76727	9	0	1	0	1	2
34751	83856	9	2	3	0	3	8
34751	90373	9	0	0	2	0	2
34751	103977	8	0	0	0	0	0
34751	55371	8	2	2	1	0	5
34751	596759	8	2	3	1	2	8
34751	596800	8	1	2	0	0	3
34751	596804	8	1	1	0	0	2
34751	596826	8	0	2	1	1	4
34751	596827	8	3	2	0	0	5
34751	596833	8	0	2	0	1	3
34751	596845	8	0	0	0	1	1
34751	73830	8	1	3	1	1	6
34751	80109	8	2	0	0	1	3
34751	99305	8	2	1	0	0	3
34751	190979	7	0	3	2	0	5
34751	212947	7	1	1	1	0	3
34751	292486	7	0	1	0	0	1
34751	292487	7	0	1	0	0	1
34751	478078	7	0	0	0	1	1
34751	56044	7	3	1	0	2	6
34751	596745	7	1	1	1	2	5
34751	596753	7	3	1	1	0	5
34751	596814	7	0	2	0	0	2
34751	596822	7	3	1	2	3	9
34751	596824	7	1	1	1	0	3
34751	596830	7	1	0	0	1	2
34751	596834	7	1	0	0	0	1
34751	88472	7	1	5	1	2	9
34751	99646	7	0	0	0	0	0
34751	292488	6	2	2	0	2	6
34751	51516	6	1	2	0	0	3
34751	54702	6	1	0	0	0	1
34751	596749	6	1	2	0	0	3
34751	596752	6	1	1	0	0	2
34751	596762	6	1	1	0	0	2
34751	596764	6	2	2	1	1	6
34751	596766	6	1	1	0	1	3
34751	596773	6	1	0	0	0	1
34751	596777	6	1	0	0	1	2
34751	596778	6	2	1	0	0	3
34751	596795	6	0	0	0	0	0
34751	596809	6	0	1	0	0	1
34751	596813	6	0	1	0	1	2
34751	596815	6	0	2	0	0	2
34751	596825	6	0	1	0	0	1
34751	596847	6	0	0	0	0	0
34751	79140	6	2	2	0	2	6
34751	214077	5	1	0	0	0	1
34751	478079	5	0	1	1	0	2
34751	596744	5	0	0	0	1	1
34751	596748	5	0	1	0	1	2
34751	596763	5	1	2	0	0	3
34751	596774	5	1	1	1	0	3
34751	596775	5	0	1	0	3	4
34751	596776	5	0	4	0	1	5
34751	596796	5	2	0	0	1	3
34751	596801	5	1	1	0	2	4
34751	596807	5	0	0	1	0	1
34751	596816	5	1	2	0	0	3
34751	596821	5	3	0	0	2	5
34751	596823	5	1	1	0	0	2
34751	596840	5	2	1	0	1	4
34751	596846	5	3	1	0	0	4
34751	65553	5	0	1	1	0	2
34751	82059	5	0	0	0	1	1
34751	86766	5	1	1	1	1	4
34751	292491	4	0	2	2	1	5
34751	596743	4	0	2	0	0	2
34751	596751	4	0	3	1	0	4
34751	596754	4	0	1	0	1	2
34751	596770	4	1	0	0	0	1
34751	596780	4	3	1	0	2	6
34751	596781	4	0	0	0	0	0
34751	596785	4	0	1	0	2	3
34751	596786	4	0	0	0	1	1
34751	596788	4	1	1	0	0	2
34751	596790	4	0	4	0	0	4
34751	596797	4	2	0	0	0	2
34751	596803	4	0	2	1	0	3
34751	596806	4	2	2	1	0	5
34751	596829	4	0	0	0	0	0
34751	596831	4	1	0	0	2	3
34751	596832	4	0	1	0	0	1
34751	596838	4	0	1	0	2	3
34751	596843	4	1	0	0	0	1
34751	596853	4	0	0	1	0	1
34751	596855	4	1	1	0	0	2
34751	596856	4	2	1	1	1	5
34751	90413	4	2	0	0	1	3
34751	193753	3	1	0	0	0	1
34751	195927	3	0	0	0	0	0
34751	210171	3	1	0	0	0	1
34751	54824	3	0	1	0	0	1
34751	596746	3	0	1	1	0	2
34751	596750	3	1	2	0	0	3
34751	596760	3	1	1	0	0	2
34751	596761	3	1	0	0	0	1
34751	596772	3	1	0	0	1	2
34751	596779	3	0	1	0	1	2
34751	596782	3	0	1	0	0	1
34751	596783	3	2	0	0	0	2
34751	596787	3	1	3	0	0	4
34751	596791	3	1	3	0	0	4
34751	596798	3	0	0	0	0	0
34751	596808	3	1	0	0	0	1
34751	596811	3	0	1	0	0	1
34751	596817	3	2	1	0	0	3
34751	596818	3	0	3	0	0	3
34751	596828	3	0	0	0	0	0
34751	596841	3	0	0	0	0	0
34751	596842	3	0	2	0	0	2
34751	596844	3	0	1	1	0	2
34751	596850	3	2	0	0	0	2
34751	103618	2	1	0	0	0	1
34751	106593	2	0	0	1	2	3
34751	187525	2	1	0	0	1	2
34751	193130	2	1	0	0	2	3
34751	206425	2	1	0	0	0	1
34751	211209	2	0	0	0	1	1
34751	596742	2	0	0	0	1	1
34751	596757	2	1	1	0	1	3
34751	596767	2	1	0	0	1	2
34751	596769	2	1	1	0	0	2
34751	596784	2	2	1	0	0	3
34751	596792	2	0	1	0	0	1
34751	596802	2	0	0	0	1	1
34751	596805	2	0	0	0	0	0
34751	596810	2	1	0	0	1	2
34751	596819	2	1	0	0	2	3
34751	596837	2	0	0	0	0	0
34751	596848	2	1	1	0	0	2
34751	596851	2	1	1	0	0	2
34751	292490	1	1	0	0	0	1
34751	596758	1	1	1	0	0	2
34751	596765	1	0	1	0	0	1
34751	596768	1	1	0	0	0	1
34751	596789	1	0	0	0	2	2
34751	596794	1	0	1	0	0	1
34751	596835	1	0	0	0	0	0
34751	596839	1	3	1	0	0	4
34751	596852	1	1	2	1	0	4
57666	606091	19	0	5	3	1	9
57666	606119	19	2	3	3	1	9
57666	606105	13	2	1	0	4	7
57666	606079	12	1	1	3	0	5
57666	606085	11	2	2	0	2	6
57666	606145	10	1	0	0	0	1
57666	606164	10	0	0	0	0	0
57666	606227	10	1	0	0	0	1
57666	606126	9	0	0	0	1	1
57666	606140	9	0	0	0	1	1
57666	606152	9	1	2	0	1	4
57666	606233	9	0	0	0	1	1
57666	281485	8	0	1	0	0	1
57666	606082	8	0	1	0	0	1
57666	606097	8	0	0	0	0	0
57666	606155	8	0	0	0	1	1
57666	606175	8	2	1	0	0	3
57666	606228	8	0	0	0	0	0
57666	91056	8	0	1	0	0	1
57666	103958	7	4	0	0	1	5
57666	606113	7	1	1	0	0	2
57666	606118	7	0	2	0	0	2
57666	606124	7	2	1	1	0	4
57666	606176	7	2	0	0	2	4
57666	606204	7	1	1	0	0	2
57666	606226	7	0	0	0	0	0
57666	606230	7	2	0	0	2	4
57666	606089	6	2	3	0	0	5
57666	606093	6	3	0	1	0	4
57666	606098	6	1	0	1	0	2
57666	606107	6	2	1	0	0	3
57666	606127	6	1	0	0	1	2
57666	606133	6	0	1	0	1	2
57666	606158	6	1	0	0	4	5
57666	606168	6	0	0	0	1	1
57666	606209	6	1	0	0	0	1
57666	220979	5	2	1	0	0	3
57666	606087	5	2	1	0	0	3
57666	606096	5	0	0	0	0	0
57666	606099	5	1	4	0	1	6
57666	606101	5	0	0	0	0	0
57666	606106	5	0	2	1	0	3
57666	606112	5	1	0	0	1	2
57666	606116	5	0	0	0	0	0
57666	606117	5	0	0	0	3	3
57666	606171	5	0	0	0	1	1
57666	606177	5	0	1	0	0	1
57666	606188	5	1	1	0	0	2
57666	606197	5	1	1	0	2	4
57666	606202	5	1	0	1	2	4
57666	606208	5	0	1	0	0	1
57666	606224	5	4	0	0	0	4
57666	298262	4	0	1	2	0	3
57666	606081	4	0	1	0	0	1
57666	606109	4	0	1	0	0	1
57666	606114	4	0	1	0	2	3
57666	606120	4	2	0	0	1	3
57666	606125	4	0	1	0	1	2
57666	606136	4	0	0	0	0	0
57666	606147	4	0	1	0	1	2
57666	606148	4	3	0	0	0	3
57666	606162	4	2	0	0	0	2
57666	606174	4	1	0	0	0	1
57666	606178	4	0	3	0	1	4
57666	606186	4	1	0	0	4	5
57666	606190	4	1	0	0	0	1
57666	606207	4	1	1	0	2	4
57666	606212	4	1	0	0	1	2
57666	606213	4	0	1	0	1	2
57666	606223	4	0	0	0	0	0
57666	606231	4	0	0	0	3	3
57666	606236	4	0	0	0	1	1
57666	208259	3	1	0	1	1	3
57666	216081	3	1	1	0	0	2
57666	606080	3	0	0	0	1	1
57666	606083	3	0	0	0	0	0
57666	606090	3	1	1	0	0	2
57666	606102	3	0	0	0	0	0
57666	606103	3	1	0	0	0	1
57666	606122	3	1	0	1	1	3
57666	606130	3	1	3	0	1	5
57666	606131	3	0	1	0	2	3
57666	606132	3	0	3	0	0	3
57666	606141	3	2	0	0	1	3
57666	606151	3	0	2	0	1	3
57666	606161	3	1	0	0	1	2
57666	606167	3	0	0	0	0	0
57666	606179	3	0	0	0	1	1
57666	606184	3	0	0	0	1	1
57666	606185	3	0	0	0	0	0
57666	606192	3	0	0	0	0	0
57666	606196	3	0	1	0	0	1
57666	606205	3	0	0	0	0	0
57666	606206	3	0	2	0	0	2
57666	606210	3	0	0	0	0	0
57666	606216	3	2	0	0	1	3
57666	606218	3	0	1	0	0	1
57666	606222	3	0	0	0	0	0
57666	606229	3	0	0	0	1	1
57666	92284	3	0	0	0	1	1
57666	208152	2	1	1	0	0	2
57666	211680	2	0	1	0	0	1
57666	606084	2	0	0	0	1	1
57666	606092	2	1	0	1	1	3
57666	606094	2	0	0	0	0	0
57666	606095	2	1	2	0	0	3
57666	606104	2	1	0	0	0	1
57666	606110	2	0	2	0	0	2
57666	606111	2	2	1	0	0	3
57666	606115	2	0	0	0	3	3
57666	606121	2	2	1	0	2	5
57666	606123	2	0	0	0	3	3
57666	606129	2	0	1	0	2	3
57666	606134	2	2	0	1	0	3
57666	606135	2	1	0	0	0	1
57666	606137	2	0	0	0	0	0
57666	606139	2	1	0	0	1	2
57666	606149	2	1	3	0	0	4
57666	606154	2	0	0	0	1	1
57666	606156	2	0	0	0	1	1
57666	606160	2	0	0	0	1	1
57666	606169	2	0	0	0	1	1
57666	606170	2	1	0	0	1	2
57666	606182	2	1	0	0	2	3
57666	606183	2	1	0	0	0	1
57666	606189	2	1	0	0	1	2
57666	606195	2	0	0	0	0	0
57666	606200	2	0	0	0	0	0
57666	606201	2	0	0	1	0	1
57666	606203	2	1	0	0	0	1
57666	606211	2	0	0	0	1	1
57666	606215	2	0	0	0	0	0
57666	606232	2	0	0	0	1	1
57666	606234	2	0	0	0	0	0
57666	606235	2	3	0	2	0	5
57666	200058	1	0	1	0	0	1
57666	203818	1	0	0	0	1	1
57666	281484	1	0	0	0	1	1
57666	606086	1	1	1	1	0	3
57666	606088	1	2	2	1	1	6
57666	606100	1	2	1	0	0	3
57666	606108	1	1	2	0	1	4
57666	606128	1	1	0	0	1	2
57666	606138	1	1	0	0	0	1
57666	606142	1	1	0	0	0	1
57666	606143	1	2	0	0	0	2
57666	606144	1	1	0	1	0	2
57666	606146	1	3	0	1	0	4
57666	606150	1	0	0	0	0	0
57666	606153	1	2	0	1	1	4
57666	606157	1	0	0	0	0	0
57666	606159	1	1	0	0	0	1
57666	606163	1	0	0	0	1	1
57666	606165	1	0	0	0	0	0
57666	606166	1	1	1	0	0	2
57666	606172	1	1	1	0	0	2
57666	606173	1	0	0	0	1	1
57666	606180	1	2	1	0	0	3
57666	606181	1	3	0	0	0	3
57666	606187	1	0	0	0	0	0
57666	606191	1	1	0	0	0	1
57666	606193	1	1	2	0	0	3
57666	606194	1	0	0	0	0	0
57666	606198	1	2	0	1	1	4
57666	606199	1	2	0	0	1	3
57666	606214	1	1	0	0	0	1
57666	606217	1	1	1	0	0	2
57666	606219	1	0	0	0	0	0
57666	606220	1	0	0	0	3	3
57666	606221	1	0	0	0	0	0
57666	606225	1	0	0	0	0	0
61507	87298	41	1	4	2	1	8
61507	78140	37	3	7	4	0	14
61507	185415	24	2	4	1	3	10
61507	214427	23	7	5	1	2	15
61507	192492	21	1	11	1	0	13
61507	54817	21	2	5	2	3	12
61507	96200	20	4	7	2	2	15
61507	105388	19	4	6	2	0	12
61507	299382	17	2	3	0	2	7
61507	208928	16	3	1	0	0	4
61507	101187	15	2	1	1	0	4
61507	299378	15	2	1	1	0	4
61507	210232	14	1	3	2	1	7
61507	207818	13	0	1	0	3	4
61507	299400	12	1	0	0	0	1
61507	56397	12	1	0	0	0	1
61507	299384	11	1	2	0	0	3
61507	59386	11	1	2	0	0	3
61507	185474	10	0	1	1	1	3
61507	100110	9	2	7	1	2	12
61507	186862	9	1	1	0	1	3
61507	187946	9	2	1	2	3	8
61507	189804	9	1	0	0	2	3
61507	194895	9	0	0	1	2	3
61507	206891	9	2	0	0	0	2
61507	207833	9	0	1	0	0	1
61507	214517	9	2	7	1	2	12
61507	299380	9	2	7	1	2	12
61507	74895	9	3	3	1	0	7
61507	190969	8	1	1	0	0	2
61507	206555	8	1	0	1	1	3
61507	207108	8	2	0	1	1	4
61507	208162	8	2	0	2	3	7
61507	101864	7	1	1	0	0	2
61507	104212	7	1	5	0	2	8
61507	183344	7	5	1	0	0	6
61507	193137	7	3	3	0	0	6
61507	195681	7	3	3	0	0	6
61507	205411	7	1	1	0	1	3
61507	206305	7	1	2	0	0	3
61507	206400	7	1	3	0	0	4
61507	207654	7	1	0	0	0	1
61507	210992	7	0	0	0	0	0
61507	216999	7	2	5	0	2	9
61507	221499	7	3	0	0	2	5
61507	299372	7	1	0	0	0	1
61507	299375	7	1	0	0	0	1
61507	299376	7	1	0	0	0	1
61507	299385	7	1	1	0	0	2
61507	299386	7	1	5	0	2	8
61507	183254	6	0	0	0	1	1
61507	183501	6	0	2	0	3	5
61507	187083	6	0	0	0	1	1
61507	193191	6	3	1	1	0	5
61507	193301	6	0	0	0	0	0
61507	195774	6	1	4	0	0	5
61507	199188	6	0	1	0	1	2
61507	201651	6	1	1	0	0	2
61507	203179	6	2	1	0	0	3
61507	208231	6	0	0	0	0	0
61507	208833	6	5	1	0	0	6
61507	214300	6	1	1	0	4	6
61507	214373	6	3	3	0	1	7
61507	217437	6	1	2	0	1	4
61507	299398	6	0	2	1	0	3
61507	183300	5	2	0	0	1	3
61507	193187	5	1	2	0	0	3
61507	199149	5	0	0	0	0	0
61507	201978	5	0	0	0	0	0
61507	203181	5	2	0	0	0	2
61507	203864	5	1	2	0	0	3
61507	208841	5	0	0	0	0	0
61507	212872	5	2	1	0	1	4
61507	214284	5	0	3	0	1	4
61507	214694	5	1	1	0	1	3
61507	215314	5	0	0	1	0	1
61507	220975	5	0	1	0	1	2
61507	299373	5	1	0	0	0	1
61507	299390	5	0	0	0	1	1
61507	83832	5	0	0	0	1	1
61507	102441	4	2	1	0	0	3
61507	187227	4	4	0	0	1	5
61507	192246	4	3	0	0	0	3
61507	195239	4	0	2	1	0	3
61507	198186	4	0	1	0	1	2
61507	198654	4	0	0	1	0	1
61507	203790	4	1	2	0	0	3
61507	204292	4	2	1	0	0	3
61507	206373	4	2	0	0	1	3
61507	207005	4	0	0	0	0	0
61507	207965	4	0	1	1	0	2
61507	208886	4	2	0	0	2	4
61507	212425	4	2	3	0	1	6
61507	212444	4	1	1	0	0	2
61507	217174	4	2	1	0	2	5
61507	299379	4	3	1	0	1	5
61507	299383	4	1	0	0	0	1
61507	299387	4	2	1	0	0	3
61507	299389	4	1	2	0	2	5
61507	299395	4	0	0	0	2	2
61507	50161	4	1	0	0	0	1
61507	51082	4	3	1	0	1	5
61507	103773	3	0	1	1	0	2
61507	182670	3	0	0	0	1	1
61507	185631	3	2	1	0	0	3
61507	186884	3	0	0	0	0	0
61507	187528	3	0	0	0	0	0
61507	187890	3	0	0	0	1	1
61507	188505	3	0	0	0	0	0
61507	192349	3	1	1	1	0	3
61507	193296	3	1	0	0	1	2
61507	194335	3	0	0	0	0	0
61507	194428	3	1	0	0	0	1
61507	195936	3	2	0	0	0	2
61507	200040	3	1	0	0	3	4
61507	203106	3	0	0	0	0	0
61507	203191	3	0	0	0	1	1
61507	205359	3	0	3	0	0	3
61507	207335	3	1	1	0	0	2
61507	208796	3	0	0	0	0	0
61507	210147	3	2	2	0	2	6
61507	214727	3	1	0	0	0	1
61507	217225	3	0	1	0	2	3
61507	218537	3	0	2	0	0	2
61507	219980	3	0	0	0	0	0
61507	220962	3	2	0	0	0	2
61507	299371	3	2	1	0	0	3
61507	299381	3	2	0	0	0	2
61507	299391	3	2	1	0	1	4
61507	299393	3	0	0	0	1	1
61507	299394	3	0	2	0	0	2
61507	299399	3	0	1	1	0	2
61507	79224	3	2	0	0	0	2
61507	84495	3	2	1	0	0	3
61507	94079	3	0	2	0	0	2
61507	185654	2	0	2	0	0	2
61507	187906	2	1	0	0	0	1
61507	195858	2	2	0	0	0	2
61507	198264	2	2	1	0	0	3
61507	201209	2	1	0	0	0	1
61507	201278	2	0	0	0	0	0
61507	202939	2	0	2	0	0	2
61507	206287	2	1	1	0	0	2
61507	207834	2	1	0	0	1	2
61507	208375	2	0	0	0	0	0
61507	208904	2	2	0	0	0	2
61507	209416	2	0	1	0	1	2
61507	213396	2	1	0	0	2	3
61507	215012	2	0	0	0	0	0
61507	219787	2	0	0	0	0	0
61507	221604	2	0	1	0	0	1
61507	299374	2	1	0	0	0	1
61507	299377	2	0	0	0	1	1
61507	299388	2	0	0	0	0	0
61507	299396	2	0	0	0	1	1
61507	59073	2	0	0	0	1	1
61507	87840	2	1	0	0	0	1
61507	186989	1	0	0	0	0	0
61507	187123	1	0	0	0	0	0
61507	189870	1	0	0	0	0	0
61507	193043	1	0	0	0	0	0
61507	193983	1	0	0	0	0	0
61507	203935	1	1	1	1	0	3
61507	204768	1	0	1	0	0	1
61507	207604	1	0	0	0	0	0
61507	210320	1	0	0	0	0	0
61507	211191	1	0	0	0	0	0
61507	217713	1	0	0	0	0	0
61507	219944	1	1	0	0	0	1
61507	299392	1	2	0	0	0	2
61507	299397	1	0	0	0	0	0
30355	531441	22	5	1	0	2	8
30355	531443	11	1	2	1	2	6
30355	531329	10	4	0	0	0	4
30355	531357	9	5	0	0	1	6
30355	531353	8	3	0	0	2	5
30355	531307	7	1	0	0	3	4
30355	531350	7	2	0	0	0	2
30355	531398	7	4	1	0	1	6
30355	531427	7	2	0	0	2	4
30355	531429	7	2	1	3	1	7
30355	531438	7	3	0	0	0	3
30355	531284	6	1	0	0	0	1
30355	531310	6	2	0	0	2	4
30355	531322	6	1	0	0	1	2
30355	531331	6	2	0	0	0	2
30355	531333	6	2	1	0	1	4
30355	531339	6	4	1	0	2	7
30355	531341	6	2	0	0	1	3
30355	531348	6	2	0	1	1	4
30355	531373	6	2	0	0	2	4
30355	531404	6	0	1	0	0	1
30355	531424	6	4	1	0	1	6
30355	531432	6	1	0	0	1	2
30355	531435	6	0	0	0	1	1
30355	531317	5	0	0	0	0	0
30355	531327	5	4	1	0	1	6
30355	531332	5	3	0	1	1	5
30355	531340	5	4	0	0	1	5
30355	531368	5	3	0	0	1	4
30355	531380	5	1	0	0	0	1
30355	531385	5	2	1	0	0	3
30355	531390	5	2	0	0	0	2
30355	531394	5	2	1	1	0	4
30355	531395	5	0	0	0	1	1
30355	531403	5	3	0	0	1	4
30355	531406	5	0	0	0	1	1
30355	531410	5	0	0	0	1	1
30355	531415	5	1	0	0	1	2
30355	531416	5	1	1	0	0	2
30355	531430	5	3	0	0	0	3
30355	193133	4	3	1	0	1	5
30355	531306	4	1	0	0	0	1
30355	531321	4	1	0	0	0	1
30355	531335	4	1	0	0	0	1
30355	531344	4	2	0	0	0	2
30355	531354	4	1	0	0	1	2
30355	531355	4	1	1	0	0	2
30355	531362	4	3	0	0	0	3
30355	531363	4	2	1	0	1	4
30355	531372	4	1	0	0	1	2
30355	531377	4	2	1	0	1	4
30355	531382	4	1	0	1	2	4
30355	531384	4	2	1	0	0	3
30355	531386	4	1	0	1	1	3
30355	531392	4	2	0	0	0	2
30355	531402	4	1	2	0	0	3
30355	531421	4	1	0	0	0	1
30355	531423	4	2	0	1	0	3
30355	531434	4	1	0	1	0	2
30355	531437	4	4	0	0	0	4
30355	191324	3	1	0	0	0	1
30355	191397	3	3	0	1	1	5
30355	206003	3	1	1	0	1	3
30355	531282	3	0	0	0	2	2
30355	531295	3	1	0	0	0	1
30355	531296	3	1	0	0	2	3
30355	531320	3	0	0	0	0	0
30355	531330	3	2	0	0	1	3
30355	531334	3	1	0	0	0	1
30355	531336	3	2	1	0	0	3
30355	531338	3	1	0	0	0	1
30355	531342	3	3	0	0	0	3
30355	531346	3	2	0	0	0	2
30355	531347	3	2	0	1	0	3
30355	531359	3	2	0	0	0	2
30355	531364	3	1	0	0	1	2
30355	531365	3	2	0	0	2	4
30355	531371	3	3	0	0	0	3
30355	531376	3	0	0	0	2	2
30355	531383	3	0	0	0	0	0
30355	531389	3	0	1	0	0	1
30355	531396	3	1	0	0	0	1
30355	531397	3	0	0	0	0	0
30355	531399	3	1	0	0	0	1
30355	531400	3	2	0	0	1	3
30355	531405	3	0	0	0	0	0
30355	531407	3	2	0	0	1	3
30355	531412	3	1	0	0	1	2
30355	531420	3	1	0	0	1	2
30355	531422	3	0	0	0	2	2
30355	531425	3	1	2	0	0	3
30355	531426	3	1	1	0	2	4
30355	531428	3	1	0	1	1	3
30355	531431	3	1	0	0	1	2
30355	531440	3	0	0	0	0	0
30355	531442	3	1	0	1	0	2
30355	198590	2	0	0	0	1	1
30355	210778	2	1	0	0	0	1
30355	279312	2	1	1	0	0	2
30355	279313	2	2	1	0	0	3
30355	531285	2	1	0	0	0	1
30355	531287	2	0	0	0	0	0
30355	531289	2	1	0	0	1	2
30355	531290	2	2	0	0	0	2
30355	531291	2	1	2	0	1	4
30355	531298	2	1	1	0	0	2
30355	531300	2	2	0	0	2	4
30355	531302	2	2	0	0	0	2
30355	531303	2	1	0	0	0	1
30355	531304	2	3	1	0	0	4
30355	531309	2	1	0	0	0	1
30355	531311	2	1	0	0	1	2
30355	531312	2	0	0	0	0	0
30355	531313	2	1	0	0	1	2
30355	531315	2	1	0	0	0	1
30355	531316	2	0	0	0	1	1
30355	531318	2	2	0	0	0	2
30355	531319	2	1	0	1	0	2
30355	531323	2	0	0	0	0	0
30355	531326	2	3	0	0	0	3
30355	531337	2	0	1	0	0	1
30355	531343	2	0	0	0	1	1
30355	531349	2	0	0	0	0	0
30355	531351	2	1	0	0	1	2
30355	531356	2	1	1	0	1	3
30355	531358	2	1	0	0	0	1
30355	531366	2	1	0	0	0	1
30355	531370	2	0	0	0	1	1
30355	531374	2	0	0	0	2	2
30355	531375	2	1	0	0	1	2
30355	531378	2	0	0	0	2	2
30355	531379	2	0	0	1	1	2
30355	531381	2	1	0	0	0	1
30355	531408	2	1	0	0	0	1
30355	531409	2	2	0	0	2	4
30355	531411	2	3	1	0	0	4
30355	531413	2	1	0	0	0	1
30355	531418	2	1	0	1	0	2
30355	531419	2	2	0	0	1	3
30355	531433	2	2	0	0	0	2
30355	531436	2	1	3	0	0	4
30355	531439	2	0	0	0	0	0
30355	209317	1	0	0	0	0	0
30355	531283	1	1	0	1	0	2
30355	531286	1	1	0	0	1	2
30355	531288	1	0	0	0	0	0
30355	531292	1	1	0	0	0	1
30355	531293	1	2	0	0	0	2
30355	531294	1	1	0	0	1	2
30355	531297	1	1	0	0	0	1
30355	531299	1	2	0	0	0	2
30355	531301	1	1	0	0	1	2
30355	531305	1	0	0	0	0	0
30355	531308	1	0	0	0	0	0
30355	531314	1	1	0	0	0	1
30355	531324	1	0	0	0	0	0
30355	531325	1	0	0	0	1	1
30355	531328	1	1	0	0	1	2
30355	531345	1	0	0	0	0	0
30355	531352	1	2	0	0	1	3
30355	531360	1	1	0	0	0	1
30355	531361	1	1	0	1	0	2
30355	531367	1	0	0	0	1	1
30355	531369	1	3	0	0	0	3
30355	531387	1	2	0	0	0	2
30355	531388	1	1	0	0	0	1
30355	531391	1	1	1	0	0	2
30355	531393	1	2	1	0	0	3
30355	531401	1	1	1	0	0	2
30355	531414	1	1	1	0	0	2
30355	531417	1	0	0	0	0	0
59468	198817	55	1	6	1	5	13
59468	281650	55	1	6	1	5	13
59468	74506	55	1	6	1	5	13
59468	85968	29	3	4	0	0	7
59468	281645	16	2	1	1	2	6
59468	51290	16	2	5	0	0	7
59468	56123	16	2	1	1	2	6
59468	196701	14	1	0	0	0	1
59468	430421	14	1	3	0	2	6
59468	188681	13	1	1	0	3	5
59468	281657	13	3	2	0	1	6
59468	281664	13	1	1	0	3	5
59468	53902	13	3	2	0	1	6
59468	188031	12	3	2	0	0	5
59468	190717	12	0	0	0	1	1
59468	430401	12	1	3	1	2	7
59468	83887	12	2	2	1	0	5
59468	192135	11	1	0	0	0	1
59468	201002	11	2	1	0	2	5
59468	202092	10	2	2	0	0	4
59468	430432	10	0	7	0	1	8
59468	430467	10	0	2	0	2	4
59468	187809	9	3	0	2	0	5
59468	281652	9	0	1	0	3	4
59468	430415	9	2	3	0	2	7
59468	430439	9	1	0	0	0	1
59468	430441	9	1	1	0	7	9
59468	430446	9	1	2	0	2	5
59468	430463	9	3	0	0	1	4
59468	97791	9	0	1	0	3	4
59468	213301	8	0	0	0	2	2
59468	220319	7	0	1	0	1	2
59468	281648	7	0	1	0	1	2
59468	430405	7	1	3	0	1	5
59468	430457	7	2	1	0	2	5
59468	430469	7	1	1	0	1	3
59468	78541	7	1	3	0	1	5
59468	98002	7	0	1	0	1	2
59468	101178	6	2	0	0	0	2
59468	204117	6	1	0	2	2	5
59468	211276	6	1	1	0	0	2
59468	281640	6	0	4	0	1	5
59468	281665	6	2	0	0	0	2
59468	430403	6	0	0	0	0	0
59468	430412	6	1	1	0	1	3
59468	430418	6	1	4	0	0	5
59468	430429	6	0	1	0	2	3
59468	430443	6	3	0	0	1	4
59468	430450	6	1	0	1	4	6
59468	430460	6	0	2	0	1	3
59468	55204	6	3	1	1	2	7
59468	583958	6	3	1	0	1	5
59468	104491	5	1	3	0	1	5
59468	194719	5	2	1	0	2	5
59468	203598	5	1	0	0	0	1
59468	217211	5	2	1	0	2	5
59468	281642	5	2	4	0	3	9
59468	281643	5	1	0	0	1	2
59468	281644	5	1	3	0	1	5
59468	281654	5	1	1	0	1	3
59468	430397	5	2	1	1	0	4
59468	430422	5	1	0	0	0	1
59468	430425	5	1	0	0	0	1
59468	430438	5	0	0	0	3	3
59468	430451	5	1	1	0	1	3
59468	430454	5	2	4	0	3	9
59468	430462	5	1	2	0	0	3
59468	430470	5	1	4	0	1	6
59468	430471	5	1	0	0	0	1
59468	51073	5	1	1	0	1	3
59468	60848	5	0	0	0	0	0
59468	92812	5	2	4	0	3	9
59468	97657	5	0	2	0	2	4
59468	98181	5	1	1	0	0	2
59468	191013	4	1	1	0	0	2
59468	191618	4	2	0	1	0	3
59468	195549	4	1	0	1	1	3
59468	201453	4	0	1	0	1	2
59468	204196	4	2	0	0	2	4
59468	210053	4	0	3	0	0	3
59468	212951	4	0	0	0	2	2
59468	216161	4	0	0	0	3	3
59468	281649	4	0	0	0	0	0
59468	281653	4	0	2	0	1	3
59468	281656	4	2	1	0	0	3
59468	281660	4	1	2	0	1	4
59468	430395	4	0	0	0	0	0
59468	430404	4	0	1	0	1	2
59468	430409	4	1	2	0	0	3
59468	430410	4	2	0	0	2	4
59468	430411	4	3	0	0	0	3
59468	430413	4	1	1	0	1	3
59468	430414	4	2	0	0	0	2
59468	430416	4	1	0	0	1	2
59468	430426	4	1	0	0	0	1
59468	430427	4	2	1	0	0	3
59468	430430	4	1	1	0	0	2
59468	430435	4	0	1	0	0	1
59468	430436	4	3	2	1	0	6
59468	430437	4	2	0	0	0	2
59468	430444	4	0	1	0	0	1
59468	430448	4	1	0	1	1	3
59468	430449	4	0	1	0	0	1
59468	430453	4	2	2	0	2	6
59468	430461	4	1	0	1	1	3
59468	430465	4	0	1	0	1	2
59468	430466	4	0	2	0	0	2
59468	430472	4	0	1	0	1	2
59468	430473	4	0	2	0	1	3
59468	64613	4	2	1	0	0	3
59468	74218	4	1	2	0	1	4
59468	84739	4	0	2	0	1	3
59468	103248	3	0	0	0	3	3
59468	108051	3	0	0	0	1	1
59468	197159	3	1	0	0	0	1
59468	213456	3	1	1	0	1	3
59468	215319	3	0	1	0	1	2
59468	281646	3	0	0	0	1	1
59468	281651	3	0	1	0	2	3
59468	281658	3	0	0	0	3	3
59468	281661	3	2	1	0	1	4
59468	430396	3	0	2	0	1	3
59468	430398	3	0	0	0	0	0
59468	430399	3	1	0	1	0	2
59468	430400	3	0	1	0	0	1
59468	430419	3	1	0	0	0	1
59468	430423	3	1	0	0	0	1
59468	430424	3	0	1	0	1	2
59468	430431	3	0	2	0	2	4
59468	430433	3	1	1	0	1	3
59468	430440	3	0	1	0	2	3
59468	430442	3	0	0	0	0	0
59468	430445	3	1	1	0	1	3
59468	430447	3	0	1	0	0	1
59468	430452	3	1	0	0	1	2
59468	430459	3	2	1	0	1	4
59468	430468	3	1	0	0	0	1
59468	430474	3	0	1	0	1	2
59468	430475	3	2	1	0	1	4
59468	61351	3	0	1	0	2	3
59468	91072	3	2	1	0	1	4
59468	215175	2	0	1	0	0	1
59468	219895	2	0	1	0	1	2
59468	281641	2	0	1	0	0	1
59468	281647	2	0	1	0	3	4
59468	281659	2	0	0	0	1	1
59468	281662	2	0	0	0	0	0
59468	430394	2	1	0	0	0	1
59468	430402	2	1	4	0	2	7
59468	430406	2	0	2	0	0	2
59468	430407	2	2	0	0	0	2
59468	430408	2	0	0	0	0	0
59468	430417	2	0	1	0	0	1
59468	430420	2	1	0	1	2	4
59468	430428	2	0	1	0	0	1
59468	430455	2	0	0	0	0	0
59468	430456	2	1	1	0	1	3
59468	51231	2	0	0	0	0	0
59468	54739	2	0	0	0	1	1
59468	188431	1	1	1	1	0	3
59468	191202	1	1	0	0	1	2
59468	200301	1	0	1	0	1	2
59468	281655	1	0	0	0	1	1
59468	281663	1	0	1	0	1	2
59468	430434	1	1	0	0	1	2
59468	430458	1	2	0	0	1	3
59468	430464	1	1	3	0	2	6
59468	71045	1	0	0	0	1	1
11034	198976	62	5	6	3	0	14
11034	276152	62	5	6	3	0	14
11034	201027	17	4	0	0	3	7
11034	598227	12	1	1	0	0	2
11034	598350	11	0	0	0	0	0
11034	212117	10	1	5	0	2	8
11034	598228	10	1	5	0	2	8
11034	598251	10	4	0	0	0	4
11034	598255	10	1	0	0	0	1
11034	598298	10	3	2	0	1	6
11034	598224	9	0	0	0	1	1
11034	598291	9	1	1	0	0	2
11034	598305	9	0	1	0	2	3
11034	598325	9	0	0	0	3	3
11034	211530	8	2	2	2	1	7
11034	598243	8	3	1	0	4	8
11034	598268	8	5	1	0	1	7
11034	598337	8	2	1	0	1	4
11034	203022	7	2	2	0	1	5
11034	276149	7	3	1	0	1	5
11034	276154	7	1	2	0	2	5
11034	598231	7	1	1	1	1	4
11034	598233	7	1	0	0	3	4
11034	598240	7	1	0	1	1	3
11034	598278	7	2	1	0	3	6
11034	598336	7	3	1	0	0	4
11034	598344	7	2	0	0	0	2
11034	598250	6	1	2	1	2	6
11034	598285	6	0	1	0	0	1
11034	598296	6	2	0	0	2	4
11034	598297	6	2	1	0	1	4
11034	598303	6	2	0	0	2	4
11034	598346	6	1	1	0	0	2
11034	598351	6	0	0	0	4	4
11034	598352	6	1	2	0	1	4
11034	188937	5	2	1	0	2	5
11034	206187	5	1	0	0	3	4
11034	209584	5	1	0	1	1	3
11034	598226	5	1	0	0	0	1
11034	598236	5	1	2	1	4	8
11034	598239	5	1	0	0	1	2
11034	598245	5	1	3	0	0	4
11034	598249	5	1	1	0	0	2
11034	598256	5	0	1	0	1	2
11034	598263	5	1	0	0	0	1
11034	598274	5	1	0	0	0	1
11034	598275	5	1	0	0	1	2
11034	598287	5	1	2	0	2	5
11034	598300	5	1	0	0	0	1
11034	598311	5	1	1	0	0	2
11034	598316	5	0	0	0	0	0
11034	598329	5	1	0	1	3	5
11034	598338	5	1	2	0	1	4
11034	598342	5	1	0	0	0	1
11034	598343	5	0	1	0	0	1
11034	598348	5	0	1	0	1	2
11034	196955	4	1	2	1	1	5
11034	198667	4	0	1	0	0	1
11034	208147	4	0	2	0	1	3
11034	209180	4	1	0	0	1	2
11034	215994	4	1	1	2	0	4
11034	276159	4	1	0	0	1	2
11034	598225	4	2	0	0	1	3
11034	598230	4	0	0	0	0	0
11034	598247	4	4	0	0	0	4
11034	598253	4	0	3	1	0	4
11034	598257	4	2	0	1	0	3
11034	598258	4	0	1	0	2	3
11034	598267	4	1	1	0	1	3
11034	598269	4	2	0	0	0	2
11034	598272	4	2	0	0	0	2
11034	598277	4	0	0	0	0	0
11034	598279	4	2	0	0	0	2
11034	598284	4	0	0	0	0	0
11034	598293	4	1	1	0	0	2
11034	598314	4	0	0	0	1	1
11034	598317	4	1	0	0	0	1
11034	598323	4	2	2	0	0	4
11034	598324	4	2	1	0	2	5
11034	598328	4	3	0	0	1	4
11034	598332	4	1	0	0	1	2
11034	598333	4	3	0	0	0	3
11034	598339	4	1	1	1	0	3
11034	193245	3	2	1	0	2	5
11034	193246	3	2	1	0	2	5
11034	204318	3	0	2	0	0	2
11034	206227	3	1	2	0	1	4
11034	214340	3	0	1	0	2	3
11034	215269	3	0	0	0	0	0
11034	218056	3	0	0	1	2	3
11034	276146	3	1	1	0	1	3
11034	276150	3	0	1	0	2	3
11034	276155	3	1	0	0	1	2
11034	276156	3	2	1	0	4	7
11034	276157	3	2	1	0	2	5
11034	276158	3	1	0	0	1	2
11034	598232	3	0	0	0	0	0
11034	598234	3	1	0	0	0	1
11034	598235	3	2	0	1	0	3
11034	598242	3	2	0	0	1	3
11034	598244	3	1	0	0	0	1
11034	598246	3	0	0	0	0	0
11034	598248	3	2	0	0	1	3
11034	598260	3	2	0	0	0	2
11034	598261	3	3	1	0	1	5
11034	598262	3	0	0	0	0	0
11034	598264	3	1	0	0	0	1
11034	598265	3	0	0	0	0	0
11034	598276	3	0	1	0	0	1
11034	598280	3	1	0	0	0	1
11034	598282	3	0	1	0	1	2
11034	598283	3	0	1	0	2	3
11034	598288	3	0	0	0	1	1
11034	598290	3	0	0	0	0	0
11034	598295	3	1	0	0	1	2
11034	598299	3	1	0	1	1	3
11034	598302	3	1	2	0	0	3
11034	598304	3	1	0	0	0	1
11034	598306	3	0	0	0	0	0
11034	598312	3	0	0	0	1	1
11034	598315	3	0	1	0	0	1
11034	598319	3	1	2	0	0	3
11034	598320	3	0	2	0	0	2
11034	598322	3	1	0	1	0	2
11034	598330	3	1	1	0	1	3
11034	598331	3	2	0	0	0	2
11034	598340	3	0	3	0	2	5
11034	598345	3	0	0	0	0	0
11034	598347	3	2	0	1	0	3
11034	189915	2	0	0	0	0	0
11034	209473	2	0	0	0	0	0
11034	276147	2	0	0	0	0	0
11034	276148	2	0	1	0	1	2
11034	276151	2	0	0	0	0	0
11034	276153	2	0	0	1	0	1
11034	598229	2	0	1	0	0	1
11034	598237	2	0	0	0	1	1
11034	598238	2	0	0	1	0	1
11034	598241	2	0	0	0	2	2
11034	598254	2	0	0	0	0	0
11034	598259	2	1	1	0	2	4
11034	598266	2	1	1	0	1	3
11034	598271	2	0	0	0	1	1
11034	598273	2	0	1	0	0	1
11034	598281	2	0	0	0	0	0
11034	598289	2	0	1	0	0	1
11034	598292	2	1	0	0	1	2
11034	598294	2	1	0	0	0	1
11034	598301	2	2	2	0	1	5
11034	598307	2	0	0	0	1	1
11034	598309	2	0	0	0	3	3
11034	598310	2	0	0	0	0	0
11034	598313	2	2	0	0	0	2
11034	598318	2	0	1	0	0	1
11034	598326	2	1	0	0	0	1
11034	598334	2	0	0	0	0	0
11034	598335	2	0	0	0	0	0
11034	598341	2	0	0	0	0	0
11034	189740	1	0	1	0	1	2
11034	195640	1	1	0	0	0	1
11034	209532	1	0	0	0	0	0
11034	598252	1	1	0	0	0	1
11034	598270	1	1	2	0	0	3
11034	598286	1	0	1	0	0	1
11034	598308	1	4	0	0	0	4
11034	598321	1	0	3	0	0	3
11034	598327	1	0	1	0	0	1
11034	598349	1	0	0	0	0	0
17023	73377	35	1	1	0	0	2
17023	601119	26	5	12	0	2	19
17023	66360	25	2	7	0	3	12
17023	287629	21	0	4	1	1	6
17023	76516	21	0	4	1	1	6
17023	601091	20	3	8	0	0	11
17023	90379	16	1	0	0	2	3
17023	287630	15	3	6	0	0	9
17023	56262	15	3	6	0	0	9
17023	61742	14	0	3	0	2	5
17023	66124	13	2	0	1	0	3
17023	99716	12	1	3	0	0	4
17023	200493	11	2	0	0	0	2
17023	215231	11	1	4	0	0	5
17023	220234	11	1	1	0	2	4
17023	601089	11	2	1	0	0	3
17023	601104	11	2	0	0	0	2
17023	72287	11	2	0	0	0	2
17023	91737	11	2	1	0	0	3
17023	96525	11	0	3	0	0	3
17023	104151	10	3	2	0	1	6
17023	217007	10	3	2	0	1	6
17023	287636	10	3	2	0	1	6
17023	57954	10	1	3	0	0	4
17023	601095	10	2	2	0	0	4
17023	99117	10	1	3	0	5	9
17023	601097	9	3	3	0	0	6
17023	601115	9	2	2	0	1	5
17023	601125	9	0	0	0	0	0
17023	601144	9	0	4	0	1	5
17023	55456	8	0	1	2	1	4
17023	107948	7	0	2	0	1	3
17023	210980	7	0	1	2	1	4
17023	287621	7	0	3	0	2	5
17023	287632	7	0	1	0	0	1
17023	287638	7	1	2	1	0	4
17023	50812	7	0	1	0	0	1
17023	601096	7	2	3	0	0	5
17023	601101	7	0	0	0	0	0
17023	601110	7	0	1	1	0	2
17023	601111	7	1	0	0	3	4
17023	601113	7	2	2	0	0	4
17023	601124	7	1	1	0	0	2
17023	601153	7	1	5	1	0	7
17023	83906	7	1	1	0	0	2
17023	85281	7	1	1	0	1	3
17023	103115	6	3	2	0	0	5
17023	183177	6	1	1	0	1	3
17023	212371	6	1	3	0	0	4
17023	217396	6	0	2	0	2	4
17023	287627	6	0	1	0	0	1
17023	287635	6	3	2	0	0	5
17023	287637	6	1	1	0	0	2
17023	601082	6	2	1	0	1	4
17023	601098	6	2	0	0	0	2
17023	601100	6	0	1	0	1	2
17023	601130	6	0	2	0	1	3
17023	601138	6	1	2	0	0	3
17023	601155	6	0	3	0	0	3
17023	601156	6	0	0	0	0	0
17023	601157	6	1	4	1	0	6
17023	61936	6	0	3	0	0	3
17023	75505	6	0	1	0	1	2
17023	82095	6	1	2	0	0	3
17023	93164	6	0	2	0	0	2
17023	95569	6	0	1	0	0	1
17023	99999	6	0	0	0	0	0
17023	200623	5	1	1	0	0	2
17023	211342	5	1	3	0	0	4
17023	287622	5	1	4	0	2	7
17023	601094	5	0	1	0	0	1
17023	601105	5	2	1	0	1	4
17023	601128	5	1	3	0	0	4
17023	601133	5	1	3	0	0	4
17023	601135	5	2	1	0	0	3
17023	601137	5	0	1	0	0	1
17023	601141	5	0	2	0	0	2
17023	601147	5	2	1	0	0	3
17023	601151	5	2	0	0	0	2
17023	601152	5	1	1	0	0	2
17023	66750	5	0	2	0	0	2
17023	79338	5	0	2	0	0	2
17023	83839	5	1	4	0	2	7
17023	84069	5	2	1	0	0	3
17023	94631	5	0	0	0	0	0
17023	104101	4	1	0	0	1	2
17023	104260	4	2	1	0	0	3
17023	189673	4	0	0	0	0	0
17023	193386	4	0	1	0	0	1
17023	194819	4	1	2	0	0	3
17023	196032	4	0	3	0	0	3
17023	201573	4	0	4	0	0	4
17023	212744	4	1	0	0	0	1
17023	287623	4	0	1	0	0	1
17023	287625	4	1	0	0	0	1
17023	287626	4	0	1	0	0	1
17023	287634	4	0	1	0	0	1
17023	601084	4	1	3	0	0	4
17023	601086	4	1	2	0	0	3
17023	601088	4	0	0	0	0	0
17023	601090	4	1	2	0	0	3
17023	601092	4	1	1	0	1	3
17023	601093	4	4	1	0	1	6
17023	601102	4	1	2	0	0	3
17023	601103	4	1	0	0	0	1
17023	601122	4	1	1	0	0	2
17023	601129	4	2	0	0	0	2
17023	601131	4	0	0	0	0	0
17023	601132	4	0	1	0	0	1
17023	601148	4	1	2	0	0	3
17023	601149	4	0	1	0	0	1
17023	89775	4	0	1	0	0	1
17023	96220	4	1	1	0	1	3
17023	98189	4	1	2	0	0	3
17023	195735	3	0	1	0	0	1
17023	202227	3	1	4	0	0	5
17023	206419	3	0	3	0	1	4
17023	207619	3	1	0	0	0	1
17023	210035	3	1	1	0	0	2
17023	287624	3	0	2	0	0	2
17023	287631	3	0	0	0	0	0
17023	287633	3	0	3	0	0	3
17023	601099	3	1	0	0	1	2
17023	601106	3	0	2	0	1	3
17023	601108	3	0	1	0	0	1
17023	601120	3	3	1	0	0	4
17023	601123	3	1	1	0	0	2
17023	601126	3	1	0	0	0	1
17023	601127	3	0	3	0	0	3
17023	601134	3	0	3	0	0	3
17023	601139	3	0	2	0	0	2
17023	601140	3	0	0	0	0	0
17023	601143	3	1	1	0	0	2
17023	601158	3	1	1	0	1	3
17023	601159	3	2	1	0	0	3
17023	601161	3	0	3	0	0	3
17023	80546	3	0	3	0	0	3
17023	84065	3	0	1	0	0	1
17023	188504	2	0	0	0	0	0
17023	191197	2	1	0	0	0	1
17023	201446	2	0	1	0	0	1
17023	217282	2	1	2	0	0	3
17023	218075	2	0	2	0	0	2
17023	287628	2	2	1	0	1	4
17023	287639	2	0	0	0	0	0
17023	287640	2	0	0	0	0	0
17023	601083	2	0	0	0	0	0
17023	601085	2	0	1	0	0	1
17023	601087	2	1	1	0	0	2
17023	601107	2	1	0	0	1	2
17023	601109	2	0	0	0	0	0
17023	601112	2	0	0	0	0	0
17023	601114	2	0	1	0	0	1
17023	601117	2	0	0	0	0	0
17023	601118	2	0	0	0	0	0
17023	601136	2	1	1	0	0	2
17023	601142	2	2	0	0	0	2
17023	601145	2	1	1	0	0	2
17023	601146	2	1	1	0	1	3
17023	601150	2	0	1	0	0	1
17023	601154	2	1	0	0	0	1
17023	601160	2	0	1	0	0	1
17023	186866	1	0	0	0	0	0
17023	601116	1	0	0	0	1	1
17023	601121	1	0	0	0	0	0
17023	90099	1	0	1	0	0	1
51886	462961	35	6	3	1	6	16
51886	210274	27	2	2	1	5	10
51886	107681	26	2	5	2	6	15
51886	220403	26	2	5	2	6	15
51886	462971	26	2	5	2	6	15
51886	462933	23	1	0	1	0	2
51886	296939	22	2	3	0	2	7
51886	75527	22	2	3	0	2	7
51886	213122	21	2	3	1	0	6
51886	75404	20	1	3	2	2	8
51886	190200	18	6	1	2	2	11
51886	296950	18	5	1	1	1	8
51886	107591	17	3	6	1	0	10
51886	91683	17	0	4	0	4	8
51886	100748	16	1	2	3	2	8
51886	296943	16	1	2	3	2	8
51886	462953	16	1	2	3	2	8
51886	462991	16	5	0	1	1	7
51886	84025	15	1	1	1	1	4
51886	91817	15	5	0	1	1	7
51886	462923	14	2	1	0	2	5
51886	103391	13	2	0	0	2	4
51886	106508	13	0	1	0	1	2
51886	296940	13	2	0	0	2	4
51886	462959	13	0	2	1	2	5
51886	462990	13	0	0	2	1	3
51886	462924	11	2	1	0	0	3
51886	86777	11	2	2	1	2	7
51886	195344	10	3	2	1	3	9
51886	296942	9	0	1	0	1	2
51886	462958	9	1	1	1	2	5
51886	66547	9	0	1	0	1	2
51886	85122	9	4	3	2	2	11
51886	196274	8	1	0	0	0	1
51886	462920	8	0	1	2	1	4
51886	99979	8	1	2	0	3	6
51886	102904	7	1	1	0	2	4
51886	194673	7	0	0	0	0	0
51886	196607	7	2	0	0	1	3
51886	212055	7	0	2	2	1	5
51886	296944	7	0	1	0	0	1
51886	296951	7	0	1	3	1	5
51886	462960	7	0	2	2	1	5
51886	462963	7	1	1	0	2	4
51886	462967	7	3	2	3	1	9
51886	462983	7	2	0	0	2	4
51886	462994	7	0	1	3	1	5
51886	462995	7	0	2	1	3	6
51886	462999	7	1	1	0	1	3
51886	53889	7	0	1	3	1	5
51886	71553	7	0	1	0	0	1
51886	74837	7	3	4	0	1	8
51886	76275	7	1	0	1	0	2
51886	90493	7	0	2	1	2	5
51886	191681	6	2	2	0	3	7
51886	193543	6	2	1	0	2	5
51886	296941	6	0	1	0	2	3
51886	462902	6	4	1	4	2	11
51886	462925	6	0	1	1	1	3
51886	462942	6	1	0	0	1	2
51886	462952	6	0	2	0	1	3
51886	462966	6	1	3	1	0	5
51886	462970	6	0	0	0	0	0
51886	462974	6	3	2	1	0	6
51886	463000	6	1	0	0	0	1
51886	66635	6	0	1	0	1	2
51886	74477	6	0	1	0	2	3
51886	102392	5	1	0	2	3	6
51886	296945	5	0	0	0	2	2
51886	462907	5	1	0	2	1	4
51886	462917	5	1	3	0	4	8
51886	462928	5	0	0	0	5	5
51886	462932	5	2	1	0	1	4
51886	462955	5	0	0	0	2	2
51886	462975	5	4	3	1	1	9
51886	462982	5	1	1	0	1	3
51886	462984	5	0	2	0	4	6
51886	462985	5	1	2	0	2	5
51886	462986	5	0	1	0	2	3
51886	462992	5	2	2	0	0	4
51886	213516	4	1	1	0	1	3
51886	462906	4	2	1	0	1	4
51886	462908	4	0	1	1	0	2
51886	462918	4	0	0	0	0	0
51886	462937	4	2	1	0	3	6
51886	462943	4	1	1	1	1	4
51886	462944	4	2	0	0	1	3
51886	462945	4	0	2	0	0	2
51886	462965	4	1	0	2	0	3
51886	462973	4	1	0	3	1	5
51886	462981	4	1	1	0	0	2
51886	462987	4	0	2	0	0	2
51886	462993	4	0	2	2	1	5
51886	462998	4	3	0	0	0	3
51886	463001	4	3	1	0	0	4
51886	54966	4	0	2	0	0	2
51886	108732	3	0	0	0	1	1
51886	191940	3	0	1	0	0	1
51886	205134	3	1	0	0	0	1
51886	214241	3	0	0	0	0	0
51886	296946	3	1	0	0	0	1
51886	296947	3	0	1	0	0	1
51886	296948	3	0	0	0	0	0
51886	296949	3	1	0	0	0	1
51886	462910	3	3	0	0	0	3
51886	462911	3	1	0	2	0	3
51886	462913	3	1	1	2	0	4
51886	462921	3	0	2	0	0	2
51886	462926	3	0	0	2	0	2
51886	462929	3	1	2	0	1	4
51886	462930	3	0	2	0	2	4
51886	462931	3	1	0	0	0	1
51886	462935	3	0	1	0	0	1
51886	462936	3	1	1	1	0	3
51886	462938	3	0	0	0	0	0
51886	462939	3	1	0	0	1	2
51886	462964	3	0	0	0	3	3
51886	462968	3	1	0	1	0	2
51886	462976	3	1	1	0	4	6
51886	462978	3	0	0	1	3	4
51886	462979	3	1	0	1	2	4
51886	462980	3	0	1	0	1	2
51886	462988	3	0	1	0	0	1
51886	462989	3	2	1	0	1	4
51886	462997	3	0	0	0	0	0
51886	63563	3	1	0	0	0	1
51886	64569	3	0	1	0	0	1
51886	81085	3	1	1	0	1	3
51886	95594	3	1	0	0	0	1
51886	208395	2	0	2	0	1	3
51886	215200	2	3	0	1	3	7
51886	217737	2	0	0	0	1	1
51886	462900	2	0	0	0	0	0
51886	462901	2	1	0	0	0	1
51886	462903	2	0	0	0	0	0
51886	462912	2	1	0	0	1	2
51886	462914	2	1	0	1	0	2
51886	462915	2	0	0	1	0	1
51886	462916	2	0	0	1	0	1
51886	462919	2	1	0	2	1	4
51886	462922	2	1	0	1	1	3
51886	462927	2	0	2	0	0	2
51886	462934	2	0	0	0	6	6
51886	462941	2	1	0	0	2	3
51886	462946	2	1	2	0	1	4
51886	462947	2	2	0	0	0	2
51886	462948	2	0	0	0	1	1
51886	462950	2	1	0	0	2	3
51886	462954	2	0	3	0	1	4
51886	462957	2	0	1	0	2	3
51886	462962	2	1	2	0	2	5
51886	462969	2	1	0	0	2	3
51886	462977	2	1	2	0	1	4
51886	462996	2	0	2	0	1	3
51886	463002	2	0	0	0	0	0
51886	205223	1	0	0	0	0	0
51886	208519	1	0	0	0	0	0
51886	462899	1	1	0	0	1	2
51886	462904	1	0	0	0	0	0
51886	462905	1	0	1	0	1	2
51886	462909	1	0	0	0	0	0
51886	462940	1	1	1	0	1	3
51886	462949	1	0	1	0	0	1
51886	462951	1	0	0	1	0	1
51886	462956	1	1	0	0	1	2
51886	462972	1	1	2	0	1	4
78596	279642	37	2	1	3	3	9
78596	202516	23	1	3	1	1	6
78596	279636	23	1	3	1	1	6
78596	219443	21	0	0	0	0	0
78596	279641	20	3	6	0	4	13
78596	279630	16	2	1	0	10	13
78596	516215	15	1	0	0	0	1
78596	516272	14	1	3	0	0	4
78596	516229	13	2	0	3	2	7
78596	279643	12	0	2	0	5	7
78596	516228	12	2	1	0	3	6
78596	516238	12	0	1	0	0	1
78596	516265	11	1	0	1	0	2
78596	516266	11	4	1	0	1	6
78596	199166	10	0	0	0	0	0
78596	516312	10	1	1	0	2	4
78596	279639	9	2	2	1	6	11
78596	516233	9	4	0	1	3	8
78596	516235	9	1	0	0	0	1
78596	516286	9	6	0	0	1	7
78596	195090	8	1	0	0	1	2
78596	200769	8	2	0	0	0	2
78596	279646	8	1	0	0	0	1
78596	279648	8	1	0	0	1	2
78596	279651	8	2	0	0	0	2
78596	516213	8	0	0	0	3	3
78596	516223	8	2	1	1	0	4
78596	516242	8	0	3	0	2	5
78596	516255	8	1	0	0	1	2
78596	516259	8	1	0	1	1	3
78596	516217	7	1	2	0	2	5
78596	516226	7	1	4	0	2	7
78596	516227	7	3	1	0	0	4
78596	516230	7	0	3	0	2	5
78596	516275	7	1	0	0	1	2
78596	516281	7	0	3	1	1	5
78596	516287	7	1	1	1	3	6
78596	516288	7	0	1	1	4	6
78596	516313	7	2	1	0	2	5
78596	185540	6	1	1	0	1	3
78596	198492	6	2	0	0	2	4
78596	279633	6	2	1	1	1	5
78596	279634	6	0	0	0	3	3
78596	279638	6	4	0	0	0	4
78596	279640	6	0	0	0	0	0
78596	279650	6	0	0	0	1	1
78596	516211	6	2	1	1	1	5
78596	516248	6	1	1	0	0	2
78596	516262	6	1	1	0	0	2
78596	516269	6	1	2	0	3	6
78596	516295	6	2	1	0	1	4
78596	516296	6	3	0	0	2	5
78596	217462	5	1	0	0	0	1
78596	217680	5	1	0	1	1	3
78596	219053	5	0	2	0	4	6
78596	279632	5	1	0	0	3	4
78596	279637	5	1	0	1	4	6
78596	279644	5	3	0	1	1	5
78596	279645	5	1	2	0	1	4
78596	516231	5	0	3	1	2	6
78596	516241	5	0	1	0	0	1
78596	516244	5	2	0	0	6	8
78596	516246	5	0	0	1	0	1
78596	516247	5	1	1	0	3	5
78596	516250	5	2	1	0	0	3
78596	516257	5	4	0	0	1	5
78596	516271	5	0	1	1	0	2
78596	516273	5	4	2	0	0	6
78596	516289	5	0	0	0	0	0
78596	516292	5	0	0	1	0	1
78596	516299	5	1	0	1	2	4
78596	516301	5	1	2	0	5	8
78596	516305	5	0	2	0	2	4
78596	516307	5	1	2	0	3	6
78596	516315	5	1	0	0	0	1
78596	182312	4	0	0	0	1	1
78596	185198	4	0	0	0	1	1
78596	192223	4	1	0	0	1	2
78596	199939	4	0	2	0	0	2
78596	206240	4	1	1	0	3	5
78596	206486	4	1	0	0	0	1
78596	206945	4	2	0	0	0	2
78596	211974	4	1	0	1	0	2
78596	220531	4	0	0	0	0	0
78596	279652	4	1	0	1	0	2
78596	516214	4	0	1	0	4	5
78596	516219	4	1	0	0	3	4
78596	516239	4	2	2	0	2	6
78596	516254	4	3	0	1	0	4
78596	516263	4	2	1	0	1	4
78596	516264	4	2	0	1	1	4
78596	516274	4	0	1	1	0	2
78596	516279	4	2	0	0	2	4
78596	516282	4	0	0	1	3	4
78596	516303	4	0	0	0	0	0
78596	516306	4	1	0	0	3	4
78596	516308	4	1	0	0	3	4
78596	516311	4	0	0	0	1	1
78596	187958	3	0	0	0	0	0
78596	201376	3	0	0	0	2	2
78596	207956	3	0	0	0	0	0
78596	212363	3	1	2	0	1	4
78596	215393	3	0	0	0	0	0
78596	279635	3	1	1	0	1	3
78596	279647	3	0	0	0	0	0
78596	516208	3	0	3	1	1	5
78596	516209	3	2	2	0	0	4
78596	516210	3	2	0	0	1	3
78596	516212	3	1	0	0	0	1
78596	516216	3	1	0	0	0	1
78596	516221	3	0	1	0	1	2
78596	516222	3	1	0	0	3	4
78596	516224	3	1	0	0	1	2
78596	516225	3	0	0	0	1	1
78596	516237	3	0	0	2	0	2
78596	516243	3	4	1	0	0	5
78596	516245	3	0	1	0	0	1
78596	516249	3	0	1	0	2	3
78596	516251	3	0	0	1	0	1
78596	516256	3	0	0	0	0	0
78596	516258	3	2	0	0	2	4
78596	516260	3	3	0	0	1	4
78596	516277	3	1	1	0	2	4
78596	516280	3	1	0	0	1	2
78596	516283	3	0	0	0	1	1
78596	516284	3	1	0	0	0	1
78596	516285	3	1	0	0	0	1
78596	516290	3	0	0	0	1	1
78596	516298	3	2	0	0	2	4
78596	516300	3	0	0	0	0	0
78596	516302	3	0	0	0	0	0
78596	516309	3	1	0	0	0	1
78596	516310	3	0	0	0	0	0
78596	516314	3	0	0	0	3	3
78596	516316	3	0	0	0	0	0
78596	188487	2	1	1	0	0	2
78596	196909	2	0	1	0	2	3
78596	206219	2	0	1	0	0	1
78596	208120	2	0	0	0	0	0
78596	211114	2	0	0	0	0	0
78596	516218	2	1	0	0	1	2
78596	516232	2	0	0	0	3	3
78596	516234	2	1	0	0	1	2
78596	516236	2	1	0	0	1	2
78596	516240	2	1	3	0	0	4
78596	516252	2	0	0	0	0	0
78596	516253	2	1	0	0	0	1
78596	516267	2	0	0	0	0	0
78596	516268	2	2	0	0	0	2
78596	516270	2	0	0	0	2	2
78596	516276	2	1	0	0	0	1
78596	516294	2	1	0	0	0	1
78596	516304	2	0	0	0	0	0
78596	203775	1	0	0	0	1	1
78596	206008	1	0	0	0	0	0
78596	212997	1	1	1	0	1	3
78596	279631	1	0	0	0	2	2
78596	279649	1	0	0	0	0	0
78596	516220	1	1	1	0	0	2
78596	516261	1	0	0	0	0	0
78596	516278	1	0	1	2	0	3
78596	516291	1	1	0	0	0	1
78596	516293	1	1	0	0	0	1
78596	516297	1	1	0	0	0	1
49682	374665	13	1	5	0	0	6
49682	374715	13	3	4	0	0	7
49682	374649	11	1	1	0	0	2
49682	374651	10	1	1	0	2	4
49682	374747	10	1	3	1	1	6
49682	296335	9	1	2	0	0	3
49682	374662	9	1	3	0	4	8
49682	374664	9	2	2	1	0	5
49682	374761	9	1	1	0	0	2
49682	374643	8	2	1	0	0	3
49682	374675	8	3	3	0	0	6
49682	374703	8	1	3	0	1	5
49682	374718	8	1	4	3	1	9
49682	374740	8	0	3	0	0	3
49682	374764	8	2	3	0	0	5
49682	183370	7	3	1	0	0	4
49682	296341	7	0	2	1	0	3
49682	374626	7	2	2	0	0	4
49682	374637	7	1	2	0	1	4
49682	374741	7	0	1	0	0	1
49682	374746	7	2	2	0	1	5
49682	374748	7	0	6	0	0	6
49682	374753	7	0	2	0	0	2
49682	374762	7	0	1	0	0	1
49682	145973	6	0	1	0	0	1
49682	190404	6	1	6	0	0	7
49682	374621	6	0	1	0	0	1
49682	374634	6	2	0	0	1	3
49682	374635	6	2	0	0	1	3
49682	374640	6	0	3	0	0	3
49682	374641	6	3	1	0	0	4
49682	374661	6	0	1	0	0	1
49682	374667	6	0	1	0	0	1
49682	374674	6	1	2	0	0	3
49682	374704	6	1	3	0	0	4
49682	374709	6	0	2	0	0	2
49682	374710	6	2	1	0	1	4
49682	374712	6	0	1	0	0	1
49682	374717	6	2	1	0	0	3
49682	211316	5	1	2	0	1	4
49682	374625	5	0	2	0	0	2
49682	374629	5	0	0	0	0	0
49682	374639	5	0	0	0	0	0
49682	374642	5	0	0	0	0	0
49682	374646	5	0	3	1	0	4
49682	374647	5	1	1	0	0	2
49682	374650	5	0	0	0	0	0
49682	374652	5	1	1	0	0	2
49682	374656	5	0	0	0	0	0
49682	374657	5	0	0	0	0	0
49682	374658	5	0	4	0	1	5
49682	374670	5	0	1	0	0	1
49682	374671	5	1	0	0	0	1
49682	374679	5	1	0	0	1	2
49682	374688	5	2	0	0	0	2
49682	374700	5	1	2	0	0	3
49682	374701	5	2	2	0	0	4
49682	374705	5	1	3	0	0	4
49682	374711	5	1	2	0	1	4
49682	374723	5	2	3	0	0	5
49682	374724	5	1	0	0	2	3
49682	374729	5	1	1	0	0	2
49682	374738	5	1	1	0	0	2
49682	374743	5	1	1	0	0	2
49682	374745	5	1	3	0	0	4
49682	374749	5	0	1	0	0	1
49682	374752	5	0	1	0	1	2
49682	374754	5	0	2	0	0	2
49682	374755	5	1	2	0	0	3
49682	374756	5	1	1	0	0	2
49682	195741	4	2	2	0	0	4
49682	374645	4	0	2	0	0	2
49682	374648	4	1	1	0	0	2
49682	374654	4	0	1	0	0	1
49682	374655	4	1	0	0	0	1
49682	374659	4	0	0	0	0	0
49682	374660	4	0	3	0	0	3
49682	374663	4	1	0	0	0	1
49682	374666	4	0	4	0	0	4
49682	374669	4	0	0	0	0	0
49682	374678	4	1	0	0	0	1
49682	374685	4	1	2	0	0	3
49682	374689	4	1	1	0	0	2
49682	374691	4	0	1	0	0	1
49682	374693	4	0	2	0	0	2
49682	374696	4	0	1	0	0	1
49682	374706	4	1	1	0	0	2
49682	374707	4	2	1	0	0	3
49682	374714	4	0	0	0	0	0
49682	374716	4	1	1	1	0	3
49682	374719	4	2	1	0	0	3
49682	374720	4	1	2	0	0	3
49682	374721	4	2	1	0	0	3
49682	374722	4	0	2	0	3	5
49682	374725	4	1	0	0	0	1
49682	374726	4	1	1	0	0	2
49682	374727	4	1	0	0	0	1
49682	374731	4	1	0	2	0	3
49682	374735	4	0	0	0	1	1
49682	374742	4	1	1	0	0	2
49682	374763	4	0	2	0	0	2
49682	189643	3	0	0	0	0	0
49682	193398	3	1	1	0	0	2
49682	204515	3	0	2	0	0	2
49682	216399	3	1	2	0	0	3
49682	296334	3	3	1	0	0	4
49682	374628	3	0	0	0	0	0
49682	374668	3	1	1	0	0	2
49682	374673	3	1	2	1	1	5
49682	374676	3	0	0	1	0	1
49682	374677	3	1	1	0	0	2
49682	374681	3	0	3	0	0	3
49682	374683	3	0	0	0	0	0
49682	374684	3	1	1	0	0	2
49682	374686	3	0	2	0	0	2
49682	374694	3	0	2	0	0	2
49682	374695	3	0	0	0	0	0
49682	374697	3	0	1	0	0	1
49682	374698	3	1	1	0	0	2
49682	374733	3	0	1	0	0	1
49682	374734	3	1	1	0	0	2
49682	374751	3	0	2	0	0	2
49682	374758	3	0	2	0	0	2
49682	374765	3	0	3	0	0	3
49682	197884	2	0	0	0	0	0
49682	296333	2	0	0	0	0	0
49682	296336	2	1	3	0	0	4
49682	296337	2	0	1	0	0	1
49682	296338	2	0	2	0	0	2
49682	296340	2	0	2	0	0	2
49682	374620	2	0	1	0	0	1
49682	374622	2	0	1	0	0	1
49682	374623	2	0	1	0	0	1
49682	374627	2	0	1	2	0	3
49682	374636	2	1	2	0	0	3
49682	374653	2	2	1	0	0	3
49682	374672	2	1	0	0	1	2
49682	374680	2	0	1	1	1	3
49682	374682	2	0	1	0	0	1
49682	374690	2	1	1	0	0	2
49682	374692	2	0	0	0	1	1
49682	374708	2	1	0	0	1	2
49682	374713	2	0	1	0	0	1
49682	374730	2	0	1	0	0	1
49682	374732	2	0	2	0	1	3
49682	374736	2	1	0	0	0	1
49682	374737	2	0	0	0	0	0
49682	374739	2	0	0	0	0	0
49682	374744	2	0	2	0	0	2
49682	374757	2	0	2	0	0	2
49682	374760	2	0	0	0	0	0
49682	207446	1	0	0	0	0	0
49682	207585	1	1	1	0	0	2
49682	296339	1	0	0	0	0	0
49682	374624	1	0	1	0	0	1
49682	374638	1	2	1	0	0	3
49682	374644	1	0	0	0	0	0
49682	374687	1	1	1	0	0	2
49682	374699	1	1	1	0	0	2
49682	374702	1	1	0	0	0	1
49682	374728	1	0	0	0	0	0
49682	374750	1	0	1	0	0	1
49682	374759	1	0	0	0	0	0
2022	93029	67	2	3	0	5	10
2022	95932	65	2	6	1	7	16
2022	283536	34	0	3	1	3	7
2022	66787	32	4	2	0	1	7
2022	378672	29	2	4	0	1	7
2022	102677	28	1	4	0	4	9
2022	283526	28	1	1	2	2	6
2022	283535	28	1	4	0	4	9
2022	378675	28	1	4	0	4	9
2022	56674	28	1	1	2	2	6
2022	103427	26	1	5	0	1	7
2022	190222	26	4	0	1	2	7
2022	378673	26	1	1	2	3	7
2022	283539	24	0	2	0	0	2
2022	378660	24	1	6	1	6	14
2022	57685	24	0	2	0	0	2
2022	283538	23	2	1	0	2	5
2022	94535	23	2	1	0	2	5
2022	188404	22	3	1	0	2	6
2022	283527	22	3	1	0	2	6
2022	84992	22	2	1	2	6	11
2022	283529	21	1	1	0	3	5
2022	283532	20	0	1	0	1	2
2022	106857	19	2	6	0	4	12
2022	283540	19	1	1	1	2	5
2022	73611	19	1	1	1	2	5
2022	378676	18	2	6	0	4	12
2022	97150	18	1	1	0	2	4
2022	105673	17	0	0	0	1	1
2022	101473	16	1	3	0	2	6
2022	189112	16	1	2	0	3	6
2022	283533	16	1	2	0	3	6
2022	283537	16	1	3	0	3	7
2022	51169	16	2	1	0	4	7
2022	53829	16	1	3	0	3	7
2022	60974	16	1	2	0	3	6
2022	97363	15	2	2	1	1	6
2022	378662	14	1	2	1	1	5
2022	55116	14	2	2	1	3	8
2022	378674	13	2	2	1	1	6
2022	86775	13	3	1	0	1	5
2022	88624	13	1	2	1	0	4
2022	77140	10	0	1	0	4	5
2022	221949	9	2	3	0	2	7
2022	378627	9	1	1	0	2	4
2022	74278	9	2	3	0	2	7
2022	188887	8	0	4	0	5	9
2022	283528	8	2	1	2	4	9
2022	378621	8	0	0	0	1	1
2022	378631	8	4	0	0	2	6
2022	60001	8	0	4	0	5	9
2022	69649	8	2	1	2	4	9
2022	102865	7	1	1	0	2	4
2022	213008	7	2	1	0	0	3
2022	378664	7	0	3	0	3	6
2022	378600	6	0	0	1	2	3
2022	378603	6	1	2	0	0	3
2022	378626	6	0	1	0	5	6
2022	378628	6	1	3	0	3	7
2022	378643	6	0	1	0	1	2
2022	378667	6	0	0	0	1	1
2022	49913	6	0	0	0	0	0
2022	69694	6	0	3	1	0	4
2022	78084	6	0	2	0	1	3
2022	191752	5	0	0	0	1	1
2022	378612	5	1	0	0	1	2
2022	378625	5	0	0	0	0	0
2022	378640	5	0	1	0	1	2
2022	378648	5	1	2	0	2	5
2022	378653	5	1	2	0	0	3
2022	378665	5	2	0	0	1	3
2022	378671	5	0	3	0	2	5
2022	50636	5	1	2	0	3	6
2022	52102	5	0	0	2	4	6
2022	66593	5	1	1	0	1	3
2022	67023	5	1	1	0	1	3
2022	93093	5	0	0	1	0	1
2022	94577	5	0	0	0	1	1
2022	193474	4	0	1	0	0	1
2022	283530	4	0	0	0	1	1
2022	283531	4	0	0	0	1	1
2022	378593	4	2	1	0	2	5
2022	378597	4	1	2	0	2	5
2022	378604	4	0	1	0	3	4
2022	378608	4	1	1	0	1	3
2022	378611	4	0	0	0	2	2
2022	378619	4	1	2	0	0	3
2022	378635	4	0	1	0	2	3
2022	378638	4	1	1	0	0	2
2022	378641	4	1	0	0	2	3
2022	378645	4	2	0	0	0	2
2022	378651	4	0	2	0	0	2
2022	378654	4	1	0	0	3	4
2022	64221	4	0	0	0	1	1
2022	84620	4	0	0	0	1	1
2022	88100	4	0	0	0	2	2
2022	88674	4	0	1	0	2	3
2022	98092	4	1	2	0	0	3
2022	102559	3	0	0	0	0	0
2022	103056	3	1	2	0	0	3
2022	103357	3	2	1	0	1	4
2022	183692	3	0	0	0	1	1
2022	378595	3	1	1	2	0	4
2022	378598	3	1	0	0	2	3
2022	378601	3	1	0	1	1	3
2022	378607	3	0	0	1	3	4
2022	378620	3	1	0	0	1	2
2022	378622	3	1	0	0	2	3
2022	378623	3	0	0	0	1	1
2022	378624	3	0	1	2	0	3
2022	378630	3	0	1	0	0	1
2022	378633	3	1	0	0	1	2
2022	378639	3	0	0	1	1	2
2022	378642	3	0	0	0	1	1
2022	378644	3	1	1	0	1	3
2022	378646	3	1	0	0	0	1
2022	378647	3	0	2	0	3	5
2022	378650	3	0	0	0	1	1
2022	378652	3	0	0	0	3	3
2022	378655	3	1	2	0	0	3
2022	378659	3	0	1	0	1	2
2022	378661	3	0	2	1	0	3
2022	378670	3	0	0	0	1	1
2022	50711	3	1	1	0	0	2
2022	92427	3	4	1	0	1	6
2022	108371	2	3	1	0	3	7
2022	182265	2	0	1	0	1	2
2022	378594	2	0	1	0	1	2
2022	378596	2	0	1	0	0	1
2022	378599	2	0	2	0	1	3
2022	378605	2	0	0	0	1	1
2022	378606	2	0	1	0	2	3
2022	378614	2	1	0	0	1	2
2022	378615	2	0	2	0	1	3
2022	378616	2	0	2	0	1	3
2022	378618	2	0	0	0	0	0
2022	378629	2	2	0	1	2	5
2022	378634	2	0	0	0	0	0
2022	378637	2	0	3	0	1	4
2022	378658	2	1	0	0	1	2
2022	378663	2	1	0	0	1	2
2022	378666	2	1	0	1	1	3
2022	68750	2	0	2	0	1	3
2022	283534	1	1	0	0	1	2
2022	378602	1	0	0	0	0	0
2022	378609	1	0	0	0	1	1
2022	378610	1	0	0	0	0	0
2022	378613	1	0	1	0	2	3
2022	378617	1	0	0	0	4	4
2022	378632	1	0	0	0	0	0
2022	378636	1	2	1	0	1	4
2022	378649	1	0	1	0	1	2
2022	378656	1	0	0	0	0	0
2022	378657	1	0	2	0	0	2
2022	378668	1	0	0	0	0	0
2022	378669	1	0	1	0	1	2
2022	56849	1	1	3	0	3	7
2022	70953	1	1	0	0	1	2
2022	85175	1	0	1	0	0	1
24508	277824	63	8	7	5	12	32
24508	56765	54	6	4	3	8	21
24508	63019	44	2	5	0	3	10
24508	83197	44	2	3	2	1	8
24508	588903	35	2	3	2	1	8
24508	63484	29	2	1	0	4	7
24508	63938	28	4	1	1	3	9
24508	96154	27	5	5	3	13	26
24508	588928	26	2	0	1	6	9
24508	49711	24	0	1	2	4	7
24508	588922	24	0	1	2	4	7
24508	588934	22	1	3	0	2	6
24508	289786	21	2	0	0	4	6
24508	588914	21	5	4	1	7	17
24508	277820	17	0	1	1	1	3
24508	277821	17	1	3	1	1	6
24508	50317	17	1	3	1	1	6
24508	62407	15	1	1	2	5	9
24508	588872	14	1	0	0	1	2
24508	189017	13	0	2	0	2	4
24508	213140	13	0	0	2	1	3
24508	289784	13	0	2	0	2	4
24508	588890	13	2	1	0	4	7
24508	588892	13	0	2	0	2	4
24508	61023	13	0	2	0	2	4
24508	85496	13	1	1	2	3	7
24508	212083	12	1	1	0	4	6
24508	55157	12	3	1	1	1	6
24508	588930	12	1	1	0	4	6
24508	87952	12	0	2	0	4	6
24508	277828	11	0	3	0	1	4
24508	289781	11	1	0	0	3	4
24508	289783	11	2	0	0	0	2
24508	588924	11	1	0	4	1	6
24508	84016	11	1	2	4	2	9
24508	92850	11	1	0	0	3	4
24508	182583	10	1	5	0	1	7
24508	289787	10	0	2	0	4	6
24508	289788	10	0	0	1	4	5
24508	289791	10	0	0	0	0	0
24508	588879	10	1	2	0	1	4
24508	97905	10	0	0	1	4	5
24508	101488	9	1	2	1	1	5
24508	204945	9	1	0	0	0	1
24508	588926	9	2	0	0	3	5
24508	588932	9	0	0	1	4	5
24508	289780	8	0	2	1	0	3
24508	588912	8	1	0	0	2	3
24508	588917	8	2	2	1	1	6
24508	588918	8	1	0	0	3	4
24508	588938	8	3	1	0	3	7
24508	79703	8	7	2	3	2	14
24508	105921	7	1	0	0	0	1
24508	108593	7	1	3	3	1	8
24508	219119	7	1	0	0	0	1
24508	277817	7	1	1	0	2	4
24508	277822	7	1	0	0	0	1
24508	277829	7	0	1	0	1	2
24508	588871	7	3	2	0	0	5
24508	588889	7	2	3	1	1	7
24508	588923	7	1	0	0	0	1
24508	588929	7	2	1	1	1	5
24508	74879	7	3	2	0	0	5
24508	83293	7	2	1	0	4	7
24508	84191	7	0	0	0	1	1
24508	94801	7	1	1	0	2	4
24508	101673	6	3	0	0	6	9
24508	203928	6	1	1	0	1	3
24508	207852	6	1	2	0	1	4
24508	277819	6	3	1	0	0	4
24508	277830	6	2	0	0	2	4
24508	289785	6	3	0	0	6	9
24508	588887	6	1	1	0	1	3
24508	588906	6	2	2	0	2	6
24508	97655	6	0	0	0	2	2
24508	187918	5	0	0	1	4	5
24508	188001	5	2	1	1	4	8
24508	188563	5	0	0	0	1	1
24508	193346	5	2	1	0	1	4
24508	203949	5	0	0	0	0	0
24508	277818	5	1	1	1	3	6
24508	277823	5	1	1	0	2	4
24508	277827	5	1	0	0	1	2
24508	277831	5	0	0	0	1	1
24508	50235	5	1	0	0	1	2
24508	588876	5	0	1	0	0	1
24508	588877	5	2	0	0	1	3
24508	588885	5	2	0	0	2	4
24508	588898	5	1	1	0	1	3
24508	588905	5	1	0	0	1	2
24508	588916	5	0	0	1	3	4
24508	588933	5	0	1	1	1	3
24508	588935	5	1	1	1	1	4
24508	588936	5	2	0	0	1	3
24508	59798	5	0	0	0	1	1
24508	72567	5	2	1	0	2	5
24508	194743	4	1	0	2	2	5
24508	204076	4	1	1	0	0	2
24508	204148	4	1	2	1	2	6
24508	208084	4	1	1	0	1	3
24508	277826	4	0	1	1	0	2
24508	289789	4	0	2	0	2	4
24508	588884	4	0	0	0	0	0
24508	588894	4	1	0	0	0	1
24508	588907	4	0	1	0	1	2
24508	588910	4	1	1	0	3	5
24508	588919	4	2	1	0	1	4
24508	588920	4	0	0	1	1	2
24508	588921	4	1	1	0	2	4
24508	588937	4	0	3	0	2	5
24508	588939	4	0	0	0	2	2
24508	588940	4	0	1	0	1	2
24508	61203	4	0	2	0	1	3
24508	64371	4	0	2	0	2	4
24508	67439	4	0	0	0	4	4
24508	72579	4	0	1	1	0	2
24508	84287	4	2	1	2	1	6
24508	92290	4	0	3	1	2	6
24508	103369	3	2	1	0	0	3
24508	277815	3	1	0	0	1	2
24508	55424	3	2	0	0	0	2
24508	588873	3	2	1	0	1	4
24508	588886	3	1	0	0	0	1
24508	588888	3	2	4	0	0	6
24508	588891	3	3	3	0	1	7
24508	588893	3	1	0	0	4	5
24508	588895	3	0	0	0	1	1
24508	588896	3	0	0	0	2	2
24508	588901	3	1	0	0	2	3
24508	588908	3	3	1	0	1	5
24508	588909	3	0	1	0	1	2
24508	588915	3	0	1	1	3	5
24508	588925	3	1	1	0	0	2
24508	61314	3	1	0	0	1	2
24508	192273	2	1	0	1	1	3
24508	211134	2	0	1	0	0	1
24508	277816	2	0	2	0	1	3
24508	289790	2	0	0	0	0	0
24508	588870	2	0	0	0	1	1
24508	588878	2	2	0	0	1	3
24508	588881	2	0	1	0	0	1
24508	588882	2	1	0	0	0	1
24508	588883	2	1	0	0	0	1
24508	588897	2	2	0	0	0	2
24508	588900	2	0	1	0	0	1
24508	588904	2	0	2	0	2	4
24508	588913	2	0	0	0	0	0
24508	588927	2	1	0	0	2	3
24508	588931	2	1	0	0	1	2
24508	72706	2	0	0	0	0	0
24508	87734	2	0	0	0	0	0
24508	191262	1	1	1	0	1	3
24508	277825	1	1	0	0	0	1
24508	289782	1	0	1	0	0	1
24508	588874	1	1	2	0	2	5
24508	588875	1	0	0	0	1	1
24508	588880	1	0	0	0	2	2
24508	588899	1	0	3	1	0	4
24508	588902	1	0	1	0	2	3
24508	588911	1	1	0	0	1	2
130257	499465	17	1	4	1	3	9
130257	499505	17	1	0	2	1	4
130257	499402	12	3	0	1	3	7
130257	499419	12	1	0	0	0	1
130257	499481	12	6	0	2	4	12
130257	499520	12	3	0	0	0	3
130257	499536	12	2	2	1	1	6
130257	499540	12	0	2	0	3	5
130257	499446	11	0	1	0	0	1
130257	499441	10	1	3	0	1	5
130257	499416	9	1	2	0	0	3
130257	499534	9	0	0	0	0	0
130257	499438	8	1	1	0	0	2
130257	499487	8	4	2	0	2	8
130257	499517	8	3	1	0	1	5
130257	499546	8	2	1	0	3	6
130257	499439	7	2	1	1	0	4
130257	499456	7	0	2	0	1	3
130257	499473	7	1	1	0	3	5
130257	499478	7	1	1	1	1	4
130257	499486	7	2	0	0	1	3
130257	499522	7	1	0	0	4	5
130257	499525	7	0	0	0	4	4
130257	499527	7	0	1	0	0	1
130257	499392	6	0	1	1	1	3
130257	499399	6	0	1	0	1	2
130257	499434	6	0	1	0	3	4
130257	499474	6	0	0	1	0	1
130257	499539	6	0	1	0	0	1
130257	499413	5	1	0	0	1	2
130257	499414	5	1	1	0	0	2
130257	499417	5	0	3	0	1	4
130257	499418	5	1	0	0	1	2
130257	499421	5	1	1	1	2	5
130257	499422	5	1	3	3	0	7
130257	499442	5	1	0	0	1	2
130257	499447	5	1	1	0	2	4
130257	499466	5	4	1	0	3	8
130257	499467	5	0	1	0	1	2
130257	499470	5	2	0	0	2	4
130257	499471	5	0	0	2	2	4
130257	499480	5	1	0	0	0	1
130257	499483	5	2	2	0	2	6
130257	499492	5	2	3	1	0	6
130257	499499	5	0	0	0	2	2
130257	499518	5	2	1	0	0	3
130257	499519	5	0	0	0	0	0
130257	499524	5	2	2	0	3	7
130257	499538	5	1	1	0	0	2
130257	499542	5	1	1	1	3	6
130257	499549	5	0	1	0	2	3
130257	499551	5	0	0	0	1	1
130257	499395	4	0	1	1	0	2
130257	499404	4	1	0	1	0	2
130257	499408	4	1	1	0	1	3
130257	499409	4	0	0	0	1	1
130257	499410	4	1	1	0	0	2
130257	499424	4	3	0	0	0	3
130257	499425	4	1	2	0	0	3
130257	499429	4	1	0	2	0	3
130257	499432	4	1	1	0	0	2
130257	499435	4	2	1	0	1	4
130257	499440	4	0	0	0	0	0
130257	499443	4	0	1	0	0	1
130257	499445	4	1	0	0	0	1
130257	499448	4	1	0	0	0	1
130257	499451	4	0	0	0	1	1
130257	499461	4	0	2	0	0	2
130257	499463	4	0	0	0	1	1
130257	499476	4	1	1	0	1	3
130257	499477	4	0	2	0	1	3
130257	499482	4	1	0	0	0	1
130257	499490	4	1	5	0	1	7
130257	499491	4	1	1	1	1	4
130257	499507	4	0	1	0	0	1
130257	499509	4	0	2	0	0	2
130257	499510	4	0	0	0	1	1
130257	499514	4	2	1	0	1	4
130257	499523	4	0	0	1	1	2
130257	499537	4	1	1	0	0	2
130257	499544	4	0	1	0	1	2
130257	499548	4	1	2	0	0	3
130257	499396	3	0	1	0	0	1
130257	499397	3	0	0	2	0	2
130257	499398	3	0	0	2	0	2
130257	499400	3	0	1	0	1	2
130257	499403	3	0	2	0	1	3
130257	499405	3	1	0	0	0	1
130257	499407	3	1	2	0	1	4
130257	499412	3	1	0	0	0	1
130257	499426	3	1	0	0	0	1
130257	499428	3	0	0	0	0	0
130257	499431	3	1	1	0	2	4
130257	499437	3	1	0	0	3	4
130257	499455	3	1	2	0	0	3
130257	499468	3	1	1	0	0	2
130257	499475	3	0	2	0	1	3
130257	499479	3	0	1	0	1	2
130257	499498	3	1	1	0	1	3
130257	499500	3	0	0	0	1	1
130257	499501	3	0	1	0	0	1
130257	499508	3	0	0	0	1	1
130257	499511	3	1	0	1	0	2
130257	499515	3	1	2	0	1	4
130257	499516	3	1	0	1	1	3
130257	499521	3	0	0	0	0	0
130257	499535	3	0	0	1	1	2
130257	499543	3	0	2	0	0	2
130257	499547	3	2	0	0	1	3
130257	499550	3	0	0	0	1	1
130257	499552	3	1	1	1	2	5
130257	499401	2	0	1	1	0	2
130257	499411	2	0	0	0	2	2
130257	499420	2	0	0	0	1	1
130257	499423	2	1	1	0	0	2
130257	499427	2	0	0	2	1	3
130257	499444	2	4	2	0	0	6
130257	499449	2	0	1	0	1	2
130257	499450	2	2	0	0	1	3
130257	499452	2	0	1	0	1	2
130257	499453	2	0	1	0	1	2
130257	499454	2	0	1	0	1	2
130257	499458	2	2	0	1	2	5
130257	499459	2	2	0	0	0	2
130257	499460	2	0	0	0	1	1
130257	499462	2	1	3	0	1	5
130257	499464	2	0	0	0	1	1
130257	499469	2	0	0	0	0	0
130257	499484	2	0	0	0	1	1
130257	499485	2	0	1	0	0	1
130257	499488	2	0	0	0	0	0
130257	499496	2	0	0	0	0	0
130257	499497	2	0	1	0	0	1
130257	499503	2	0	1	1	0	2
130257	499504	2	2	2	0	0	4
130257	499506	2	0	2	0	0	2
130257	499512	2	1	0	1	1	3
130257	499513	2	0	0	0	1	1
130257	499528	2	1	3	0	2	6
130257	499529	2	0	2	0	0	2
130257	499530	2	0	2	0	2	4
130257	499532	2	0	2	0	1	3
130257	499545	2	1	2	0	0	3
130257	499393	1	1	0	0	0	1
130257	499394	1	0	0	0	1	1
130257	499406	1	1	0	0	1	2
130257	499415	1	0	0	0	1	1
130257	499430	1	1	1	2	0	4
130257	499433	1	0	0	0	2	2
130257	499436	1	0	1	0	0	1
130257	499457	1	0	2	0	2	4
130257	499472	1	0	1	0	2	3
130257	499489	1	0	2	0	0	2
130257	499493	1	0	0	0	0	0
130257	499494	1	1	0	0	0	1
130257	499495	1	0	1	0	0	1
130257	499502	1	0	2	0	0	2
130257	499526	1	1	4	0	1	6
130257	499531	1	0	1	0	1	2
130257	499533	1	0	0	0	1	1
130257	499541	1	2	1	0	0	3
36352	586930	51	10	5	1	0	16
36352	586917	24	3	3	1	1	8
36352	586844	14	4	5	0	0	9
36352	586939	13	2	2	0	0	4
36352	586935	12	4	0	0	0	4
36352	586817	11	3	1	0	0	4
36352	586923	11	2	2	1	0	5
36352	586810	8	1	1	0	0	2
36352	586814	8	0	1	0	0	1
36352	586818	8	2	3	1	1	7
36352	586893	8	1	1	0	0	2
36352	586899	8	1	2	0	0	3
36352	586925	7	0	1	0	0	1
36352	586927	7	2	1	0	0	3
36352	586790	6	0	3	0	0	3
36352	586900	6	1	1	0	0	2
36352	586908	6	1	1	0	0	2
36352	586913	6	2	3	0	0	5
36352	586919	6	3	3	0	0	6
36352	586929	6	2	3	0	0	5
36352	586937	6	1	3	0	1	5
36352	586940	6	0	2	0	0	2
36352	586787	5	1	1	0	1	3
36352	586823	5	3	4	2	0	9
36352	586827	5	1	2	0	0	3
36352	586831	5	1	1	1	0	3
36352	586834	5	0	2	0	1	3
36352	586847	5	2	0	0	0	2
36352	586872	5	1	2	1	0	4
36352	586910	5	0	2	0	0	2
36352	586920	5	2	2	0	0	4
36352	586936	5	0	0	1	0	1
36352	586941	5	2	0	2	0	4
36352	586821	4	1	0	1	1	3
36352	586822	4	2	0	0	0	2
36352	586851	4	0	1	0	0	1
36352	586853	4	1	2	0	0	3
36352	586854	4	0	0	0	0	0
36352	586869	4	1	0	0	0	1
36352	586875	4	0	1	0	0	1
36352	586876	4	0	1	1	0	2
36352	586878	4	1	0	0	1	2
36352	586889	4	1	1	0	0	2
36352	586902	4	0	0	0	0	0
36352	586907	4	4	1	0	0	5
36352	586912	4	1	0	0	0	1
36352	586915	4	2	1	0	0	3
36352	586934	4	1	1	0	0	2
36352	586945	4	1	1	0	0	2
36352	586791	3	0	0	0	0	0
36352	586793	3	1	2	0	1	4
36352	586800	3	0	1	0	0	1
36352	586809	3	0	0	0	0	0
36352	586813	3	0	0	1	0	1
36352	586828	3	1	0	0	0	1
36352	586833	3	0	1	1	0	2
36352	586842	3	1	1	0	1	3
36352	586845	3	0	1	0	0	1
36352	586848	3	0	1	0	0	1
36352	586855	3	0	0	0	0	0
36352	586857	3	0	2	0	0	2
36352	586863	3	1	0	0	0	1
36352	586865	3	0	2	0	0	2
36352	586867	3	0	1	0	0	1
36352	586868	3	1	1	0	0	2
36352	586870	3	2	1	0	0	3
36352	586881	3	0	1	0	2	3
36352	586883	3	0	0	0	0	0
36352	586884	3	2	2	0	0	4
36352	586886	3	0	1	1	0	2
36352	586887	3	2	4	0	1	7
36352	586890	3	2	4	0	0	6
36352	586904	3	0	1	0	0	1
36352	586928	3	1	1	0	0	2
36352	586933	3	1	0	0	0	1
36352	586942	3	1	1	0	0	2
36352	586795	2	0	0	0	0	0
36352	586796	2	0	2	0	1	3
36352	586801	2	0	2	0	0	2
36352	586803	2	0	1	0	0	1
36352	586806	2	0	1	0	0	1
36352	586807	2	0	1	0	1	2
36352	586808	2	0	1	0	0	1
36352	586819	2	1	1	0	0	2
36352	586824	2	1	0	0	0	1
36352	586825	2	0	0	0	0	0
36352	586829	2	0	0	0	0	0
36352	586840	2	0	1	0	0	1
36352	586841	2	1	0	0	0	1
36352	586843	2	1	0	0	0	1
36352	586862	2	0	1	0	1	2
36352	586874	2	0	1	1	0	2
36352	586885	2	0	0	0	0	0
36352	586888	2	0	0	0	0	0
36352	586891	2	0	2	0	0	2
36352	586892	2	0	2	0	0	2
36352	586894	2	1	1	0	0	2
36352	586896	2	1	0	0	0	1
36352	586898	2	0	1	0	0	1
36352	586901	2	0	1	0	0	1
36352	586903	2	2	1	0	0	3
36352	586905	2	1	1	0	0	2
36352	586911	2	0	3	0	0	3
36352	586918	2	0	1	0	0	1
36352	586921	2	0	1	0	0	1
36352	586922	2	0	1	0	0	1
36352	586931	2	1	0	0	0	1
36352	586938	2	0	1	0	0	1
36352	586943	2	1	0	1	1	3
36352	586944	2	0	0	0	0	0
36352	586786	1	0	1	0	0	1
36352	586788	1	0	0	0	1	1
36352	586789	1	0	1	0	0	1
36352	586792	1	1	2	0	0	3
36352	586794	1	0	1	0	0	1
36352	586797	1	0	1	0	0	1
36352	586798	1	0	1	0	1	2
36352	586799	1	0	0	0	0	0
36352	586802	1	0	0	0	0	0
36352	586804	1	0	0	0	0	0
36352	586805	1	0	1	0	0	1
36352	586811	1	1	1	0	0	2
36352	586812	1	0	0	0	0	0
36352	586815	1	0	0	0	0	0
36352	586816	1	0	0	0	0	0
36352	586820	1	0	0	0	0	0
36352	586826	1	0	0	0	0	0
36352	586830	1	0	2	0	1	3
36352	586832	1	0	1	0	0	1
36352	586835	1	0	0	0	0	0
36352	586836	1	0	1	0	0	1
36352	586837	1	0	0	0	0	0
36352	586838	1	0	0	0	0	0
36352	586839	1	0	2	0	0	2
36352	586846	1	0	0	0	0	0
36352	586849	1	0	0	0	1	1
36352	586850	1	1	1	0	0	2
36352	586852	1	0	0	0	0	0
36352	586856	1	1	0	0	0	1
36352	586858	1	0	1	0	0	1
36352	586859	1	0	0	0	0	0
36352	586860	1	1	1	0	0	2
36352	586861	1	0	1	0	0	1
36352	586864	1	1	1	0	0	2
36352	586866	1	1	0	0	0	1
36352	586871	1	0	0	0	0	0
36352	586873	1	0	0	0	0	0
36352	586877	1	0	0	0	0	0
36352	586879	1	0	0	0	1	1
36352	586880	1	0	0	0	1	1
36352	586882	1	1	0	0	0	1
36352	586895	1	0	1	0	0	1
36352	586897	1	0	0	0	0	0
36352	586906	1	0	0	0	0	0
36352	586909	1	0	0	0	0	0
36352	586914	1	0	0	0	1	1
36352	586916	1	0	0	0	0	0
36352	586924	1	0	0	0	0	0
36352	586926	1	1	0	0	0	1
36352	586932	1	0	1	0	0	1
63911	453314	11	1	3	0	0	4
63911	453413	11	3	1	0	2	6
63911	453356	10	1	5	0	2	8
63911	453357	10	2	1	0	1	4
63911	453384	10	3	0	0	0	3
63911	453339	9	1	0	1	0	2
63911	453355	9	1	0	0	0	1
63911	453316	8	1	0	0	0	1
63911	453337	8	0	0	1	0	1
63911	453342	8	1	2	0	0	3
63911	453377	8	1	1	0	0	2
63911	188656	7	0	1	0	0	1
63911	300122	7	0	1	0	0	1
63911	453295	7	2	0	0	0	2
63911	453298	7	1	0	0	0	1
63911	453323	7	2	1	0	0	3
63911	453332	7	1	1	0	1	3
63911	453340	7	0	2	0	0	2
63911	453348	7	0	0	0	1	1
63911	453361	7	0	0	1	0	1
63911	453365	7	0	1	0	0	1
63911	453376	7	2	1	0	0	3
63911	453417	7	2	1	0	0	3
63911	453421	7	0	0	0	0	0
63911	453301	6	0	4	0	0	4
63911	453318	6	0	1	0	0	1
63911	453324	6	2	1	0	0	3
63911	453333	6	1	0	0	0	1
63911	453363	6	2	1	1	0	4
63911	453378	6	2	0	0	1	3
63911	453391	6	1	1	0	0	2
63911	453426	6	1	1	0	0	2
63911	453428	6	0	0	0	0	0
63911	188960	5	1	1	0	0	2
63911	204226	5	0	3	0	0	3
63911	205674	5	0	1	0	0	1
63911	453308	5	0	0	0	1	1
63911	453309	5	2	0	0	0	2
63911	453322	5	1	1	0	0	2
63911	453326	5	2	1	1	0	4
63911	453327	5	0	0	0	0	0
63911	453352	5	1	1	0	1	3
63911	453358	5	1	0	0	0	1
63911	453373	5	0	1	0	0	1
63911	453383	5	1	2	0	0	3
63911	453408	5	0	0	2	0	2
63911	453414	5	1	0	0	0	1
63911	453420	5	0	2	0	1	3
63911	453427	5	1	1	0	0	2
63911	453431	5	1	0	1	0	2
63911	453434	5	2	0	0	0	2
63911	91995	5	0	0	0	2	2
63911	188957	4	0	0	0	1	1
63911	218351	4	2	0	0	0	2
63911	300118	4	2	0	0	0	2
63911	300120	4	0	0	0	0	0
63911	300121	4	0	0	0	0	0
63911	453304	4	2	0	0	0	2
63911	453312	4	1	1	0	0	2
63911	453317	4	1	1	0	1	3
63911	453331	4	0	1	0	0	1
63911	453334	4	0	0	0	1	1
63911	453341	4	1	0	0	0	1
63911	453347	4	0	0	0	0	0
63911	453349	4	1	0	0	0	1
63911	453354	4	0	2	0	1	3
63911	453374	4	0	0	0	0	0
63911	453380	4	1	1	0	1	3
63911	453389	4	0	2	0	0	2
63911	453399	4	1	0	0	2	3
63911	453400	4	2	1	0	0	3
63911	453401	4	5	0	0	0	5
63911	453402	4	1	0	0	2	3
63911	453404	4	0	1	2	0	3
63911	453412	4	1	0	0	0	1
63911	453415	4	1	1	0	0	2
63911	453416	4	1	0	0	1	2
63911	453424	4	4	1	0	2	7
63911	453430	4	2	1	0	0	3
63911	453432	4	0	0	0	0	0
63911	453433	4	1	1	0	0	2
63911	91141	4	0	0	0	0	0
63911	94109	4	2	0	0	0	2
63911	300119	3	1	1	0	0	2
63911	453299	3	3	0	0	0	3
63911	453303	3	1	0	0	0	1
63911	453307	3	3	0	0	0	3
63911	453310	3	3	2	1	0	6
63911	453315	3	0	0	0	0	0
63911	453321	3	2	0	0	0	2
63911	453325	3	2	2	0	0	4
63911	453330	3	2	2	0	0	4
63911	453335	3	0	1	0	0	1
63911	453338	3	1	0	0	0	1
63911	453343	3	2	2	0	0	4
63911	453350	3	1	0	0	0	1
63911	453367	3	1	1	0	0	2
63911	453371	3	0	1	0	0	1
63911	453375	3	0	0	0	0	0
63911	453379	3	0	3	1	0	4
63911	453381	3	0	1	1	1	3
63911	453387	3	1	0	0	0	1
63911	453393	3	0	1	0	0	1
63911	453395	3	1	0	0	0	1
63911	453403	3	0	1	0	0	1
63911	453405	3	0	0	0	0	0
63911	453407	3	1	1	0	0	2
63911	453409	3	0	0	0	0	0
63911	453411	3	1	0	0	0	1
63911	453418	3	1	1	0	0	2
63911	453419	3	1	0	0	0	1
63911	453422	3	2	0	0	0	2
63911	453425	3	1	0	0	0	1
63911	453435	3	0	0	0	0	0
63911	220973	2	2	0	0	1	3
63911	453297	2	1	1	0	2	4
63911	453300	2	2	0	0	0	2
63911	453305	2	2	0	0	1	3
63911	453319	2	2	1	0	0	3
63911	453320	2	1	0	0	0	1
63911	453329	2	0	0	0	0	0
63911	453345	2	1	2	0	0	3
63911	453346	2	1	1	0	1	3
63911	453351	2	0	1	0	0	1
63911	453353	2	2	0	0	0	2
63911	453359	2	0	0	0	0	0
63911	453364	2	0	0	0	0	0
63911	453366	2	2	0	0	0	2
63911	453369	2	0	0	0	0	0
63911	453370	2	0	1	0	0	1
63911	453372	2	1	0	0	0	1
63911	453385	2	1	0	0	0	1
63911	453386	2	0	1	0	0	1
63911	453388	2	1	0	0	0	1
63911	453390	2	0	0	0	0	0
63911	453394	2	0	0	0	0	0
63911	453396	2	1	0	0	0	1
63911	453397	2	0	0	0	0	0
63911	453406	2	0	0	0	0	0
63911	453429	2	0	0	1	0	1
63911	453436	2	0	2	0	0	2
63911	453293	1	1	1	0	1	3
63911	453294	1	0	0	0	0	0
63911	453296	1	0	1	0	0	1
63911	453302	1	0	1	0	0	1
63911	453306	1	1	0	0	0	1
63911	453311	1	0	0	0	0	0
63911	453313	1	0	1	0	0	1
63911	453328	1	1	5	0	2	8
63911	453336	1	2	0	0	0	2
63911	453344	1	2	0	0	0	2
63911	453360	1	1	1	0	0	2
63911	453362	1	0	0	0	0	0
63911	453368	1	0	0	0	0	0
63911	453382	1	2	0	0	0	2
63911	453392	1	0	0	0	0	0
63911	453398	1	0	0	0	0	0
63911	453410	1	0	0	0	0	0
63911	453423	1	2	0	0	0	2
35092	537181	15	0	3	0	1	4
35092	203008	13	0	0	0	1	1
35092	213167	13	1	0	0	2	3
35092	537180	13	1	0	0	2	3
35092	183746	12	0	4	2	0	6
35092	537214	12	0	1	0	3	4
35092	537165	11	2	0	1	2	5
35092	210550	9	4	1	1	1	7
35092	212199	9	0	4	0	1	5
35092	292620	9	3	2	1	1	7
35092	537171	9	0	4	0	1	5
35092	537173	9	0	4	0	1	5
35092	537206	9	2	2	0	0	4
35092	196566	8	1	0	1	1	3
35092	537177	8	1	0	0	0	1
35092	537178	8	1	0	0	0	1
35092	537182	8	3	1	0	0	4
35092	537215	8	3	2	3	3	11
35092	292621	7	2	1	0	1	4
35092	537176	7	1	1	0	0	2
35092	537195	7	1	1	3	0	5
35092	537217	7	1	1	0	0	2
35092	537234	7	1	3	0	2	6
35092	537238	7	1	2	1	0	4
35092	537239	7	0	0	2	3	5
35092	194660	6	2	1	0	0	3
35092	211545	6	4	1	1	0	6
35092	292610	6	2	2	0	0	4
35092	292617	6	0	1	1	0	2
35092	292622	6	3	0	0	2	5
35092	537174	6	2	2	0	1	5
35092	537188	6	1	0	0	3	4
35092	537194	6	1	0	0	1	2
35092	537198	6	2	1	0	2	5
35092	537223	6	1	0	0	0	1
35092	537225	6	3	0	1	3	7
35092	537229	6	0	0	0	2	2
35092	537232	6	2	1	0	0	3
35092	537251	6	1	0	2	0	3
35092	187132	5	2	0	0	0	2
35092	208940	5	0	1	0	1	2
35092	292611	5	0	1	1	0	2
35092	292613	5	3	0	2	0	5
35092	537166	5	3	0	2	0	5
35092	537170	5	2	2	0	1	5
35092	537189	5	1	1	0	0	2
35092	537192	5	0	0	0	0	0
35092	537197	5	2	3	0	3	8
35092	537203	5	1	1	0	0	2
35092	537207	5	2	0	1	0	3
35092	537218	5	2	0	1	1	4
35092	537221	5	4	0	4	0	8
35092	537231	5	0	1	0	0	1
35092	537246	5	1	0	0	1	2
35092	537254	5	0	2	1	0	3
35092	184921	4	0	1	0	2	3
35092	199165	4	1	0	0	0	1
35092	199181	4	1	3	0	0	4
35092	201356	4	1	0	0	3	4
35092	204793	4	0	0	1	0	1
35092	207845	4	2	0	0	1	3
35092	208222	4	1	0	0	0	1
35092	217153	4	5	0	1	0	6
35092	292609	4	0	0	0	0	0
35092	292615	4	1	0	1	1	3
35092	292618	4	0	0	0	0	0
35092	537168	4	1	1	0	2	4
35092	537185	4	1	3	0	1	5
35092	537186	4	2	0	2	0	4
35092	537191	4	1	0	1	0	2
35092	537201	4	1	1	0	0	2
35092	537205	4	1	1	0	1	3
35092	537210	4	1	0	0	0	1
35092	537220	4	1	0	1	0	2
35092	537224	4	0	1	0	0	1
35092	537228	4	2	3	0	0	5
35092	537240	4	2	1	0	0	3
35092	537241	4	1	2	0	0	3
35092	537244	4	1	0	0	0	1
35092	537245	4	2	0	0	0	2
35092	537249	4	2	0	0	2	4
35092	537252	4	2	0	1	1	4
35092	537253	4	5	1	0	0	6
35092	537255	4	1	0	0	1	2
35092	537256	4	0	2	0	0	2
35092	537259	4	2	0	0	1	3
35092	184796	3	0	1	0	2	3
35092	184900	3	0	1	0	2	3
35092	186850	3	0	0	0	1	1
35092	202729	3	1	0	1	2	4
35092	212983	3	0	2	1	0	3
35092	214922	3	0	1	0	2	3
35092	216529	3	0	1	1	0	2
35092	217869	3	1	0	0	1	2
35092	292612	3	2	1	1	0	4
35092	292614	3	2	1	1	0	4
35092	292616	3	0	1	0	2	3
35092	292619	3	0	0	0	1	1
35092	292623	3	0	0	0	0	0
35092	292624	3	0	0	0	0	0
35092	537167	3	2	1	0	0	3
35092	537179	3	0	0	0	1	1
35092	537183	3	1	0	0	2	3
35092	537184	3	0	0	0	0	0
35092	537204	3	1	0	0	0	1
35092	537209	3	2	1	3	1	7
35092	537211	3	2	0	0	0	2
35092	537219	3	0	3	0	0	3
35092	537226	3	0	2	0	1	3
35092	537227	3	0	0	0	1	1
35092	537230	3	2	2	1	0	5
35092	537235	3	2	0	0	2	4
35092	537248	3	1	1	0	0	2
35092	537250	3	2	0	0	1	3
35092	183481	2	2	0	0	1	3
35092	184240	2	0	0	0	1	1
35092	185187	2	1	1	0	1	3
35092	185534	2	0	0	0	1	1
35092	185620	2	0	0	0	0	0
35092	198439	2	1	1	0	1	3
35092	200015	2	1	1	0	0	2
35092	202598	2	0	0	1	2	3
35092	203351	2	0	0	1	1	2
35092	207150	2	0	2	0	0	2
35092	211116	2	0	0	0	0	0
35092	212900	2	1	0	0	0	1
35092	213937	2	1	1	0	0	2
35092	215829	2	0	0	1	0	1
35092	217085	2	0	0	0	0	0
35092	218977	2	0	0	0	1	1
35092	537169	2	0	0	0	1	1
35092	537187	2	0	2	0	0	2
35092	537190	2	1	1	0	0	2
35092	537193	2	1	1	0	3	5
35092	537199	2	0	0	2	0	2
35092	537208	2	1	0	0	0	1
35092	537212	2	2	0	0	0	2
35092	537213	2	0	1	0	1	2
35092	537216	2	0	1	0	0	1
35092	537222	2	0	1	0	1	2
35092	537233	2	0	0	0	0	0
35092	537242	2	1	0	0	0	1
35092	537243	2	1	0	0	0	1
35092	537258	2	0	0	0	1	1
35092	190007	1	0	0	0	1	1
35092	191335	1	0	0	0	0	0
35092	192800	1	0	2	0	0	2
35092	206111	1	0	0	0	1	1
35092	207946	1	0	0	0	0	0
35092	211896	1	1	0	0	0	1
35092	212495	1	1	0	0	0	1
35092	214965	1	0	1	0	0	1
35092	537175	1	2	0	0	0	2
35092	537196	1	1	0	1	0	2
35092	537200	1	2	0	0	0	2
35092	537202	1	3	0	0	0	3
35092	537236	1	0	0	0	0	0
35092	537237	1	0	0	0	1	1
35092	537247	1	0	0	0	2	2
35092	537257	1	1	0	1	0	2
20479	198977	43	2	3	0	4	9
20479	288696	42	2	3	0	4	9
20479	74372	35	2	3	0	2	7
20479	209515	24	4	9	3	3	19
20479	288695	24	4	9	3	3	19
20479	214292	18	1	3	2	1	7
20479	609758	18	0	0	0	0	0
20479	609812	14	2	2	0	1	5
20479	609759	12	4	1	0	0	5
20479	609768	11	1	2	0	3	6
20479	192121	10	0	0	0	0	0
20479	207535	9	1	0	1	3	5
20479	288703	9	4	1	0	1	6
20479	53847	9	4	1	0	1	6
20479	609761	9	4	2	1	3	10
20479	609772	9	0	2	2	7	11
20479	103135	8	1	2	0	2	5
20479	202024	8	4	1	0	1	6
20479	216696	8	0	1	2	0	3
20479	288697	8	1	3	0	1	5
20479	288714	8	1	2	0	2	5
20479	52431	8	1	3	0	1	5
20479	609753	8	1	0	0	0	1
20479	609815	8	1	2	0	2	5
20479	193516	7	0	2	0	1	3
20479	193638	7	1	1	0	1	3
20479	210546	7	0	0	0	2	2
20479	219823	7	2	1	0	3	6
20479	288704	7	2	4	0	0	6
20479	288712	7	1	0	0	0	1
20479	609763	7	0	0	0	0	0
20479	609779	7	0	4	0	9	13
20479	609780	7	2	0	0	0	2
20479	609784	7	1	2	0	3	6
20479	609800	7	2	1	0	0	3
20479	65447	7	2	4	0	0	6
20479	72446	7	1	0	0	0	1
20479	101014	6	0	0	0	1	1
20479	190888	6	1	0	0	1	2
20479	201898	6	2	1	0	1	4
20479	208082	6	0	0	0	1	1
20479	208304	6	3	1	0	3	7
20479	211263	6	1	0	0	0	1
20479	218427	6	0	1	0	0	1
20479	288699	6	0	0	0	1	1
20479	288706	6	0	0	0	0	0
20479	288713	6	3	0	0	3	6
20479	609764	6	2	0	0	0	2
20479	609767	6	1	1	0	0	2
20479	609776	6	0	1	0	0	1
20479	609782	6	2	1	1	3	7
20479	609786	6	1	2	1	2	6
20479	609788	6	0	1	1	3	5
20479	609796	6	1	1	0	0	2
20479	609798	6	0	1	2	1	4
20479	609799	6	1	0	0	1	2
20479	609809	6	1	2	0	3	6
20479	194891	5	1	0	0	0	1
20479	197415	5	2	2	1	1	6
20479	199209	5	1	1	0	1	3
20479	207655	5	0	1	0	1	2
20479	210066	5	0	3	0	0	3
20479	214852	5	3	0	0	3	6
20479	218603	5	4	1	0	1	6
20479	288698	5	1	0	0	0	1
20479	288700	5	0	1	0	0	1
20479	609746	5	0	2	1	0	3
20479	609757	5	3	0	0	0	3
20479	609791	5	3	1	0	3	7
20479	609794	5	2	1	0	0	3
20479	609801	5	0	0	1	2	3
20479	609806	5	1	0	0	1	2
20479	609810	5	0	0	0	1	1
20479	67073	5	2	2	0	0	4
20479	93770	5	0	1	0	0	1
20479	102028	4	3	0	0	3	6
20479	193696	4	1	1	0	1	3
20479	197129	4	3	0	0	5	8
20479	200213	4	0	2	0	1	3
20479	212958	4	0	0	0	3	3
20479	215054	4	0	1	0	1	2
20479	288701	4	2	0	0	3	5
20479	609745	4	1	1	0	1	3
20479	609748	4	0	2	0	0	2
20479	609749	4	0	1	0	1	2
20479	609751	4	0	1	0	2	3
20479	609752	4	1	0	0	1	2
20479	609754	4	0	1	0	0	1
20479	609755	4	3	1	0	0	4
20479	609765	4	1	2	0	0	3
20479	609771	4	2	0	0	0	2
20479	609773	4	2	0	0	0	2
20479	609774	4	1	1	0	1	3
20479	609790	4	1	1	0	0	2
20479	609793	4	1	1	0	1	3
20479	609795	4	0	0	0	0	0
20479	609797	4	1	2	0	1	4
20479	609802	4	0	0	0	0	0
20479	609811	4	0	0	0	0	0
20479	70818	4	2	0	0	3	5
20479	97654	4	0	0	2	0	2
20479	190475	3	2	1	0	0	3
20479	195792	3	1	0	0	1	2
20479	207169	3	1	1	0	0	2
20479	207257	3	0	1	0	2	3
20479	207573	3	0	0	0	0	0
20479	211195	3	0	2	0	1	3
20479	212687	3	0	0	0	0	0
20479	214122	3	1	1	0	2	4
20479	214512	3	0	0	0	0	0
20479	288694	3	1	1	0	3	5
20479	288707	3	1	0	0	1	2
20479	288708	3	0	1	0	0	1
20479	288711	3	0	0	0	0	0
20479	609743	3	0	1	0	1	2
20479	609744	3	0	0	2	2	4
20479	609747	3	1	1	0	1	3
20479	609760	3	1	3	0	0	4
20479	609766	3	1	0	0	0	1
20479	609769	3	1	3	0	0	4
20479	609770	3	0	0	0	1	1
20479	609777	3	0	1	0	5	6
20479	609781	3	0	2	0	1	3
20479	609789	3	0	2	0	1	3
20479	609803	3	1	0	0	0	1
20479	609804	3	2	0	0	0	2
20479	609808	3	0	1	0	1	2
20479	609813	3	0	2	0	3	5
20479	87714	3	1	1	0	3	5
20479	100037	2	0	0	0	0	0
20479	184313	2	0	0	0	0	0
20479	190941	2	0	0	0	0	0
20479	191055	2	0	1	0	2	3
20479	191234	2	0	1	0	2	3
20479	196053	2	0	1	0	1	2
20479	210728	2	0	0	0	1	1
20479	221904	2	2	6	1	2	11
20479	288702	2	0	0	0	0	0
20479	288705	2	0	0	0	0	0
20479	609750	2	0	1	0	0	1
20479	609756	2	1	1	0	0	2
20479	609762	2	0	4	0	1	5
20479	609775	2	2	2	0	2	6
20479	609778	2	1	0	0	0	1
20479	609785	2	1	0	0	1	2
20479	609787	2	0	1	0	1	2
20479	609814	2	0	0	0	0	0
20479	609816	2	0	1	0	0	1
20479	203076	1	1	1	0	1	3
20479	211093	1	0	0	0	0	0
20479	220007	1	0	1	0	1	2
20479	288709	1	0	0	0	1	1
20479	288710	1	0	0	0	1	1
20479	57353	1	0	0	0	1	1
20479	609783	1	2	2	0	0	4
20479	609792	1	1	0	0	1	2
20479	609805	1	1	0	0	0	1
20479	609807	1	0	0	0	1	1
41948	198847	33	3	5	0	2	10
41948	294410	33	3	5	0	2	10
41948	202328	29	0	3	0	1	4
41948	499828	28	0	3	0	1	4
41948	200750	21	2	8	0	5	15
41948	294437	21	2	8	0	5	15
41948	499831	18	2	6	0	1	9
41948	499824	15	2	4	0	0	6
41948	294411	14	4	0	0	3	7
41948	496672	14	3	2	0	1	6
41948	294422	13	2	2	0	3	7
41948	294433	13	1	2	0	1	4
41948	496668	13	4	2	0	1	7
41948	496677	13	3	4	0	0	7
41948	214668	11	2	4	0	0	6
41948	294408	11	3	3	2	2	10
41948	184750	10	0	1	0	0	1
41948	496663	10	2	3	2	2	9
41948	499830	10	2	1	0	0	3
41948	196025	9	0	1	0	1	2
41948	204676	9	0	2	0	0	2
41948	294438	9	0	4	0	0	4
41948	184058	8	1	3	0	1	5
41948	187782	8	1	4	0	0	5
41948	197395	8	1	6	0	1	8
41948	207377	8	1	2	0	1	4
41948	221516	8	3	0	0	0	3
41948	294417	8	1	3	0	1	5
41948	294429	8	1	6	0	1	8
41948	294431	8	0	1	0	0	1
41948	294435	8	3	2	0	2	7
41948	496674	8	0	2	0	0	2
41948	185929	7	0	1	0	0	1
41948	186025	7	1	2	0	0	3
41948	192406	7	0	2	0	2	4
41948	194776	7	1	3	0	0	4
41948	201699	7	1	0	0	0	1
41948	210475	7	0	1	0	0	1
41948	214878	7	3	2	0	2	7
41948	216717	7	0	3	1	0	4
41948	294420	7	1	2	0	1	4
41948	294423	7	1	1	0	1	3
41948	294424	7	1	1	0	0	2
41948	496662	7	0	1	0	0	1
41948	496671	7	1	1	0	1	3
41948	184273	6	0	2	0	0	2
41948	184274	6	0	2	0	0	2
41948	193223	6	0	0	0	0	0
41948	203567	6	0	2	0	0	2
41948	207520	6	2	5	0	1	8
41948	210438	6	2	1	0	0	3
41948	211088	6	1	1	0	0	2
41948	211319	6	0	0	0	1	1
41948	217103	6	0	3	0	2	5
41948	220257	6	0	1	0	0	1
41948	294432	6	0	2	0	0	2
41948	294434	6	0	0	0	0	0
41948	294436	6	4	2	0	0	6
41948	496669	6	1	2	0	0	3
41948	183762	5	1	2	1	2	6
41948	188470	5	2	2	1	0	5
41948	192387	5	1	2	1	1	5
41948	192615	5	0	3	0	1	4
41948	193216	5	0	3	0	2	5
41948	193515	5	0	1	0	0	1
41948	193666	5	1	1	0	0	2
41948	194402	5	2	0	0	6	8
41948	196031	5	0	0	0	1	1
41948	203752	5	0	3	0	0	3
41948	203940	5	0	2	0	0	2
41948	207052	5	0	1	0	0	1
41948	209788	5	0	2	0	0	2
41948	209795	5	0	2	0	1	3
41948	210014	5	1	1	0	0	2
41948	210824	5	1	2	0	1	4
41948	211795	5	1	3	0	0	4
41948	213823	5	0	4	0	0	4
41948	218377	5	1	3	0	0	4
41948	218802	5	1	0	0	0	1
41948	294409	5	4	2	0	1	7
41948	294428	5	1	3	0	0	4
41948	496676	5	0	2	0	0	2
41948	184962	4	0	2	0	0	2
41948	185674	4	1	1	0	1	3
41948	185793	4	2	4	0	1	7
41948	187222	4	0	0	0	0	0
41948	190034	4	2	1	0	1	4
41948	190980	4	0	0	0	0	0
41948	196971	4	0	1	0	0	1
41948	199951	4	0	1	0	0	1
41948	200234	4	0	0	0	0	0
41948	201249	4	0	1	0	4	5
41948	205377	4	0	3	0	0	3
41948	208282	4	1	3	0	0	4
41948	213548	4	0	1	1	0	2
41948	219888	4	0	2	0	0	2
41948	294414	4	1	1	0	0	2
41948	294418	4	1	1	0	0	2
41948	294421	4	0	1	0	0	1
41948	294439	4	3	4	0	0	7
41948	496665	4	0	2	0	0	2
41948	499820	4	0	2	0	0	2
41948	499821	4	1	2	0	1	4
41948	184063	3	0	1	0	0	1
41948	185724	3	0	1	0	1	2
41948	186491	3	0	1	0	0	1
41948	188303	3	1	0	0	0	1
41948	188986	3	0	0	0	1	1
41948	190414	3	0	2	0	0	2
41948	191255	3	2	2	0	0	4
41948	195734	3	0	1	0	0	1
41948	196387	3	0	3	0	0	3
41948	199865	3	2	0	0	0	2
41948	205299	3	0	2	0	0	2
41948	213824	3	1	1	0	0	2
41948	218765	3	0	1	0	1	2
41948	294412	3	1	2	0	2	5
41948	294413	3	0	1	1	0	2
41948	294415	3	0	1	0	0	1
41948	294416	3	0	0	0	0	0
41948	294419	3	0	1	0	1	2
41948	294425	3	0	1	0	1	2
41948	294426	3	2	0	0	2	4
41948	294427	3	0	0	0	0	0
41948	496664	3	0	2	0	0	2
41948	496666	3	2	1	0	0	3
41948	496667	3	0	2	0	1	3
41948	496670	3	1	1	0	0	2
41948	496673	3	1	1	0	1	3
41948	499823	3	0	0	0	2	2
41948	499825	3	2	0	0	1	3
41948	499826	3	4	3	0	1	8
41948	499827	3	0	2	0	1	3
41948	207045	2	0	0	0	0	0
41948	207501	2	0	1	0	0	1
41948	208662	2	0	1	0	0	1
41948	210041	2	1	1	0	0	2
41948	210341	2	0	0	0	0	0
41948	217844	2	0	2	0	0	2
41948	220790	2	0	1	0	0	1
41948	221507	2	0	0	0	0	0
41948	294430	2	1	2	0	0	3
41948	496661	2	0	1	0	0	1
41948	496675	2	0	1	0	0	1
41948	499815	2	0	3	0	0	3
41948	499816	2	1	2	0	0	3
41948	499817	2	0	1	0	0	1
41948	499822	2	0	1	0	0	1
41948	499829	2	0	1	0	1	2
41948	184236	1	0	0	0	0	0
41948	185315	1	1	0	0	0	1
41948	190038	1	1	0	0	0	1
41948	190639	1	0	1	0	0	1
41948	209763	1	0	0	0	0	0
41948	209827	1	0	0	0	1	1
41948	499818	1	0	0	0	0	0
41948	499819	1	0	0	0	0	0
17844	199026	37	3	7	5	3	18
17844	287827	37	3	7	5	3	18
17844	595026	15	2	3	1	4	10
17844	209940	12	1	2	0	0	3
17844	287833	12	2	0	0	0	2
17844	595070	12	1	0	0	1	2
17844	287835	10	1	0	0	0	1
17844	595008	10	1	1	3	0	5
17844	185294	9	0	0	1	1	2
17844	595024	8	3	0	0	1	4
17844	190315	7	0	1	1	2	4
17844	287825	7	0	0	0	2	2
17844	595017	7	0	2	0	0	2
17844	595036	7	1	1	0	0	2
17844	595071	7	1	1	0	0	2
17844	595072	7	2	3	0	0	5
17844	187046	6	1	2	0	0	3
17844	199789	6	2	1	0	0	3
17844	218855	6	0	1	0	2	3
17844	287821	6	1	1	0	0	2
17844	287822	6	2	3	0	3	8
17844	287826	6	3	4	0	3	10
17844	595006	6	2	0	2	3	7
17844	595007	6	4	1	0	0	5
17844	595012	6	2	2	1	0	5
17844	595014	6	3	0	0	0	3
17844	595019	6	2	0	1	0	3
17844	595039	6	1	2	0	0	3
17844	595051	6	1	0	0	0	1
17844	595062	6	1	0	1	0	2
17844	595067	6	0	1	0	0	1
17844	595079	6	0	0	0	1	1
17844	186144	5	1	1	0	1	3
17844	215302	5	0	1	0	0	1
17844	216826	5	2	0	0	0	2
17844	216885	5	0	0	0	0	0
17844	220046	5	0	1	1	1	3
17844	287831	5	1	1	1	0	3
17844	287838	5	0	0	0	0	0
17844	595010	5	0	0	0	1	1
17844	595011	5	1	1	1	0	3
17844	595015	5	1	1	0	0	2
17844	595021	5	2	1	0	1	4
17844	595025	5	0	1	0	0	1
17844	595033	5	2	1	0	0	3
17844	595058	5	1	0	1	0	2
17844	595065	5	3	1	0	0	4
17844	595074	5	1	0	0	0	1
17844	595086	5	1	1	0	0	2
17844	595091	5	0	3	0	0	3
17844	186783	4	0	0	1	0	1
17844	187079	4	0	0	0	0	0
17844	188938	4	0	1	0	0	1
17844	199860	4	1	0	0	0	1
17844	203138	4	1	1	0	0	2
17844	207240	4	0	0	0	0	0
17844	207737	4	0	1	0	2	3
17844	209792	4	1	0	0	0	1
17844	216528	4	0	0	1	0	1
17844	287830	4	2	1	1	1	5
17844	287834	4	1	1	1	0	3
17844	287836	4	0	1	1	0	2
17844	595018	4	1	0	1	0	2
17844	595022	4	1	0	1	1	3
17844	595031	4	1	0	0	0	1
17844	595035	4	1	1	0	0	2
17844	595040	4	1	0	0	0	1
17844	595047	4	0	2	1	3	6
17844	595052	4	0	2	0	0	2
17844	595053	4	1	0	0	0	1
17844	595057	4	2	0	0	0	2
17844	595063	4	0	0	0	0	0
17844	595073	4	0	1	0	0	1
17844	595076	4	2	0	0	0	2
17844	595078	4	0	0	0	0	0
17844	595082	4	1	1	0	0	2
17844	595089	4	0	1	0	0	1
17844	595092	4	1	2	0	0	3
17844	595097	4	1	0	0	0	1
17844	185200	3	1	0	1	0	2
17844	195944	3	1	0	0	0	1
17844	196685	3	0	0	0	0	0
17844	199943	3	0	1	0	0	1
17844	200014	3	0	1	0	0	1
17844	202941	3	0	0	0	0	0
17844	203324	3	0	0	0	0	0
17844	206280	3	0	1	0	0	1
17844	213016	3	2	0	0	0	2
17844	214942	3	0	0	0	1	1
17844	287832	3	1	1	0	1	3
17844	595003	3	0	0	0	1	1
17844	595004	3	0	0	0	0	0
17844	595013	3	1	1	0	1	3
17844	595023	3	1	0	0	0	1
17844	595027	3	2	2	0	0	4
17844	595028	3	1	1	0	0	2
17844	595030	3	0	0	0	0	0
17844	595041	3	0	0	0	0	0
17844	595042	3	0	0	0	0	0
17844	595046	3	0	0	0	0	0
17844	595048	3	1	0	0	0	1
17844	595050	3	0	0	0	0	0
17844	595061	3	0	0	0	0	0
17844	595066	3	0	0	1	0	1
17844	595068	3	0	0	0	0	0
17844	595080	3	1	0	0	0	1
17844	595081	3	0	0	0	0	0
17844	595084	3	2	1	0	0	3
17844	595087	3	0	2	0	0	2
17844	595090	3	0	1	0	1	2
17844	595095	3	0	0	0	0	0
17844	595096	3	0	1	0	0	1
17844	183860	2	0	1	0	0	1
17844	185536	2	0	0	0	0	0
17844	192607	2	0	1	0	1	2
17844	207953	2	1	1	0	0	2
17844	209477	2	0	1	0	0	1
17844	214015	2	0	0	0	0	0
17844	217413	2	0	0	0	0	0
17844	287828	2	0	0	0	0	0
17844	287829	2	0	0	0	0	0
17844	287837	2	0	0	0	0	0
17844	595005	2	1	0	0	0	1
17844	595016	2	0	1	0	0	1
17844	595020	2	0	3	0	0	3
17844	595032	2	0	0	0	0	0
17844	595037	2	0	0	0	0	0
17844	595038	2	0	0	0	0	0
17844	595043	2	0	0	0	0	0
17844	595045	2	0	1	0	0	1
17844	595049	2	0	0	0	0	0
17844	595054	2	0	1	0	0	1
17844	595055	2	0	3	0	1	4
17844	595056	2	1	2	0	0	3
17844	595059	2	0	0	0	0	0
17844	595060	2	2	1	0	0	3
17844	595064	2	0	1	0	1	2
17844	595069	2	1	0	0	2	3
17844	595077	2	0	3	1	0	4
17844	595083	2	0	0	0	0	0
17844	595085	2	0	0	0	0	0
17844	595088	2	0	0	0	0	0
17844	595094	2	1	0	0	2	3
17844	183025	1	0	0	0	1	1
17844	191411	1	1	0	0	1	2
17844	195651	1	0	0	0	0	0
17844	203234	1	0	0	0	1	1
17844	287824	1	0	0	0	1	1
17844	595009	1	0	0	2	0	2
17844	595029	1	0	1	0	0	1
17844	595034	1	0	0	0	0	0
17844	595044	1	0	1	0	0	1
17844	595075	1	0	0	0	0	0
17844	595093	1	0	0	0	1	1
17844	595098	1	0	1	0	0	1
1028	468310	11	2	0	0	0	2
1028	468178	10	1	0	0	1	2
1028	468205	9	5	2	0	0	7
1028	468307	9	1	0	1	0	2
1028	468252	8	5	0	0	0	5
1028	468179	7	0	0	0	0	0
1028	468223	7	2	0	0	0	2
1028	468237	7	2	0	0	0	2
1028	468246	7	5	1	0	0	6
1028	468312	7	1	0	0	0	1
1028	207732	6	0	1	0	0	1
1028	468202	6	3	0	0	0	3
1028	468218	6	1	0	0	1	2
1028	468314	6	1	0	0	0	1
1028	208245	5	0	0	0	0	0
1028	468176	5	0	0	0	0	0
1028	468181	5	3	0	0	0	3
1028	468191	5	4	0	0	0	4
1028	468210	5	2	1	0	0	3
1028	468217	5	2	0	0	3	5
1028	468254	5	0	0	0	1	1
1028	468298	5	0	1	0	3	4
1028	468302	5	0	0	1	2	3
1028	468303	5	2	0	0	2	4
1028	468306	5	0	0	0	0	0
1028	468313	5	0	1	0	0	1
1028	468317	5	0	0	0	4	4
1028	468183	4	0	1	0	0	1
1028	468194	4	0	0	0	0	0
1028	468197	4	0	0	1	0	1
1028	468204	4	2	0	1	0	3
1028	468219	4	0	2	0	0	2
1028	468228	4	2	0	0	0	2
1028	468242	4	0	0	0	2	2
1028	468248	4	2	1	0	0	3
1028	468267	4	1	0	0	0	1
1028	468275	4	1	0	0	1	2
1028	468292	4	1	0	0	0	1
1028	468315	4	1	2	0	1	4
1028	468318	4	0	0	0	2	2
1028	468321	4	0	0	0	3	3
1028	468323	4	1	1	0	0	2
1028	468325	4	0	0	0	2	2
1028	468177	3	0	1	0	0	1
1028	468180	3	2	3	1	0	6
1028	468190	3	1	0	0	0	1
1028	468192	3	0	0	1	0	1
1028	468193	3	1	1	0	0	2
1028	468195	3	2	0	1	0	3
1028	468196	3	1	0	0	0	1
1028	468198	3	1	0	1	1	3
1028	468200	3	0	0	0	0	0
1028	468211	3	2	0	0	0	2
1028	468213	3	0	0	0	0	0
1028	468220	3	0	0	0	0	0
1028	468221	3	1	0	0	0	1
1028	468222	3	0	0	0	0	0
1028	468226	3	0	1	0	0	1
1028	468229	3	0	0	0	1	1
1028	468231	3	2	1	0	0	3
1028	468235	3	0	0	0	0	0
1028	468236	3	1	0	0	0	1
1028	468238	3	0	0	0	0	0
1028	468240	3	0	0	0	0	0
1028	468245	3	0	1	0	0	1
1028	468249	3	0	0	0	1	1
1028	468283	3	2	0	0	0	2
1028	468284	3	0	0	0	0	0
1028	468286	3	0	0	0	0	0
1028	468287	3	0	0	0	1	1
1028	468288	3	0	0	0	0	0
1028	468295	3	0	0	0	0	0
1028	468299	3	1	0	0	1	2
1028	468305	3	1	0	1	0	2
1028	468322	3	1	1	0	0	2
1028	468184	2	3	0	0	0	3
1028	468187	2	0	0	0	0	0
1028	468188	2	1	0	0	0	1
1028	468189	2	1	0	0	1	2
1028	468199	2	3	0	0	0	3
1028	468201	2	0	1	0	0	1
1028	468207	2	1	0	1	0	2
1028	468212	2	0	0	0	0	0
1028	468214	2	0	0	0	0	0
1028	468225	2	1	0	1	0	2
1028	468227	2	1	0	0	0	1
1028	468232	2	1	0	0	0	1
1028	468234	2	0	0	0	1	1
1028	468250	2	1	1	0	1	3
1028	468251	2	2	0	0	0	2
1028	468253	2	3	0	0	1	4
1028	468255	2	3	0	0	0	3
1028	468259	2	0	0	1	0	1
1028	468262	2	0	1	1	0	2
1028	468265	2	0	0	0	0	0
1028	468266	2	2	0	0	0	2
1028	468268	2	2	0	0	1	3
1028	468273	2	0	0	0	0	0
1028	468274	2	0	0	0	0	0
1028	468277	2	0	0	0	2	2
1028	468280	2	1	2	1	0	4
1028	468282	2	0	0	0	0	0
1028	468290	2	3	0	0	0	3
1028	468294	2	3	0	0	0	3
1028	468300	2	0	1	0	0	1
1028	468304	2	1	0	0	0	1
1028	468324	2	1	0	0	1	2
1028	468326	2	0	0	0	2	2
1028	200059	1	1	0	1	0	2
1028	468175	1	0	0	0	0	0
1028	468182	1	2	2	1	0	5
1028	468185	1	5	0	0	0	5
1028	468186	1	1	0	0	0	1
1028	468203	1	1	1	1	0	3
1028	468206	1	0	0	0	0	0
1028	468208	1	1	0	1	0	2
1028	468209	1	0	0	0	0	0
1028	468215	1	1	0	0	0	1
1028	468216	1	1	0	0	0	1
1028	468224	1	1	1	0	0	2
1028	468230	1	3	0	0	0	3
1028	468233	1	0	0	0	0	0
1028	468239	1	1	0	0	0	1
1028	468241	1	3	0	0	0	3
1028	468243	1	2	1	0	0	3
1028	468244	1	1	1	1	0	3
1028	468247	1	1	0	1	1	3
1028	468256	1	0	0	0	0	0
1028	468257	1	0	0	0	2	2
1028	468258	1	0	0	0	0	0
1028	468260	1	2	1	0	1	4
1028	468261	1	2	0	0	0	2
1028	468263	1	1	0	0	0	1
1028	468264	1	3	0	0	1	4
1028	468269	1	0	0	0	1	1
1028	468270	1	0	0	0	1	1
1028	468271	1	2	0	0	0	2
1028	468272	1	1	0	0	0	1
1028	468276	1	0	1	0	1	2
1028	468278	1	1	0	0	0	1
1028	468279	1	1	1	1	0	3
1028	468281	1	1	0	0	0	1
1028	468285	1	1	1	0	0	2
1028	468289	1	1	0	0	0	1
1028	468291	1	1	0	0	1	2
1028	468293	1	1	0	0	0	1
1028	468296	1	0	0	0	2	2
1028	468297	1	1	0	0	0	1
1028	468301	1	1	0	0	0	1
1028	468308	1	4	0	0	0	4
1028	468309	1	0	1	0	0	1
1028	468316	1	0	0	0	2	2
1028	468319	1	1	0	0	1	2
1028	468320	1	0	0	0	1	1
36278	543119	39	0	1	2	0	3
36278	74419	33	1	5	2	1	9
36278	57527	31	3	4	0	2	9
36278	279167	29	3	4	0	1	8
36278	51274	29	0	5	2	0	7
36278	443077	26	3	7	0	4	14
36278	279186	24	1	6	0	3	10
36278	76735	23	3	1	2	3	9
36278	543160	22	1	6	1	3	11
36278	543134	21	2	5	0	3	10
36278	85957	21	1	2	1	0	4
36278	543146	20	1	4	0	0	5
36278	279183	19	2	5	0	3	10
36278	543156	18	2	5	0	3	10
36278	97738	18	2	5	0	3	10
36278	190195	16	1	4	0	2	7
36278	279169	15	2	6	0	1	9
36278	543120	14	4	3	0	1	8
36278	543133	14	3	7	1	4	15
36278	543151	14	3	7	1	4	15
36278	58188	14	1	1	0	0	2
36278	91792	14	3	7	1	4	15
36278	217524	13	1	3	2	1	7
36278	65625	12	0	3	2	1	6
36278	543131	11	0	3	2	1	6
36278	543159	11	3	4	0	0	7
36278	70002	11	0	3	2	1	6
36278	543138	10	0	1	0	0	1
36278	543152	10	0	2	0	0	2
36278	543154	10	2	3	0	1	6
36278	72520	10	2	6	0	1	9
36278	85590	10	0	1	0	0	1
36278	94601	10	1	3	0	0	4
36278	184928	9	4	4	0	0	8
36278	190030	9	1	4	0	2	7
36278	216630	9	2	6	2	3	13
36278	279172	9	1	1	3	1	6
36278	279175	9	1	2	2	3	8
36278	279178	9	4	4	0	0	8
36278	443076	9	1	1	0	0	2
36278	543117	9	1	1	1	0	3
36278	543145	9	4	4	0	0	8
36278	65880	9	2	6	2	3	13
36278	543130	8	1	3	0	0	4
36278	543153	8	2	7	2	3	14
36278	188648	7	0	3	2	1	6
36278	217100	7	3	0	0	1	4
36278	279170	7	3	4	0	1	8
36278	59842	7	0	3	2	1	6
36278	78775	7	0	0	0	1	1
36278	213540	6	1	1	0	1	3
36278	279173	6	1	3	0	0	4
36278	279185	6	4	2	0	0	6
36278	543112	6	2	0	0	0	2
36278	543118	6	0	2	0	0	2
36278	543125	6	4	2	0	0	6
36278	543132	6	1	3	0	0	4
36278	543150	6	2	4	0	1	7
36278	63625	6	1	2	0	0	3
36278	74263	6	3	1	1	1	6
36278	76264	6	1	1	0	0	2
36278	80602	6	0	1	0	2	3
36278	84812	6	1	3	0	0	4
36278	89084	6	2	4	0	1	7
36278	185924	5	0	3	0	0	3
36278	187215	5	0	0	0	0	0
36278	194702	5	0	0	0	0	0
36278	196382	5	0	2	0	1	3
36278	198814	5	0	1	0	0	1
36278	201245	5	0	0	0	1	1
36278	207369	5	0	1	0	0	1
36278	207496	5	1	0	0	0	1
36278	210009	5	0	3	0	0	3
36278	210922	5	1	4	0	0	5
36278	212848	5	1	3	0	1	5
36278	219876	5	1	0	0	1	2
36278	279174	5	1	3	0	1	5
36278	279176	5	1	2	0	0	3
36278	279180	5	3	1	0	0	4
36278	279184	5	0	3	0	0	3
36278	543113	5	0	2	0	0	2
36278	543129	5	1	2	0	0	3
36278	543140	5	0	0	0	0	0
36278	543144	5	1	2	0	0	3
36278	79519	5	0	0	0	1	1
36278	92987	5	0	3	0	0	3
36278	108427	4	2	0	0	0	2
36278	182281	4	0	1	0	0	1
36278	186492	4	1	2	0	0	3
36278	193662	4	0	2	0	1	3
36278	199945	4	2	2	0	0	4
36278	200227	4	0	1	0	0	1
36278	201185	4	0	2	0	0	2
36278	203571	4	1	1	0	0	2
36278	204236	4	1	2	0	0	3
36278	205373	4	1	0	0	0	1
36278	207047	4	0	1	0	1	2
36278	221512	4	2	0	0	0	2
36278	279171	4	0	2	0	0	2
36278	279179	4	1	1	0	0	2
36278	279187	4	1	1	0	0	2
36278	443074	4	3	0	0	0	3
36278	443075	4	1	0	0	0	1
36278	543114	4	1	1	0	0	2
36278	543123	4	0	0	0	0	0
36278	543135	4	1	1	0	0	2
36278	543139	4	1	1	0	1	3
36278	543141	4	1	1	0	0	2
36278	543147	4	1	1	0	1	3
36278	543155	4	1	2	0	0	3
36278	189835	3	0	1	0	0	1
36278	193437	3	0	1	0	0	1
36278	195849	3	1	3	0	0	4
36278	209785	3	1	0	0	0	1
36278	211198	3	0	1	0	0	1
36278	279168	3	0	1	0	0	1
36278	279182	3	0	1	0	2	3
36278	543115	3	0	0	0	0	0
36278	543121	3	0	1	0	0	1
36278	543122	3	0	3	0	0	3
36278	543126	3	1	1	0	0	2
36278	543127	3	0	1	0	0	1
36278	543128	3	1	1	0	0	2
36278	543136	3	3	2	0	0	5
36278	543142	3	1	2	0	1	4
36278	543143	3	0	3	0	0	3
36278	543148	3	1	2	0	0	3
36278	543157	3	0	0	0	0	0
36278	543158	3	2	1	0	1	4
36278	92378	3	0	3	0	0	3
36278	98852	3	1	0	1	0	2
36278	182235	2	0	1	0	1	2
36278	196637	2	0	1	0	0	1
36278	198455	2	0	0	0	0	0
36278	279181	2	2	0	0	0	2
36278	279188	2	0	0	0	0	0
36278	443073	2	0	2	0	0	2
36278	543116	2	0	2	0	0	2
36278	543124	2	0	1	0	0	1
36278	543137	2	1	1	0	0	2
36278	543149	2	2	0	0	0	2
36278	105303	1	0	0	0	2	2
36278	185314	1	0	0	0	0	0
36278	186657	1	1	0	0	0	1
36278	189516	1	2	2	0	0	4
36278	198034	1	0	1	0	0	1
36278	208559	1	0	0	0	0	0
36278	214249	1	1	0	0	0	1
36278	279177	1	0	0	0	1	1
36278	443072	1	0	1	0	0	1
36278	543111	1	0	1	0	1	2
36278	54477	1	0	2	0	0	2
53601	536651	16	3	1	1	2	7
53601	536657	12	2	3	0	0	5
53601	536228	11	3	0	0	1	4
53601	390271	9	1	0	0	1	2
53601	536642	8	2	0	0	1	3
53601	536670	8	1	0	0	1	2
53601	536659	7	1	0	0	0	1
53601	390262	6	2	0	0	2	4
53601	520973	6	3	0	0	0	3
53601	536628	6	2	0	0	0	2
53601	536652	6	2	1	0	0	3
53601	281089	5	1	0	0	1	2
53601	520979	5	1	1	0	1	3
53601	536230	5	0	0	0	1	1
53601	536607	5	0	0	0	1	1
53601	536613	5	0	0	0	0	0
53601	536631	5	0	0	0	1	1
53601	536632	5	1	0	0	0	1
53601	536637	5	0	2	0	3	5
53601	536649	5	2	0	0	0	2
53601	536650	5	1	0	0	0	1
53601	536664	5	0	1	0	0	1
53601	536682	5	1	0	0	1	2
53601	536683	5	0	0	0	0	0
53601	536698	5	1	0	0	0	1
53601	536699	5	1	2	0	1	4
53601	536701	5	0	0	0	2	2
53601	536704	5	1	0	0	0	1
53601	536707	5	3	0	1	0	4
53601	390266	4	3	0	0	1	4
53601	390268	4	1	0	0	1	2
53601	520976	4	1	0	0	2	3
53601	520978	4	1	0	1	1	3
53601	536227	4	3	0	0	0	3
53601	536234	4	0	0	0	1	1
53601	536239	4	3	0	0	0	3
53601	536634	4	0	0	0	0	0
53601	536646	4	0	0	0	0	0
53601	536647	4	1	0	0	0	1
53601	536654	4	0	0	0	0	0
53601	536663	4	1	1	0	0	2
53601	536673	4	0	0	0	0	0
53601	536676	4	1	0	0	1	2
53601	536685	4	1	1	0	0	2
53601	536694	4	1	0	0	0	1
53601	536708	4	1	1	0	0	2
53601	536713	4	0	1	0	2	3
53601	387563	3	1	0	0	2	3
53601	390267	3	2	0	0	1	3
53601	390269	3	4	0	0	0	4
53601	390270	3	1	0	0	0	1
53601	428864	3	0	0	0	0	0
53601	467461	3	0	1	0	1	2
53601	520975	3	1	0	0	2	3
53601	536237	3	0	0	0	1	1
53601	536609	3	0	1	0	2	3
53601	536610	3	1	0	0	1	2
53601	536611	3	0	0	0	2	2
53601	536615	3	0	0	1	1	2
53601	536625	3	1	0	0	1	2
53601	536626	3	1	0	0	0	1
53601	536627	3	1	0	0	0	1
53601	536630	3	0	1	0	1	2
53601	536638	3	0	0	0	0	0
53601	536644	3	2	0	1	0	3
53601	536645	3	2	0	0	1	3
53601	536648	3	1	0	0	0	1
53601	536662	3	2	1	0	0	3
53601	536665	3	0	0	0	1	1
53601	536666	3	1	0	0	0	1
53601	536669	3	0	0	0	0	0
53601	536671	3	1	0	0	0	1
53601	536672	3	0	0	0	1	1
53601	536675	3	1	0	0	2	3
53601	536677	3	1	0	0	1	2
53601	536689	3	0	0	0	0	0
53601	536693	3	0	0	0	0	0
53601	536702	3	1	0	0	0	1
53601	536705	3	1	0	1	0	2
53601	536709	3	1	0	0	1	2
53601	536710	3	2	0	0	2	4
53601	536711	3	3	0	0	0	3
53601	390265	2	2	0	0	3	5
53601	467460	2	1	0	0	0	1
53601	520974	2	2	0	0	1	3
53601	520977	2	1	0	0	1	2
53601	536225	2	1	0	0	1	2
53601	536226	2	1	0	0	2	3
53601	536232	2	0	0	0	1	1
53601	536235	2	2	0	0	0	2
53601	536238	2	0	0	0	1	1
53601	536601	2	1	0	0	1	2
53601	536602	2	1	0	0	2	3
53601	536606	2	2	0	0	0	2
53601	536612	2	0	0	0	0	0
53601	536614	2	2	0	0	0	2
53601	536616	2	1	0	0	1	2
53601	536617	2	0	0	0	2	2
53601	536618	2	2	0	0	1	3
53601	536619	2	1	0	0	1	2
53601	536621	2	2	0	0	0	2
53601	536622	2	0	0	0	0	0
53601	536623	2	2	1	0	0	3
53601	536624	2	1	0	0	0	1
53601	536629	2	2	1	2	1	6
53601	536633	2	0	0	0	2	2
53601	536635	2	0	0	0	0	0
53601	536636	2	0	0	0	2	2
53601	536643	2	1	0	0	1	2
53601	536655	2	0	0	0	0	0
53601	536656	2	0	0	0	1	1
53601	536658	2	1	0	0	2	3
53601	536660	2	0	0	0	0	0
53601	536667	2	0	0	0	0	0
53601	536674	2	1	0	0	1	2
53601	536678	2	0	0	0	4	4
53601	536680	2	1	0	0	0	1
53601	536681	2	0	0	0	2	2
53601	536684	2	1	0	0	0	1
53601	536687	2	0	0	0	0	0
53601	536688	2	1	0	0	0	1
53601	536692	2	1	0	0	0	1
53601	536695	2	1	0	0	0	1
53601	536696	2	1	0	0	0	1
53601	536697	2	3	0	0	1	4
53601	536700	2	0	0	1	1	2
53601	536703	2	0	0	0	1	1
53601	536712	2	1	0	0	0	1
53601	390261	1	0	0	0	2	2
53601	390263	1	1	0	0	0	1
53601	390264	1	0	0	0	0	0
53601	520972	1	0	0	0	1	1
53601	520980	1	0	0	0	1	1
53601	536229	1	0	0	0	0	0
53601	536231	1	1	0	0	1	2
53601	536233	1	1	0	0	0	1
53601	536236	1	1	0	0	1	2
53601	536600	1	1	0	0	0	1
53601	536603	1	1	0	0	0	1
53601	536604	1	1	1	0	0	2
53601	536605	1	2	0	0	0	2
53601	536608	1	0	0	0	1	1
53601	536620	1	0	0	0	0	0
53601	536639	1	0	1	0	0	1
53601	536641	1	1	1	0	1	3
53601	536653	1	2	0	0	0	2
53601	536661	1	0	0	0	0	0
53601	536668	1	1	0	0	0	1
53601	536679	1	0	1	0	0	1
53601	536686	1	0	0	0	0	0
53601	536690	1	0	0	0	0	0
53601	536691	1	1	0	0	1	2
53601	536706	1	0	0	0	0	0
62115	198772	46	2	7	2	4	15
62115	299548	46	2	7	2	4	15
62115	74516	46	2	7	2	4	15
62115	57542	43	6	1	0	1	8
62115	187577	24	2	7	2	9	20
62115	200677	23	2	5	3	3	13
62115	217628	23	0	2	0	1	3
62115	299559	23	2	5	3	3	13
62115	81753	23	3	2	0	0	5
62115	77010	22	2	5	3	3	13
62115	85973	21	1	0	0	0	1
62115	86513	21	2	2	1	1	6
62115	202416	19	1	2	0	0	3
62115	299549	18	1	2	0	0	3
62115	423627	18	1	2	0	0	3
62115	82887	18	1	2	0	0	3
62115	107309	17	1	2	0	0	3
62115	423603	17	1	2	0	0	3
62115	423606	15	3	0	1	0	4
62115	423656	14	2	1	1	0	4
62115	423641	13	2	5	1	2	10
62115	423646	13	4	2	0	2	8
62115	423643	11	0	1	0	0	1
62115	209600	10	2	1	0	0	3
62115	299547	10	1	2	1	2	6
62115	299553	10	3	1	0	3	7
62115	423660	10	3	1	0	3	7
62115	423665	10	2	1	0	0	3
62115	423666	10	0	3	2	1	6
62115	57461	10	3	1	0	3	7
62115	62869	10	5	3	3	2	13
62115	423637	9	2	0	0	0	2
62115	82031	9	1	3	2	2	8
62115	208168	8	2	0	1	0	3
62115	423636	8	0	2	0	2	4
62115	423642	8	4	2	1	1	8
62115	205736	7	1	1	0	0	2
62115	299545	7	0	3	0	0	3
62115	423595	7	1	1	0	1	3
62115	423611	7	1	2	1	0	4
62115	423640	7	2	3	1	2	8
62115	423673	7	0	5	0	3	8
62115	423676	7	3	8	0	4	15
62115	423677	7	3	8	0	4	15
62115	51088	7	0	3	0	0	3
62115	65886	7	0	5	0	3	8
62115	203501	6	1	1	0	0	2
62115	423600	6	1	0	0	0	1
62115	423604	6	0	2	2	0	4
62115	423672	6	0	2	1	1	4
62115	423674	6	2	2	0	1	5
62115	423675	6	1	2	0	1	4
62115	299550	5	1	0	1	0	2
62115	299551	5	0	0	0	0	0
62115	299555	5	0	0	0	0	0
62115	423602	5	0	1	1	0	2
62115	423608	5	1	3	0	1	5
62115	423619	5	1	2	0	0	3
62115	423620	5	0	1	1	0	2
62115	423625	5	1	4	0	0	5
62115	423651	5	4	0	0	0	4
62115	423652	5	0	1	0	1	2
62115	423654	5	0	1	0	1	2
62115	423661	5	0	1	0	0	1
62115	423668	5	1	3	0	0	4
62115	53770	5	0	0	0	0	0
62115	64633	5	0	0	0	0	0
62115	89569	5	1	1	1	0	3
62115	101508	4	0	1	1	1	3
62115	185722	4	0	0	0	0	0
62115	196750	4	1	0	0	0	1
62115	204215	4	0	1	0	1	2
62115	207246	4	2	1	0	0	3
62115	213542	4	3	1	0	0	4
62115	299552	4	0	0	1	1	2
62115	299562	4	2	3	0	0	5
62115	423597	4	1	0	0	0	1
62115	423612	4	0	1	0	1	2
62115	423629	4	2	1	0	1	4
62115	423634	4	2	0	0	0	2
62115	423635	4	2	0	0	0	2
62115	423645	4	2	3	0	0	5
62115	423648	4	2	0	0	0	2
62115	423653	4	0	2	0	0	2
62115	423657	4	0	1	0	0	1
62115	423658	4	0	1	0	0	1
62115	423662	4	0	0	0	0	0
62115	423671	4	1	1	0	0	2
62115	74220	4	2	3	0	0	5
62115	100924	3	0	0	0	0	0
62115	184710	3	0	0	0	0	0
62115	299546	3	0	1	0	0	1
62115	299554	3	0	0	0	0	0
62115	299556	3	1	0	0	2	3
62115	299557	3	1	0	0	0	1
62115	299558	3	1	1	0	0	2
62115	423596	3	0	1	0	1	2
62115	423598	3	1	1	0	0	2
62115	423601	3	0	5	0	0	5
62115	423605	3	0	1	0	0	1
62115	423607	3	0	3	0	0	3
62115	423613	3	0	2	0	1	3
62115	423621	3	0	2	0	1	3
62115	423628	3	0	2	0	0	2
62115	423638	3	1	3	0	1	5
62115	423639	3	1	1	0	1	3
62115	423644	3	1	1	0	1	3
62115	423647	3	1	1	0	0	2
62115	423649	3	0	1	0	0	1
62115	423650	3	0	4	0	0	4
62115	423659	3	1	0	0	0	1
62115	423663	3	0	0	0	0	0
62115	423670	3	0	0	0	1	1
62115	54313	3	0	0	0	0	0
62115	72699	3	0	2	0	0	2
62115	74041	3	0	1	0	0	1
62115	81792	3	0	0	0	0	0
62115	91108	3	1	0	0	2	3
62115	101870	2	0	2	0	0	2
62115	220167	2	0	0	0	0	0
62115	299561	2	0	2	0	0	2
62115	423599	2	0	0	0	0	0
62115	423609	2	0	1	0	0	1
62115	423616	2	0	0	0	0	0
62115	423617	2	0	0	0	1	1
62115	423622	2	0	1	0	0	1
62115	423623	2	0	2	0	0	2
62115	423624	2	0	0	0	0	0
62115	423626	2	1	1	1	3	6
62115	423630	2	0	2	0	0	2
62115	423632	2	2	0	0	1	3
62115	423655	2	1	3	0	0	4
62115	423664	2	1	2	1	0	4
62115	423669	2	1	2	0	0	3
62115	423678	2	2	2	1	1	6
62115	54992	2	0	0	0	0	0
62115	56873	2	0	1	0	0	1
62115	84792	2	2	2	1	1	6
62115	88579	2	0	1	0	0	1
62115	97205	2	0	1	0	0	1
62115	195814	1	0	2	0	0	2
62115	209549	1	1	0	0	0	1
62115	299560	1	1	0	0	0	1
62115	423610	1	1	0	0	0	1
62115	423614	1	0	1	0	0	1
62115	423615	1	0	1	0	4	5
62115	423618	1	0	2	0	0	2
62115	423631	1	1	1	0	1	3
62115	423633	1	0	3	0	0	3
62115	423667	1	0	0	0	0	0
79789	214967	19	0	3	0	0	3
79789	622761	15	2	2	0	1	5
79789	622840	13	0	2	1	3	6
79789	622798	12	1	2	1	2	6
79789	622807	12	0	0	0	0	0
79789	622887	12	3	2	0	4	9
79789	622827	10	1	1	0	3	5
79789	622863	10	0	3	0	0	3
79789	205252	9	0	2	1	0	3
79789	216401	9	2	1	0	2	5
79789	622821	9	2	0	1	2	5
79789	622842	9	0	0	0	1	1
79789	622891	9	0	1	1	0	2
79789	190481	8	1	2	1	1	5
79789	622781	8	3	1	1	3	8
79789	622787	8	0	1	0	0	1
79789	622796	8	1	2	0	3	6
79789	622805	8	0	1	0	1	2
79789	622837	8	0	0	0	0	0
79789	622892	8	0	0	0	1	1
79789	622894	8	0	1	0	0	1
79789	192776	7	2	1	0	2	5
79789	622770	7	0	1	0	1	2
79789	622775	7	2	2	0	2	6
79789	622790	7	1	2	0	1	4
79789	622806	7	2	1	0	1	4
79789	622808	7	2	0	0	0	2
79789	622817	7	2	3	1	4	10
79789	622835	7	0	1	0	3	4
79789	622879	7	1	1	0	2	4
79789	622881	7	1	3	1	5	10
79789	622767	6	1	0	0	0	1
79789	622769	6	2	0	0	0	2
79789	622785	6	2	2	0	6	10
79789	622789	6	0	4	0	4	8
79789	622801	6	1	0	1	0	2
79789	622804	6	0	0	0	0	0
79789	622816	6	4	0	1	0	5
79789	622818	6	0	1	0	2	3
79789	622829	6	1	0	0	1	2
79789	622853	6	0	1	0	0	1
79789	622854	6	1	1	0	1	3
79789	622877	6	1	2	0	1	4
79789	193118	5	0	1	0	3	4
79789	203148	5	0	3	0	1	4
79789	206191	5	0	2	0	0	2
79789	215984	5	1	0	0	1	2
79789	622774	5	0	0	0	0	0
79789	622780	5	1	0	0	1	2
79789	622782	5	1	0	0	0	1
79789	622839	5	1	0	0	0	1
79789	622841	5	1	2	0	0	3
79789	622850	5	0	2	0	1	3
79789	622862	5	0	1	0	0	1
79789	622868	5	0	1	0	0	1
79789	622869	5	3	3	0	1	7
79789	622871	5	0	1	0	1	2
79789	622872	5	0	2	0	1	3
79789	622873	5	2	0	0	0	2
79789	622890	5	2	0	0	3	5
79789	185686	4	0	1	1	2	4
79789	199877	4	1	0	0	3	4
79789	622765	4	1	1	0	1	3
79789	622773	4	1	0	0	1	2
79789	622777	4	1	1	0	2	4
79789	622784	4	1	1	2	1	5
79789	622786	4	0	2	0	1	3
79789	622788	4	1	1	0	1	3
79789	622812	4	1	3	0	1	5
79789	622815	4	0	2	0	1	3
79789	622825	4	0	2	0	1	3
79789	622828	4	2	2	1	0	5
79789	622830	4	0	2	0	3	5
79789	622831	4	1	1	1	2	5
79789	622834	4	1	4	0	1	6
79789	622838	4	0	1	0	1	2
79789	622843	4	1	1	0	2	4
79789	622844	4	0	2	0	0	2
79789	622848	4	0	2	0	1	3
79789	622849	4	1	0	0	0	1
79789	622859	4	1	0	1	1	3
79789	622860	4	0	4	0	2	6
79789	622866	4	0	3	0	1	4
79789	622870	4	1	1	0	3	5
79789	622875	4	3	0	0	0	3
79789	622876	4	0	0	0	1	1
79789	622878	4	1	1	0	2	4
79789	622880	4	1	0	0	4	5
79789	622885	4	2	0	0	0	2
79789	622886	4	1	1	0	1	3
79789	622888	4	0	1	0	0	1
79789	195665	3	0	1	0	2	3
79789	195788	3	0	2	0	3	5
79789	207170	3	1	0	0	1	2
79789	208296	3	0	1	0	3	4
79789	622768	3	0	0	0	0	0
79789	622783	3	1	0	0	0	1
79789	622791	3	1	2	0	0	3
79789	622792	3	1	0	0	1	2
79789	622799	3	1	0	0	0	1
79789	622803	3	0	0	2	0	2
79789	622809	3	1	1	0	3	5
79789	622810	3	0	0	0	0	0
79789	622811	3	0	0	0	0	0
79789	622822	3	0	0	0	1	1
79789	622824	3	0	1	0	2	3
79789	622832	3	1	2	0	2	5
79789	622847	3	2	1	0	0	3
79789	622851	3	0	1	0	2	3
79789	622856	3	0	0	0	1	1
79789	622861	3	2	0	0	0	2
79789	622864	3	1	1	0	0	2
79789	622865	3	0	1	0	1	2
79789	622867	3	2	2	0	2	6
79789	622874	3	1	0	0	1	2
79789	622882	3	1	1	0	2	4
79789	191224	2	1	1	0	1	3
79789	196523	2	0	0	0	1	1
79789	198382	2	1	1	0	0	2
79789	622766	2	1	1	0	1	3
79789	622771	2	0	2	0	1	3
79789	622772	2	0	0	0	0	0
79789	622776	2	2	0	0	1	3
79789	622779	2	0	1	0	0	1
79789	622795	2	0	0	0	0	0
79789	622797	2	0	0	0	0	0
79789	622802	2	0	2	0	2	4
79789	622813	2	0	0	0	0	0
79789	622814	2	1	3	0	2	6
79789	622819	2	2	1	0	2	5
79789	622820	2	1	2	0	0	3
79789	622826	2	1	1	0	0	2
79789	622836	2	1	0	0	2	3
79789	622846	2	0	2	0	1	3
79789	622852	2	0	1	0	0	1
79789	622855	2	3	0	0	2	5
79789	622857	2	1	2	0	0	3
79789	622858	2	2	2	1	1	6
79789	622883	2	1	0	0	2	3
79789	622884	2	0	1	0	1	2
79789	622889	2	0	0	0	1	1
79789	622893	2	1	2	0	2	5
79789	622762	1	0	1	0	1	2
79789	622763	1	1	0	0	0	1
79789	622764	1	0	1	0	0	1
79789	622778	1	0	0	0	0	0
79789	622793	1	1	0	0	2	3
79789	622794	1	0	0	0	1	1
79789	622800	1	0	0	0	2	2
79789	622823	1	0	0	0	0	0
79789	622833	1	0	0	0	0	0
79789	622845	1	0	3	0	0	3
16014	276719	14	3	2	0	1	6
16014	610347	11	0	1	0	0	1
16014	182625	10	2	2	1	0	5
16014	480786	10	1	3	2	0	6
16014	608679	10	3	5	1	1	10
16014	608707	10	0	1	1	0	2
16014	610344	10	2	1	0	0	3
16014	608686	9	3	1	0	0	4
16014	608702	9	4	5	0	0	9
16014	480782	8	2	3	0	1	6
16014	608684	8	0	1	0	0	1
16014	608713	8	2	3	0	2	7
16014	608733	8	2	2	0	4	8
16014	287389	7	3	2	0	0	5
16014	608666	7	3	2	0	2	7
16014	608676	7	0	3	0	0	3
16014	608691	7	3	0	0	2	5
16014	608715	7	1	1	0	0	2
16014	608728	7	2	1	0	0	3
16014	222060	6	5	1	0	2	8
16014	287378	6	0	1	2	0	3
16014	287380	6	0	0	0	1	1
16014	287387	6	1	2	0	0	3
16014	287388	6	1	1	0	2	4
16014	287390	6	0	2	0	3	5
16014	480776	6	0	1	0	1	2
16014	480790	6	0	0	0	2	2
16014	608667	6	1	1	0	2	4
16014	608672	6	1	0	0	0	1
16014	608725	6	0	1	0	0	1
16014	610331	6	3	6	1	1	11
16014	610346	6	2	2	0	0	4
16014	188419	5	2	1	0	0	3
16014	192915	5	1	1	0	0	2
16014	212455	5	2	0	0	1	3
16014	287379	5	2	1	0	0	3
16014	287385	5	1	1	0	0	2
16014	480765	5	1	0	0	0	1
16014	480769	5	0	1	0	1	2
16014	480775	5	0	0	0	0	0
16014	480778	5	1	2	0	0	3
16014	480781	5	5	1	0	2	8
16014	480783	5	1	0	1	1	3
16014	480787	5	3	1	0	0	4
16014	608678	5	0	2	0	0	2
16014	608680	5	0	0	0	0	0
16014	608682	5	1	0	0	0	1
16014	608683	5	1	3	0	3	7
16014	608689	5	1	0	0	0	1
16014	608694	5	1	2	0	0	3
16014	608696	5	1	0	0	1	2
16014	608704	5	0	0	0	1	1
16014	608705	5	1	1	0	0	2
16014	608711	5	0	1	0	2	3
16014	608722	5	0	0	0	0	0
16014	608723	5	2	1	0	0	3
16014	608726	5	2	2	1	0	5
16014	608727	5	0	1	0	0	1
16014	608732	5	5	1	0	1	7
16014	610339	5	2	1	1	0	4
16014	610340	5	1	1	0	0	2
16014	610348	5	0	3	0	0	3
16014	610349	5	2	0	0	1	3
16014	184019	4	5	2	0	0	7
16014	198497	4	0	0	0	0	0
16014	202942	4	2	0	0	0	2
16014	210168	4	1	1	0	0	2
16014	212005	4	1	1	0	0	2
16014	276720	4	0	0	2	1	3
16014	287381	4	0	3	0	3	6
16014	287384	4	0	0	0	1	1
16014	287391	4	0	2	0	0	2
16014	480779	4	0	1	0	1	2
16014	480785	4	1	0	0	0	1
16014	608670	4	3	0	0	1	4
16014	608673	4	0	0	0	1	1
16014	608681	4	1	1	0	0	2
16014	608685	4	1	1	0	0	2
16014	608692	4	1	0	0	0	1
16014	608697	4	0	2	0	0	2
16014	608701	4	0	0	0	0	0
16014	608703	4	1	0	1	1	3
16014	608709	4	0	0	0	0	0
16014	608718	4	1	2	0	0	3
16014	608719	4	0	0	0	0	0
16014	608724	4	0	2	0	0	2
16014	610334	4	1	2	0	2	5
16014	610336	4	1	1	0	0	2
16014	610342	4	1	0	0	0	1
16014	610343	4	1	1	0	0	2
16014	183705	3	1	1	0	0	2
16014	184318	3	3	0	0	1	4
16014	201907	3	1	4	0	0	5
16014	287382	3	0	1	0	0	1
16014	287383	3	0	0	0	0	0
16014	287386	3	0	0	0	0	0
16014	480771	3	0	2	0	0	2
16014	480773	3	0	0	0	0	0
16014	480777	3	1	0	0	2	3
16014	480784	3	0	0	0	0	0
16014	480789	3	1	1	0	0	2
16014	608668	3	1	1	0	0	2
16014	608669	3	0	1	0	0	1
16014	608688	3	0	0	0	0	0
16014	608698	3	1	3	0	1	5
16014	608700	3	1	0	0	0	1
16014	608710	3	1	2	0	1	4
16014	608716	3	0	2	0	0	2
16014	608717	3	0	2	0	1	3
16014	608720	3	0	0	0	1	1
16014	608721	3	0	2	0	1	3
16014	608731	3	1	1	0	0	2
16014	610332	3	1	2	0	2	5
16014	610333	3	0	1	0	0	1
16014	610338	3	0	0	1	0	1
16014	610341	3	0	2	0	0	2
16014	610345	3	0	0	0	2	2
16014	190647	2	1	1	0	2	4
16014	195929	2	0	2	0	0	2
16014	201277	2	0	0	0	0	0
16014	201953	2	2	0	0	0	2
16014	206972	2	0	1	0	0	1
16014	207427	2	1	0	0	0	1
16014	216903	2	0	1	0	0	1
16014	221067	2	0	0	0	0	0
16014	480766	2	0	0	0	2	2
16014	480770	2	0	1	0	0	1
16014	480774	2	1	0	0	1	2
16014	480780	2	0	2	0	0	2
16014	480788	2	1	1	0	1	3
16014	608675	2	1	1	0	0	2
16014	608677	2	0	2	0	2	4
16014	608699	2	0	0	0	0	0
16014	608706	2	0	0	0	1	1
16014	608708	2	0	0	0	1	1
16014	608712	2	1	1	0	0	2
16014	608714	2	0	0	0	0	0
16014	608729	2	1	0	0	2	3
16014	608730	2	1	2	0	0	3
16014	610350	2	0	2	0	2	4
16014	480767	1	1	0	0	0	1
16014	480768	1	2	0	0	1	3
16014	480772	1	1	0	0	0	1
16014	608671	1	0	2	1	4	7
16014	608674	1	0	3	0	0	3
16014	608690	1	0	0	0	0	0
16014	608693	1	0	0	0	0	0
16014	608695	1	0	0	0	0	0
16014	610335	1	0	2	0	0	2
16014	610337	1	0	0	0	0	0
14892	287049	229	22	34	9	9	74
14892	287056	110	6	16	3	3	28
14892	56779	110	6	16	3	3	28
14892	51244	60	4	5	1	3	13
14892	287048	58	4	7	2	2	15
14892	81881	58	4	7	2	2	15
14892	91793	57	3	6	3	2	14
14892	287040	56	4	5	1	3	13
14892	503077	56	4	5	1	3	13
14892	503051	41	2	6	0	2	10
14892	503056	39	2	6	2	2	12
14892	92271	37	8	9	0	3	20
14892	287041	33	4	1	0	1	6
14892	287053	33	3	8	1	1	13
14892	57528	33	3	1	0	1	5
14892	80771	33	3	8	1	1	13
14892	503063	31	3	8	1	1	13
14892	53181	30	1	7	3	0	11
14892	58193	30	6	3	0	2	11
14892	64967	28	2	2	1	0	5
14892	67327	28	3	2	0	4	9
14892	78776	28	6	5	2	2	15
14892	503075	27	3	2	0	0	5
14892	73703	27	2	2	1	0	5
14892	85244	27	3	2	0	0	5
14892	107442	26	1	3	0	0	4
14892	503055	26	1	3	0	0	4
14892	103481	25	2	3	5	2	12
14892	503066	25	1	3	2	4	10
14892	503074	25	8	8	0	2	18
14892	70004	25	5	4	4	3	16
14892	81245	25	2	9	1	2	14
14892	287058	24	1	4	0	0	5
14892	503071	24	2	0	0	0	2
14892	100610	23	3	5	1	0	9
14892	287050	23	2	2	0	4	8
14892	83643	23	2	0	0	3	5
14892	88642	23	1	4	0	0	5
14892	91462	23	2	2	0	4	8
14892	287054	21	3	5	4	0	12
14892	50090	21	3	5	4	0	12
14892	503053	21	2	2	0	4	8
14892	503057	21	3	5	1	0	9
14892	503064	21	3	5	4	0	12
14892	80312	21	1	2	1	0	4
14892	96145	21	1	2	2	0	5
14892	287052	20	3	4	2	1	10
14892	61051	20	0	4	1	2	7
14892	70454	20	3	1	0	1	5
14892	95490	20	3	4	2	1	10
14892	287042	19	2	2	0	0	4
14892	287057	19	0	3	1	2	6
14892	503059	19	3	4	2	1	10
14892	503065	19	0	4	1	2	7
14892	503070	19	0	0	0	1	1
14892	503073	19	0	3	1	2	6
14892	52248	19	0	3	1	2	6
14892	85895	19	2	2	0	0	4
14892	287060	18	2	3	0	3	8
14892	503050	18	4	3	3	1	11
14892	503060	18	2	6	2	1	11
14892	503062	18	1	5	1	3	10
14892	74247	18	4	7	2	0	13
14892	85315	18	2	3	0	3	8
14892	85430	18	4	3	3	1	11
14892	94641	18	2	3	1	0	6
14892	207883	17	1	2	0	4	7
14892	503054	17	1	1	4	0	6
14892	503067	17	4	7	2	1	14
14892	503068	17	2	4	0	2	8
14892	503082	17	2	3	0	3	8
14892	74625	17	1	2	0	0	3
14892	83455	17	2	4	0	2	8
14892	287045	16	1	0	0	0	1
14892	56944	16	1	0	0	0	1
14892	106034	15	0	0	0	0	0
14892	503069	15	3	4	0	3	10
14892	99888	15	3	4	0	0	7
14892	287047	14	2	4	1	4	11
14892	287051	14	1	2	0	0	3
14892	503052	14	2	4	1	4	11
14892	82967	14	2	4	1	4	11
14892	192666	13	4	4	0	4	12
14892	219354	13	0	0	0	0	0
14892	287055	13	2	7	0	2	11
14892	503081	13	2	2	0	0	4
14892	58722	13	0	1	0	0	1
14892	64846	13	2	7	0	2	11
14892	287046	12	4	4	0	4	12
14892	503079	12	0	1	0	0	1
14892	65975	12	4	4	0	4	12
14892	98650	12	1	2	1	1	5
14892	106650	11	2	2	0	0	4
14892	503058	11	1	6	0	0	7
14892	503072	11	0	2	1	0	3
14892	503083	11	2	5	1	2	10
14892	55482	11	0	0	1	0	1
14892	72082	11	1	2	0	1	4
14892	72521	11	1	3	0	0	4
14892	92881	10	3	5	1	2	11
14892	103691	9	1	0	0	0	1
14892	503049	9	0	3	0	0	3
14892	503078	9	0	1	1	0	2
14892	50669	9	0	1	1	0	2
14892	51341	9	0	2	0	0	2
14892	287043	8	0	1	0	0	1
14892	503061	8	1	0	0	0	1
14892	58979	8	0	5	0	0	5
14892	85622	8	0	1	0	0	1
14892	107820	7	0	1	0	0	1
14892	503041	7	1	5	0	4	10
14892	65626	7	1	3	1	2	7
14892	82591	7	0	1	0	3	4
14892	107744	6	0	1	0	0	1
14892	191498	6	2	3	0	0	5
14892	503042	6	1	3	0	0	4
14892	503045	6	0	0	0	0	0
14892	63720	6	2	3	0	0	5
14892	287059	5	0	0	0	0	0
14892	503080	5	0	3	0	0	3
14892	59316	5	0	4	1	2	7
14892	84308	5	1	2	0	1	4
14892	89145	5	1	1	0	0	2
14892	105223	4	0	0	0	0	0
14892	190687	4	1	1	0	0	2
14892	193616	4	1	0	0	0	1
14892	214155	4	1	1	0	1	3
14892	287044	4	3	3	0	0	6
14892	50010	4	0	2	0	0	2
14892	503037	4	2	1	0	0	3
14892	503048	4	0	1	2	1	4
14892	54941	4	1	1	0	0	2
14892	89252	4	0	1	1	1	3
14892	181999	3	0	0	0	0	0
14892	287039	3	0	1	0	0	1
14892	503044	3	0	1	0	0	1
14892	54520	3	2	5	0	0	7
14892	56326	3	1	0	1	2	4
14892	85157	3	0	1	0	0	1
14892	503036	2	0	0	0	0	0
14892	503040	2	0	5	0	0	5
14892	503043	2	0	0	0	0	0
14892	503047	2	0	1	2	0	3
14892	83447	2	1	3	0	6	10
14892	191250	1	0	1	0	1	2
14892	195821	1	0	1	0	0	1
14892	503038	1	0	1	0	1	2
14892	503039	1	0	1	0	0	1
14892	503046	1	0	2	0	0	2
14892	89085	1	0	1	0	1	2
4774	284139	33	5	6	0	0	11
4774	625805	33	1	8	2	7	18
4774	79785	33	1	8	2	7	18
4774	90479	33	5	6	0	0	11
4774	625770	32	5	6	0	0	11
4774	625774	32	3	2	2	0	7
4774	625791	32	4	12	1	2	19
4774	86973	32	4	12	1	2	19
4774	625813	28	3	2	0	1	6
4774	284162	27	3	2	0	1	6
4774	67271	27	3	2	1	0	6
4774	625792	24	4	9	2	2	17
4774	625806	24	4	9	2	2	17
4774	69850	24	4	9	2	2	17
4774	195885	23	4	9	2	2	17
4774	284154	23	0	6	0	2	8
4774	76373	23	0	6	0	2	8
4774	97674	21	0	1	0	1	2
4774	625794	20	2	5	0	1	8
4774	75294	19	3	8	2	3	16
4774	83715	18	1	2	1	1	5
4774	56913	17	3	1	1	1	6
4774	63950	17	2	4	0	1	7
4774	103299	16	0	1	0	0	1
4774	284133	16	2	0	0	0	2
4774	284145	16	1	4	0	1	6
4774	284147	16	3	1	1	1	6
4774	50034	16	1	4	0	1	6
4774	625775	16	1	4	0	1	6
4774	625777	16	3	4	1	3	11
4774	625810	16	0	1	0	0	1
4774	81943	16	0	2	0	0	2
4774	57779	15	3	0	1	0	4
4774	65601	15	3	1	0	1	5
4774	78708	15	1	6	0	0	7
4774	93095	15	1	3	0	0	4
4774	284159	14	2	5	0	0	7
4774	53833	14	2	5	0	0	7
4774	625800	14	3	2	0	0	5
4774	75578	14	1	4	0	2	7
4774	91704	14	4	0	0	1	5
4774	100647	13	1	3	0	0	4
4774	284141	13	1	3	0	0	4
4774	284157	13	1	1	1	2	5
4774	53279	13	2	2	0	3	7
4774	625809	13	4	0	0	1	5
4774	72502	13	0	2	3	1	6
4774	105210	12	0	4	0	1	5
4774	284155	12	6	3	0	2	11
4774	284158	12	6	8	1	2	17
4774	625769	12	1	3	0	0	4
4774	625804	12	6	8	1	2	17
4774	625807	12	3	0	0	1	4
4774	625811	12	4	5	0	0	9
4774	74063	12	6	8	1	2	17
4774	80462	12	0	3	0	1	4
4774	284138	11	0	2	0	0	2
4774	284156	11	2	1	0	0	3
4774	284161	11	1	5	0	1	7
4774	54100	11	1	5	0	1	7
4774	625814	11	1	5	0	1	7
4774	66935	11	0	0	0	2	2
4774	73716	11	2	1	0	0	3
4774	77936	11	0	2	0	0	2
4774	99657	11	2	1	1	0	4
4774	625795	10	0	2	0	0	2
4774	194418	9	1	0	0	1	2
4774	625771	9	1	3	0	0	4
4774	625772	9	0	0	0	0	0
4774	68840	9	3	3	1	0	7
4774	88557	9	3	3	1	1	8
4774	625788	8	0	8	1	0	9
4774	625790	8	3	1	0	0	4
4774	625793	8	2	1	2	0	5
4774	625798	8	1	2	0	1	4
4774	625799	8	3	2	0	1	6
4774	66778	8	1	3	0	1	5
4774	92358	8	0	0	0	0	0
4774	92958	8	0	0	0	1	1
4774	105691	7	0	1	0	0	1
4774	106605	7	1	0	0	1	2
4774	211443	7	0	1	0	1	2
4774	219593	7	0	1	0	0	1
4774	284136	7	1	1	0	0	2
4774	284150	7	1	1	0	0	2
4774	49927	7	1	0	0	0	1
4774	50749	7	1	1	0	0	2
4774	68030	7	3	2	0	0	5
4774	85871	7	1	1	0	0	2
4774	105322	6	0	1	0	0	1
4774	284144	6	1	0	0	0	1
4774	625779	6	0	2	0	1	3
4774	625781	6	0	0	0	1	1
4774	625782	6	1	1	0	0	2
4774	625786	6	1	4	0	0	5
4774	625789	6	3	3	0	0	6
4774	625796	6	0	6	0	1	7
4774	625808	6	3	3	0	0	6
4774	64829	6	3	3	0	0	6
4774	70420	6	1	0	0	0	1
4774	72695	6	2	2	0	0	4
4774	90552	6	1	0	0	0	1
4774	92555	6	1	3	0	0	4
4774	107724	5	0	1	0	0	1
4774	205371	5	1	0	0	0	1
4774	284151	5	2	2	0	1	5
4774	284152	5	2	0	0	0	2
4774	284160	5	0	1	1	0	2
4774	51442	5	0	2	0	0	2
4774	53621	5	0	1	1	0	2
4774	54515	5	5	4	0	0	9
4774	56140	5	2	2	0	1	5
4774	61288	5	2	0	0	0	2
4774	625780	5	0	1	0	1	2
4774	625784	5	0	2	1	0	3
4774	625787	5	0	3	0	4	7
4774	625797	5	1	1	0	0	2
4774	625812	5	3	2	0	3	8
4774	204191	4	1	1	0	0	2
4774	208153	4	1	0	0	0	1
4774	284153	4	0	3	0	0	3
4774	52363	4	3	1	0	4	8
4774	55049	4	1	1	0	0	2
4774	56220	4	0	2	0	0	2
4774	625801	4	0	1	1	0	2
4774	625802	4	0	1	0	0	1
4774	92920	4	0	1	0	0	1
4774	284143	3	0	0	0	0	0
4774	284149	3	0	0	1	0	1
4774	625767	3	1	1	0	0	2
4774	625773	3	0	2	0	0	2
4774	625778	3	1	1	0	0	2
4774	625785	3	1	0	0	0	1
4774	625803	3	0	1	0	0	1
4774	65528	3	1	2	0	0	3
4774	83443	3	2	0	0	0	2
4774	99238	3	0	4	0	1	5
4774	182116	2	0	1	0	0	1
4774	184369	2	0	0	0	0	0
4774	189337	2	0	1	0	0	1
4774	284134	2	1	0	0	1	2
4774	625768	2	0	1	0	0	1
4774	625776	2	1	1	0	0	2
4774	625783	2	0	0	0	1	1
4774	71989	2	1	0	0	1	2
4774	83463	2	1	3	0	1	5
4774	208550	1	0	0	0	0	0
4774	81763	1	1	0	0	0	1
2601	202324	23	1	6	1	0	8
2601	275151	22	1	6	1	0	8
2601	536328	22	1	6	1	0	8
2601	82603	22	1	6	1	0	8
2601	536411	15	2	4	0	1	7
2601	188865	14	0	1	1	1	3
2601	536357	14	1	2	0	0	3
2601	275158	13	0	1	1	1	3
2601	536379	13	4	3	0	2	9
2601	536354	12	3	1	2	0	6
2601	536391	12	0	1	0	1	2
2601	536376	11	1	1	0	1	3
2601	536384	11	2	2	0	4	8
2601	536413	10	1	1	0	0	2
2601	183394	9	0	1	1	2	4
2601	536380	9	1	2	0	0	3
2601	536381	9	2	6	0	2	10
2601	536406	9	0	1	1	2	4
2601	183493	8	2	1	0	0	3
2601	205510	8	2	1	0	0	3
2601	536368	8	1	0	0	1	2
2601	536396	8	1	2	0	1	4
2601	186185	7	0	1	0	0	1
2601	192441	7	2	2	0	2	6
2601	195116	7	2	1	0	0	3
2601	536334	7	0	1	0	0	1
2601	536370	7	1	2	0	1	4
2601	536398	7	0	3	0	0	3
2601	536403	7	2	1	1	1	5
2601	536410	7	2	0	0	0	2
2601	536417	7	0	0	0	1	1
2601	220262	6	0	1	0	0	1
2601	275152	6	0	1	0	2	3
2601	275159	6	2	2	0	0	4
2601	536340	6	4	1	0	0	5
2601	536343	6	1	0	0	0	1
2601	536385	6	2	1	0	0	3
2601	536395	6	0	3	0	0	3
2601	536402	6	0	1	0	0	1
2601	536404	6	1	0	0	0	1
2601	536338	5	0	0	0	0	0
2601	536341	5	0	2	0	2	4
2601	536349	5	0	0	0	0	0
2601	536360	5	0	0	0	0	0
2601	536362	5	1	1	0	1	3
2601	536365	5	0	2	0	1	3
2601	536371	5	1	1	1	1	4
2601	536378	5	1	2	0	0	3
2601	536397	5	0	0	0	0	0
2601	536407	5	0	0	0	1	1
2601	536415	5	1	0	0	0	1
2601	206871	4	0	0	0	0	0
2601	207300	4	2	1	0	0	3
2601	208761	4	2	1	0	0	3
2601	275153	4	1	1	0	0	2
2601	275154	4	0	1	0	0	1
2601	536326	4	1	1	0	0	2
2601	536339	4	0	1	0	0	1
2601	536350	4	0	1	0	0	1
2601	536356	4	1	2	0	0	3
2601	536358	4	0	1	0	0	1
2601	536361	4	0	0	0	0	0
2601	536372	4	1	0	1	0	2
2601	536375	4	1	0	0	0	1
2601	536382	4	1	1	0	0	2
2601	536392	4	3	1	0	0	4
2601	536393	4	0	0	0	0	0
2601	536399	4	0	0	0	0	0
2601	536400	4	0	2	0	0	2
2601	536401	4	3	2	0	0	5
2601	536405	4	0	1	0	0	1
2601	536412	4	2	2	0	0	4
2601	536422	4	0	0	0	0	0
2601	536424	4	5	3	0	0	8
2601	98295	4	1	2	0	0	3
2601	186585	3	1	1	0	0	2
2601	186861	3	0	0	0	0	0
2601	195787	3	0	1	0	0	1
2601	198529	3	2	2	0	0	4
2601	200111	3	2	2	1	0	5
2601	204442	3	1	1	0	0	2
2601	211159	3	0	1	0	0	1
2601	214359	3	1	0	0	0	1
2601	215413	3	1	1	0	1	3
2601	215695	3	1	0	0	0	1
2601	215839	3	1	3	0	0	4
2601	275156	3	1	1	0	0	2
2601	275160	3	0	2	0	0	2
2601	275161	3	3	1	0	0	4
2601	275163	3	1	1	0	0	2
2601	536327	3	0	2	0	0	2
2601	536330	3	1	1	0	0	2
2601	536336	3	1	3	0	0	4
2601	536337	3	0	0	0	0	0
2601	536342	3	1	1	0	0	2
2601	536345	3	0	2	0	0	2
2601	536348	3	0	0	0	0	0
2601	536352	3	0	2	0	0	2
2601	536373	3	0	2	0	0	2
2601	536377	3	0	0	0	0	0
2601	536383	3	1	1	0	0	2
2601	536390	3	0	2	0	1	3
2601	536414	3	0	0	0	0	0
2601	536416	3	1	0	0	0	1
2601	536419	3	1	0	0	1	2
2601	536420	3	0	1	0	0	1
2601	536421	3	0	1	0	0	1
2601	185541	2	0	0	0	0	0
2601	190476	2	0	1	0	1	2
2601	192819	2	1	0	0	0	1
2601	196076	2	1	0	0	0	1
2601	196417	2	0	0	0	1	1
2601	209653	2	2	0	0	0	2
2601	210039	2	1	0	0	0	1
2601	275155	2	0	0	0	0	0
2601	275157	2	2	0	0	0	2
2601	275162	2	0	2	0	2	4
2601	536332	2	0	0	0	0	0
2601	536344	2	0	3	0	0	3
2601	536346	2	0	1	0	0	1
2601	536347	2	3	2	0	0	5
2601	536353	2	1	2	0	0	3
2601	536355	2	0	1	0	0	1
2601	536363	2	0	1	0	0	1
2601	536364	2	2	0	0	0	2
2601	536369	2	1	0	0	0	1
2601	536374	2	0	0	0	0	0
2601	536388	2	0	0	0	1	1
2601	536389	2	2	0	0	0	2
2601	536394	2	0	0	0	0	0
2601	536409	2	1	1	0	0	2
2601	536418	2	0	2	0	0	2
2601	536423	2	0	0	0	0	0
2601	73944	2	0	1	0	1	2
2601	186994	1	0	0	0	0	0
2601	190657	1	0	0	0	0	0
2601	202592	1	0	0	0	0	0
2601	207189	1	0	0	0	0	0
2601	275150	1	0	0	0	0	0
2601	536329	1	0	2	0	0	2
2601	536331	1	0	0	0	0	0
2601	536333	1	0	2	0	1	3
2601	536335	1	0	1	0	0	1
2601	536351	1	0	1	0	0	1
2601	536359	1	0	0	0	1	1
2601	536366	1	3	1	0	0	4
2601	536367	1	0	0	0	0	0
2601	536386	1	0	0	0	0	0
2601	536387	1	0	0	0	0	0
2601	536408	1	1	0	0	0	1
60580	575480	33	2	8	0	3	13
60580	299102	24	2	1	0	2	5
60580	88069	24	2	1	0	2	5
60580	201034	20	4	4	0	1	9
60580	191676	19	1	1	0	5	7
60580	73038	18	0	0	0	1	1
60580	190186	17	0	3	0	3	6
60580	221801	17	1	2	1	1	5
60580	575500	17	0	3	0	3	6
60580	575542	16	0	3	1	2	6
60580	201396	14	1	2	0	4	7
60580	575508	13	2	3	0	8	13
60580	575528	13	1	1	1	1	4
60580	77149	13	1	2	0	5	8
60580	104666	12	0	0	1	2	3
60580	183454	12	2	2	0	8	12
60580	299097	12	0	0	1	2	3
60580	575540	12	2	7	1	5	15
60580	55669	11	0	0	1	2	3
60580	575499	11	3	3	0	1	7
60580	575520	11	0	0	4	0	4
60580	575543	11	2	5	1	3	11
60580	186186	10	4	2	0	0	6
60580	192259	10	0	1	0	3	4
60580	195087	10	0	0	2	5	7
60580	204022	10	0	4	1	2	7
60580	221122	10	2	0	0	3	5
60580	299106	10	1	3	1	1	6
60580	575481	10	4	1	1	4	10
60580	575509	10	0	0	0	0	0
60580	575523	10	1	2	1	4	8
60580	192120	9	0	1	0	4	5
60580	212637	9	2	2	1	3	8
60580	575537	9	2	1	0	0	3
60580	191166	8	1	2	0	0	3
60580	210712	8	0	3	1	1	5
60580	299103	8	0	1	0	0	1
60580	575483	8	1	3	0	2	6
60580	575484	8	1	0	1	1	3
60580	575498	8	3	2	1	6	12
60580	575530	8	0	2	0	1	3
60580	575534	8	1	1	1	0	3
60580	575539	8	0	0	0	1	1
60580	197340	7	0	1	0	0	1
60580	208962	7	0	0	0	0	0
60580	575488	7	0	0	0	2	2
60580	575516	7	0	1	0	1	2
60580	575524	7	2	1	0	0	3
60580	575529	7	4	5	0	0	9
60580	83926	7	0	0	0	2	2
60580	183271	6	0	1	0	0	1
60580	183923	6	1	1	0	1	3
60580	195550	6	1	0	3	1	5
60580	203544	6	0	1	0	0	1
60580	575470	6	0	0	0	0	0
60580	575485	6	1	0	0	3	4
60580	575492	6	0	1	0	0	1
60580	575504	6	0	0	0	1	1
60580	575507	6	1	2	2	1	6
60580	575515	6	0	0	0	2	2
60580	575521	6	1	3	1	1	6
60580	575525	6	2	3	0	0	5
60580	575531	6	1	1	0	2	4
60580	575532	6	0	2	0	2	4
60580	575533	6	0	1	0	3	4
60580	575541	6	0	2	0	1	3
60580	206542	5	1	2	0	1	4
60580	299104	5	1	2	1	1	5
60580	575486	5	4	1	0	0	5
60580	575506	5	1	2	2	1	6
60580	575511	5	1	5	0	2	8
60580	575512	5	1	1	0	1	3
60580	575513	5	1	2	0	1	4
60580	575514	5	0	0	0	0	0
60580	575527	5	0	0	0	1	1
60580	64621	5	1	2	1	1	5
60580	101184	4	1	3	0	1	5
60580	182787	4	0	0	0	0	0
60580	187836	4	0	3	0	2	5
60580	192403	4	0	1	0	2	3
60580	299098	4	1	1	0	0	2
60580	299101	4	1	3	0	1	5
60580	299105	4	0	0	0	0	0
60580	575461	4	3	2	1	6	12
60580	575465	4	3	2	0	3	8
60580	575478	4	1	2	0	1	4
60580	575482	4	0	1	1	2	4
60580	575489	4	0	3	0	0	3
60580	575491	4	0	2	1	1	4
60580	575493	4	0	1	0	0	1
60580	575501	4	0	1	0	2	3
60580	575502	4	2	2	0	0	4
60580	575503	4	1	1	0	2	4
60580	575517	4	0	0	0	0	0
60580	575519	4	0	2	0	0	2
60580	575522	4	1	1	0	2	4
60580	575535	4	0	2	0	1	3
60580	189527	3	0	1	1	1	3
60580	196066	3	0	1	0	1	2
60580	196642	3	1	2	0	1	4
60580	211168	3	1	0	0	2	3
60580	213963	3	0	0	0	1	1
60580	215133	3	0	3	0	1	4
60580	215791	3	0	6	0	1	7
60580	575466	3	0	1	1	2	4
60580	575476	3	2	2	0	1	5
60580	575479	3	0	1	0	1	2
60580	575487	3	0	3	0	2	5
60580	575495	3	0	1	0	0	1
60580	575496	3	0	0	0	1	1
60580	575505	3	0	1	0	0	1
60580	575510	3	0	0	0	2	2
60580	575526	3	1	0	0	0	1
60580	575536	3	0	0	0	0	0
60580	106247	2	0	0	0	1	1
60580	191953	2	1	0	0	1	2
60580	195548	2	0	0	0	0	0
60580	207841	2	0	0	0	0	0
60580	219663	2	1	1	0	0	2
60580	299099	2	0	1	0	0	1
60580	575464	2	0	2	0	2	4
60580	575469	2	0	1	0	0	1
60580	575474	2	0	0	0	0	0
60580	575494	2	0	0	0	2	2
60580	575497	2	0	0	0	2	2
60580	575518	2	0	0	0	0	0
60580	73263	2	3	0	0	0	3
60580	79333	2	0	0	0	2	2
60580	189576	1	0	0	0	0	0
60580	192555	1	0	1	1	1	3
60580	198481	1	0	2	0	0	2
60580	208396	1	0	3	0	1	4
60580	209826	1	0	1	0	0	1
60580	213523	1	0	0	0	1	1
60580	220092	1	0	0	0	0	0
60580	299100	1	0	0	0	0	0
60580	575462	1	0	1	0	0	1
60580	575463	1	0	1	0	0	1
60580	575467	1	0	1	0	1	2
60580	575468	1	0	0	0	2	2
60580	575471	1	0	0	0	0	0
60580	575472	1	0	0	0	1	1
60580	575473	1	0	2	0	1	3
60580	575475	1	0	1	0	0	1
60580	575477	1	0	1	0	0	1
60580	575490	1	1	1	0	0	2
60580	575538	1	0	0	0	1	1
60580	61352	1	0	0	0	0	0
26008	536136	46	8	3	2	1	14
26008	536141	39	5	11	1	0	17
26008	536115	37	4	6	1	3	14
26008	536117	36	7	2	6	4	19
26008	536137	34	3	6	1	4	14
26008	536121	33	2	4	4	3	13
26008	536119	32	4	5	5	2	16
26008	536122	32	6	3	1	0	10
26008	536118	29	2	4	2	3	11
26008	536127	29	7	6	3	1	17
26008	536116	25	1	5	2	1	9
26008	536124	25	5	3	1	4	13
26008	536125	25	5	3	1	4	13
26008	536128	25	2	2	0	1	5
26008	536178	25	3	2	4	3	12
26008	536129	24	5	3	0	3	11
26008	536130	24	5	3	0	3	11
26008	536142	24	5	4	1	3	13
26008	184103	21	1	4	0	3	8
26008	536170	18	1	4	0	2	7
26008	536172	18	1	4	0	2	7
26008	290066	17	0	6	1	3	10
26008	536134	17	0	0	0	1	1
26008	207718	16	1	2	0	0	3
26008	536123	16	3	3	0	3	9
26008	536131	14	2	4	1	3	10
26008	536211	14	1	6	0	1	8
26008	209851	13	1	1	0	4	6
26008	290065	13	1	1	0	4	6
26008	536157	12	2	2	2	0	6
26008	536171	12	1	4	0	2	7
26008	196875	11	2	1	0	0	3
26008	211520	11	2	0	0	0	2
26008	212992	11	3	2	0	1	6
26008	184667	10	0	2	2	2	6
26008	212223	10	2	1	2	4	9
26008	536160	10	2	1	2	4	9
26008	536177	10	3	2	1	4	10
26008	290077	9	2	0	0	1	3
26008	536152	9	2	1	1	0	4
26008	536159	9	0	0	0	0	0
26008	536198	9	1	2	1	2	6
26008	536133	8	2	0	0	1	3
26008	536140	8	3	1	0	3	7
26008	536158	8	1	1	0	1	3
26008	536165	8	5	1	2	1	9
26008	536166	8	0	0	1	3	4
26008	536181	8	0	1	1	2	4
26008	536193	8	1	1	0	0	2
26008	536208	8	0	1	0	0	1
26008	536212	8	6	3	0	0	9
26008	290067	7	1	1	0	3	5
26008	290072	7	0	2	1	2	5
26008	536147	7	1	0	0	0	1
26008	536162	7	4	3	2	1	10
26008	536186	7	2	3	0	0	5
26008	536201	7	0	2	0	2	4
26008	190572	6	1	0	1	2	4
26008	193105	6	1	1	0	3	5
26008	198678	6	2	0	1	1	4
26008	536149	6	0	0	0	0	0
26008	536163	6	2	0	0	0	2
26008	536168	6	0	0	0	0	0
26008	536199	6	1	0	0	1	2
26008	536202	6	0	1	0	1	2
26008	194386	5	0	0	0	1	1
26008	203383	5	1	1	0	2	4
26008	209625	5	0	0	0	3	3
26008	220065	5	1	0	0	1	2
26008	290074	5	2	0	0	1	3
26008	536114	5	4	0	0	3	7
26008	536135	5	2	0	0	1	3
26008	536143	5	1	2	0	1	4
26008	536144	5	1	1	0	0	2
26008	536161	5	1	0	0	1	2
26008	536182	5	1	0	0	2	3
26008	536191	5	0	3	0	2	5
26008	536207	5	0	2	1	0	3
26008	189176	4	1	1	0	1	3
26008	205426	4	2	1	0	2	5
26008	212701	4	0	1	0	1	2
26008	214939	4	0	2	0	1	3
26008	290063	4	0	3	0	1	4
26008	290068	4	2	1	1	2	6
26008	290070	4	0	1	0	1	2
26008	290071	4	2	2	0	0	4
26008	290073	4	1	0	0	1	2
26008	290076	4	0	1	0	1	2
26008	536111	4	1	3	0	1	5
26008	536126	4	0	1	0	0	1
26008	536132	4	3	0	0	2	5
26008	536138	4	0	1	0	0	1
26008	536146	4	1	0	0	0	1
26008	536150	4	2	1	0	1	4
26008	536164	4	0	1	1	1	3
26008	536174	4	0	0	0	0	0
26008	536180	4	0	0	0	0	0
26008	536183	4	1	0	0	1	2
26008	536185	4	1	2	0	0	3
26008	536192	4	2	1	0	0	3
26008	536204	4	0	1	0	1	2
26008	193175	3	1	2	0	1	4
26008	199938	3	0	0	0	1	1
26008	204877	3	2	5	0	0	7
26008	218077	3	0	0	0	3	3
26008	290069	3	0	0	0	1	1
26008	290078	3	1	0	0	0	1
26008	369282	3	1	2	0	0	3
26008	399952	3	1	2	0	0	3
26008	536110	3	0	2	0	2	4
26008	536139	3	1	0	0	2	3
26008	536145	3	1	0	0	0	1
26008	536151	3	0	1	1	0	2
26008	536154	3	0	0	2	0	2
26008	536155	3	0	0	0	3	3
26008	536156	3	1	0	0	0	1
26008	536167	3	2	2	0	0	4
26008	536169	3	2	1	0	0	3
26008	536176	3	2	2	0	0	4
26008	536179	3	0	0	0	0	0
26008	536187	3	1	3	0	2	6
26008	536188	3	2	0	1	0	3
26008	536196	3	1	0	0	0	1
26008	536205	3	2	1	2	0	5
26008	536209	3	1	0	0	0	1
26008	536210	3	1	3	0	1	5
26008	183482	2	2	0	0	0	2
26008	191104	2	0	2	1	2	5
26008	200288	2	0	1	0	0	1
26008	203262	2	0	0	0	1	1
26008	290075	2	1	0	0	0	1
26008	536148	2	0	0	0	0	0
26008	536153	2	0	0	1	0	1
26008	536173	2	0	2	0	1	3
26008	536175	2	2	1	0	0	3
26008	536189	2	0	0	0	1	1
26008	536194	2	0	1	0	1	2
26008	536195	2	2	0	0	0	2
26008	536197	2	0	0	0	0	0
26008	536206	2	0	0	0	0	0
26008	198484	1	0	0	0	0	0
26008	205732	1	0	1	0	0	1
26008	536109	1	1	0	0	0	1
26008	536112	1	0	0	2	0	2
26008	536113	1	0	0	0	2	2
26008	536184	1	0	0	0	0	0
26008	536190	1	0	0	0	0	0
26008	536200	1	1	1	1	1	4
26008	536203	1	0	0	0	0	0
7126	210671	27	4	10	0	2	16
7126	474249	26	4	10	0	2	16
7126	210215	20	0	6	1	0	7
7126	101974	19	0	3	2	0	5
7126	210972	10	1	2	0	1	4
7126	474279	10	1	1	0	0	2
7126	474271	9	2	2	0	2	6
7126	474230	8	0	1	0	1	2
7126	474233	8	3	3	0	1	7
7126	474237	8	1	3	0	1	5
7126	474320	8	0	0	0	0	0
7126	190471	7	1	1	0	0	2
7126	474234	7	3	4	0	1	8
7126	474299	7	1	1	0	0	2
7126	185874	6	3	1	0	0	4
7126	195147	6	3	0	1	0	4
7126	202701	6	3	0	0	0	3
7126	275562	6	0	0	0	0	0
7126	474242	6	0	1	0	0	1
7126	474247	6	1	4	0	0	5
7126	474263	6	1	3	0	1	5
7126	474296	6	1	0	0	0	1
7126	474312	6	0	2	1	0	3
7126	474316	6	2	1	1	0	4
7126	191093	5	2	0	1	0	3
7126	193506	5	0	3	0	0	3
7126	197115	5	1	1	0	0	2
7126	211609	5	3	1	0	1	5
7126	474239	5	0	2	0	0	2
7126	474251	5	2	0	0	0	2
7126	474252	5	0	1	0	0	1
7126	474267	5	2	2	0	3	7
7126	474272	5	1	3	0	1	5
7126	474277	5	0	0	0	0	0
7126	474298	5	0	0	0	1	1
7126	474301	5	1	3	0	0	4
7126	474305	5	2	2	1	3	8
7126	474314	5	0	1	0	0	1
7126	201300	4	1	1	1	0	3
7126	205300	4	1	0	0	0	1
7126	220098	4	2	1	0	0	3
7126	275560	4	1	0	1	0	2
7126	275563	4	0	3	0	0	3
7126	275565	4	1	0	0	0	1
7126	275568	4	1	1	0	1	3
7126	275571	4	0	2	0	0	2
7126	474227	4	0	0	0	0	0
7126	474238	4	2	1	0	0	3
7126	474257	4	0	2	0	0	2
7126	474261	4	1	1	0	0	2
7126	474269	4	1	3	0	0	4
7126	474281	4	1	1	0	0	2
7126	474286	4	0	0	0	0	0
7126	474290	4	1	1	0	0	2
7126	474292	4	0	0	0	0	0
7126	474293	4	0	0	1	0	1
7126	474294	4	0	0	1	0	1
7126	474300	4	0	1	1	0	2
7126	474308	4	1	1	0	0	2
7126	474309	4	0	0	1	0	1
7126	474315	4	0	1	0	0	1
7126	474319	4	0	0	0	1	1
7126	474325	4	1	1	1	0	3
7126	182728	3	1	0	0	0	1
7126	200097	3	1	0	0	0	1
7126	200432	3	1	0	0	0	1
7126	200643	3	0	0	0	1	1
7126	202035	3	0	2	0	0	2
7126	205271	3	0	0	0	0	0
7126	209684	3	1	0	0	0	1
7126	216802	3	0	0	0	0	0
7126	275559	3	0	1	0	0	1
7126	275561	3	1	1	0	0	2
7126	275564	3	0	1	0	0	1
7126	275569	3	0	1	0	0	1
7126	474228	3	1	0	0	0	1
7126	474240	3	0	2	0	0	2
7126	474244	3	0	1	1	0	2
7126	474245	3	1	3	0	0	4
7126	474246	3	1	1	0	0	2
7126	474255	3	1	0	0	0	1
7126	474256	3	1	0	0	0	1
7126	474258	3	0	1	0	0	1
7126	474259	3	1	2	0	1	4
7126	474262	3	0	2	0	0	2
7126	474265	3	0	0	0	0	0
7126	474266	3	0	0	0	0	0
7126	474270	3	1	1	0	0	2
7126	474273	3	0	0	0	0	0
7126	474274	3	1	0	0	0	1
7126	474275	3	0	0	0	0	0
7126	474278	3	0	2	0	0	2
7126	474282	3	1	1	0	0	2
7126	474283	3	1	1	0	0	2
7126	474285	3	0	0	1	0	1
7126	474287	3	0	0	0	0	0
7126	474288	3	0	2	0	0	2
7126	474303	3	1	3	0	0	4
7126	474304	3	2	0	0	0	2
7126	474306	3	0	1	0	0	1
7126	474307	3	0	2	0	0	2
7126	474311	3	1	1	0	0	2
7126	474318	3	0	0	0	0	0
7126	189633	2	0	2	0	0	2
7126	190049	2	0	0	0	0	0
7126	200649	2	1	0	0	0	1
7126	204604	2	0	0	0	0	0
7126	205527	2	1	0	0	0	1
7126	214360	2	1	0	0	0	1
7126	275567	2	1	0	0	0	1
7126	474231	2	0	1	0	0	1
7126	474235	2	1	1	0	1	3
7126	474236	2	0	0	0	0	0
7126	474241	2	1	0	0	0	1
7126	474243	2	1	1	0	0	2
7126	474250	2	0	0	0	1	1
7126	474253	2	1	0	0	0	1
7126	474254	2	1	1	0	0	2
7126	474264	2	0	0	0	0	0
7126	474268	2	0	3	0	0	3
7126	474276	2	1	4	0	0	5
7126	474280	2	0	2	0	0	2
7126	474289	2	0	1	0	0	1
7126	474291	2	0	0	0	0	0
7126	474295	2	1	0	0	0	1
7126	474297	2	0	1	0	0	1
7126	474310	2	2	0	0	0	2
7126	474317	2	0	0	0	0	0
7126	474321	2	1	0	0	0	1
7126	474323	2	0	1	0	0	1
7126	474324	2	0	0	0	0	0
7126	186589	1	0	1	0	0	1
7126	193971	1	0	0	0	0	0
7126	200284	1	0	0	0	0	0
7126	203722	1	0	0	0	0	0
7126	216962	1	1	2	0	0	3
7126	220270	1	1	0	0	0	1
7126	275566	1	1	1	0	0	2
7126	275570	1	0	1	0	0	1
7126	474229	1	0	0	0	0	0
7126	474232	1	0	1	0	1	2
7126	474248	1	1	0	0	0	1
7126	474260	1	0	0	0	0	0
7126	474284	1	0	3	0	0	3
7126	474302	1	0	1	0	0	1
7126	474313	1	1	0	0	0	1
7126	474322	1	1	1	0	1	3
25373	191550	36	0	2	2	1	5
25373	395452	35	3	2	3	3	11
25373	395425	29	2	3	0	5	10
25373	83198	29	2	3	0	5	10
25373	395437	21	2	5	0	3	10
25373	395505	18	0	1	1	1	3
25373	189984	16	1	0	0	1	2
25373	289957	14	0	2	0	0	2
25373	70771	14	0	2	0	0	2
25373	78756	14	0	0	2	2	4
25373	395507	13	0	0	0	0	0
25373	55159	13	1	1	1	4	7
25373	395436	12	2	0	0	2	4
25373	101489	11	1	3	1	7	12
25373	188619	10	1	3	0	2	6
25373	289964	10	1	3	0	2	6
25373	395504	10	1	1	0	0	2
25373	59801	10	1	3	0	2	6
25373	212309	9	3	2	0	1	6
25373	395423	9	1	2	0	0	3
25373	395433	9	4	1	0	3	8
25373	395435	9	0	0	0	3	3
25373	395453	9	0	0	3	0	3
25373	395480	9	3	0	0	0	3
25373	395493	9	1	1	0	0	2
25373	186020	8	1	2	0	0	3
25373	188032	8	1	2	0	0	3
25373	395456	8	1	3	1	2	7
25373	395479	8	0	2	0	0	2
25373	395485	8	4	1	0	0	5
25373	395497	8	2	0	0	2	4
25373	395506	8	0	0	0	3	3
25373	101032	7	1	1	0	1	3
25373	209797	7	1	0	0	0	1
25373	289963	7	1	1	0	1	3
25373	395432	7	2	1	1	4	8
25373	395443	7	2	1	0	1	4
25373	395444	7	1	1	1	1	4
25373	395446	7	4	1	0	1	6
25373	395476	7	1	2	0	4	7
25373	395498	7	0	0	0	1	1
25373	79704	7	1	2	0	1	4
25373	194655	6	0	0	0	2	2
25373	197510	6	1	3	1	0	5
25373	198707	6	0	0	0	1	1
25373	203464	6	0	1	0	1	2
25373	220629	6	1	0	0	1	2
25373	289958	6	1	1	0	2	4
25373	289960	6	1	3	1	0	5
25373	395451	6	1	1	0	1	3
25373	395472	6	0	1	0	1	2
25373	395487	6	2	0	0	1	3
25373	395494	6	0	0	0	1	1
25373	74597	6	0	0	0	1	1
25373	84679	6	1	1	0	2	4
25373	89304	6	1	0	0	3	4
25373	184575	5	0	0	0	1	1
25373	191277	5	0	1	0	2	3
25373	219816	5	0	0	0	3	3
25373	395426	5	1	0	0	1	2
25373	395427	5	1	3	0	2	6
25373	395431	5	0	1	0	0	1
25373	395459	5	1	1	0	0	2
25373	395460	5	0	0	1	1	2
25373	395471	5	2	0	0	0	2
25373	395473	5	1	1	0	1	3
25373	395488	5	2	0	0	1	3
25373	395502	5	0	3	0	2	5
25373	395503	5	1	0	0	0	1
25373	413259	5	1	2	1	0	4
25373	50714	5	0	0	0	0	0
25373	182194	4	1	0	0	2	3
25373	188372	4	0	0	0	1	1
25373	189419	4	0	0	0	2	2
25373	190719	4	0	0	0	1	1
25373	192119	4	0	2	0	2	4
25373	208947	4	0	0	0	1	1
25373	211463	4	0	1	0	2	3
25373	289959	4	0	0	0	3	3
25373	289961	4	1	0	0	2	3
25373	395454	4	0	2	0	0	2
25373	395458	4	0	0	0	0	0
25373	395464	4	1	0	1	0	2
25373	395469	4	2	1	0	0	3
25373	395478	4	1	1	0	2	4
25373	395481	4	0	0	0	2	2
25373	395486	4	0	1	0	1	2
25373	395491	4	0	0	0	2	2
25373	395499	4	1	2	0	0	3
25373	413260	4	1	2	2	0	5
25373	51304	4	1	0	0	2	3
25373	56609	4	0	0	1	0	1
25373	108124	3	0	1	1	2	4
25373	215189	3	0	0	0	1	1
25373	289962	3	0	0	0	2	2
25373	395428	3	0	0	1	0	1
25373	395434	3	1	0	0	1	2
25373	395438	3	0	1	0	3	4
25373	395439	3	3	0	0	0	3
25373	395440	3	0	0	0	4	4
25373	395441	3	2	0	0	1	3
25373	395442	3	1	1	0	0	2
25373	395448	3	0	0	0	1	1
25373	395450	3	2	1	0	1	4
25373	395455	3	0	2	0	1	3
25373	395462	3	1	1	0	1	3
25373	395463	3	0	0	0	0	0
25373	395465	3	1	0	0	4	5
25373	395466	3	0	0	0	1	1
25373	395467	3	0	0	0	1	1
25373	395470	3	0	1	1	0	2
25373	395477	3	2	0	0	1	3
25373	395484	3	1	0	0	1	2
25373	395490	3	0	1	1	0	2
25373	395496	3	1	1	1	1	4
25373	395509	3	2	0	0	3	5
25373	413261	3	1	0	1	2	4
25373	61317	3	0	0	0	2	2
25373	184342	2	0	1	0	0	1
25373	192849	2	0	0	0	0	0
25373	196425	2	1	0	0	0	1
25373	395445	2	0	0	0	0	0
25373	395447	2	0	0	0	0	0
25373	395449	2	0	0	0	2	2
25373	395457	2	0	0	0	0	0
25373	395461	2	0	0	0	1	1
25373	395468	2	1	0	0	1	2
25373	395474	2	0	0	0	0	0
25373	395475	2	0	1	1	0	2
25373	395482	2	0	1	0	0	1
25373	395483	2	0	0	0	2	2
25373	395489	2	0	0	0	1	1
25373	395492	2	0	1	0	1	2
25373	395495	2	0	0	0	1	1
25373	395500	2	1	0	0	2	3
25373	395501	2	0	2	0	0	2
25373	395508	2	0	1	0	0	1
25373	395511	2	1	0	0	0	1
25373	395422	1	0	1	0	0	1
25373	395424	1	0	0	0	1	1
25373	395429	1	0	0	0	0	0
25373	395430	1	0	0	0	0	0
25373	395510	1	1	1	0	0	2
25373	413258	1	0	2	0	0	2
63571	426514	15	1	2	0	0	3
63571	426523	13	0	1	0	2	3
63571	426549	13	0	1	0	0	1
63571	426513	11	3	4	0	0	7
63571	426571	11	0	0	0	4	4
63571	403369	9	0	0	0	0	0
63571	426552	8	2	1	0	0	3
63571	426556	8	0	0	0	0	0
63571	426557	8	1	4	0	0	5
63571	426572	8	1	1	0	0	2
63571	426612	8	2	1	1	0	4
63571	300000	7	1	1	0	1	3
63571	403368	7	1	2	1	0	4
63571	426560	7	0	2	2	0	4
63571	426629	7	3	2	0	2	7
63571	205283	6	0	0	0	0	0
63571	299999	6	0	2	0	0	2
63571	300003	6	1	3	0	0	4
63571	426512	6	0	1	0	0	1
63571	426581	6	2	1	0	0	3
63571	426594	6	1	1	0	0	2
63571	426614	6	3	0	0	0	3
63571	426619	6	0	1	0	0	1
63571	426633	6	1	4	0	0	5
63571	199084	5	0	0	0	0	0
63571	300002	5	0	0	0	1	1
63571	426520	5	1	1	2	0	4
63571	426525	5	1	0	0	1	2
63571	426528	5	1	4	0	0	5
63571	426535	5	1	1	0	0	2
63571	426546	5	1	1	0	0	2
63571	426550	5	2	2	0	2	6
63571	426561	5	1	0	0	0	1
63571	426576	5	1	1	0	0	2
63571	426586	5	0	0	0	0	0
63571	426588	5	0	1	0	0	1
63571	426604	5	2	2	0	0	4
63571	426606	5	1	2	0	0	3
63571	426608	5	0	0	0	0	0
63571	426617	5	1	3	1	0	5
63571	426621	5	2	1	0	0	3
63571	426631	5	0	3	0	1	4
63571	426632	5	1	1	0	0	2
63571	211080	4	0	1	0	0	1
63571	299998	4	0	2	0	1	3
63571	426510	4	1	0	0	0	1
63571	426538	4	0	2	0	0	2
63571	426539	4	2	0	0	0	2
63571	426541	4	3	2	0	0	5
63571	426542	4	1	1	0	0	2
63571	426544	4	1	0	0	0	1
63571	426551	4	2	1	0	0	3
63571	426553	4	0	2	0	2	4
63571	426559	4	0	0	0	0	0
63571	426563	4	1	1	0	0	2
63571	426577	4	0	1	0	0	1
63571	426582	4	0	0	0	0	0
63571	426583	4	0	1	0	0	1
63571	426596	4	2	1	0	0	3
63571	426597	4	1	1	0	0	2
63571	426602	4	0	1	0	0	1
63571	426620	4	1	1	0	0	2
63571	426624	4	0	1	0	0	1
63571	426625	4	1	1	0	0	2
63571	426627	4	0	3	0	0	3
63571	426628	4	1	0	0	0	1
63571	200113	3	0	1	0	2	3
63571	203096	3	1	1	0	0	2
63571	299997	3	0	2	0	0	2
63571	403371	3	1	3	0	1	5
63571	426517	3	1	2	0	0	3
63571	426518	3	0	1	0	1	2
63571	426522	3	1	2	0	0	3
63571	426526	3	2	1	0	0	3
63571	426527	3	0	1	0	0	1
63571	426529	3	0	0	0	0	0
63571	426534	3	1	3	0	0	4
63571	426536	3	0	1	0	0	1
63571	426540	3	1	2	0	0	3
63571	426545	3	1	1	0	1	3
63571	426558	3	0	0	0	0	0
63571	426562	3	0	1	0	0	1
63571	426567	3	0	1	0	1	2
63571	426568	3	1	1	0	0	2
63571	426569	3	1	0	0	0	1
63571	426570	3	1	0	0	1	2
63571	426574	3	0	1	0	0	1
63571	426579	3	1	0	0	0	1
63571	426580	3	0	1	0	0	1
63571	426584	3	0	2	0	0	2
63571	426585	3	1	0	1	0	2
63571	426589	3	1	3	0	0	4
63571	426590	3	0	0	0	0	0
63571	426591	3	3	1	0	0	4
63571	426592	3	2	0	0	0	2
63571	426593	3	2	2	0	1	5
63571	426598	3	0	1	0	0	1
63571	426599	3	1	0	0	0	1
63571	426600	3	0	0	0	0	0
63571	426609	3	2	1	0	0	3
63571	426611	3	2	0	0	0	2
63571	426613	3	2	2	0	0	4
63571	426616	3	0	0	0	0	0
63571	426623	3	0	1	0	0	1
63571	426634	3	0	1	0	0	1
63571	204348	2	1	1	0	0	2
63571	299995	2	1	1	0	0	2
63571	299996	2	0	1	0	0	1
63571	300001	2	0	1	0	0	1
63571	403370	2	1	1	0	0	2
63571	426511	2	1	1	0	0	2
63571	426521	2	0	1	0	0	1
63571	426530	2	0	0	0	0	0
63571	426531	2	1	1	0	0	2
63571	426532	2	1	2	0	0	3
63571	426533	2	0	2	0	0	2
63571	426537	2	0	1	0	0	1
63571	426543	2	0	1	0	0	1
63571	426547	2	0	1	0	0	1
63571	426548	2	2	4	2	0	8
63571	426554	2	0	2	0	0	2
63571	426555	2	0	1	0	0	1
63571	426565	2	1	0	0	0	1
63571	426573	2	0	1	0	0	1
63571	426575	2	0	1	0	0	1
63571	426578	2	1	0	0	0	1
63571	426601	2	1	0	0	0	1
63571	426603	2	1	1	0	0	2
63571	426607	2	0	1	0	0	1
63571	426610	2	0	1	0	0	1
63571	426615	2	0	2	0	2	4
63571	426618	2	1	1	0	0	2
63571	426622	2	0	1	0	0	1
63571	426635	2	1	2	0	0	3
63571	209378	1	1	0	0	0	1
63571	426515	1	1	0	0	0	1
63571	426516	1	0	0	0	0	0
63571	426519	1	0	2	0	0	2
63571	426524	1	1	0	0	0	1
63571	426564	1	0	0	0	0	0
63571	426566	1	0	0	0	0	0
63571	426587	1	1	2	0	0	3
63571	426595	1	2	0	0	1	3
63571	426605	1	0	0	0	0	0
63571	426626	1	0	1	0	1	2
63571	426636	1	1	0	0	1	2
65635	58528	27	3	4	1	2	10
65635	221562	20	1	1	0	0	2
65635	202445	19	3	6	0	0	9
65635	300709	19	3	6	0	0	9
65635	483619	19	3	6	0	0	9
65635	82904	19	3	6	0	0	9
65635	106678	12	0	2	0	0	2
65635	187757	12	1	0	1	0	2
65635	196493	12	1	3	0	0	4
65635	104225	11	1	0	0	2	3
65635	190626	10	1	0	0	0	1
65635	483633	10	0	2	0	0	2
65635	483685	10	1	1	0	0	2
65635	220240	8	0	0	0	0	0
65635	65438	8	1	2	0	0	3
65635	89168	8	0	3	0	2	5
65635	189974	7	1	1	0	0	2
65635	483645	7	1	1	0	0	2
65635	483655	7	0	0	0	0	0
65635	483680	7	1	3	0	1	5
65635	205795	6	1	1	0	0	2
65635	483621	6	1	1	0	0	2
65635	483623	6	0	2	0	0	2
65635	483629	6	1	2	0	0	3
65635	483646	6	3	2	0	1	6
65635	483668	6	0	0	0	0	0
65635	483683	6	0	3	0	1	4
65635	483690	6	0	1	0	0	1
65635	51567	6	2	0	1	0	3
65635	189406	5	0	2	0	0	2
65635	202962	5	0	2	0	0	2
65635	204406	5	1	1	0	0	2
65635	216725	5	1	2	0	0	3
65635	218566	5	0	3	0	0	3
65635	300711	5	1	0	0	0	1
65635	300715	5	2	3	0	2	7
65635	300720	5	1	3	0	0	4
65635	483614	5	1	1	0	1	3
65635	483616	5	2	3	0	0	5
65635	483635	5	0	1	0	1	2
65635	483636	5	2	1	1	0	4
65635	483642	5	0	0	0	0	0
65635	483661	5	0	1	0	0	1
65635	483672	5	0	1	0	0	1
65635	483677	5	2	3	0	1	6
65635	483684	5	0	2	0	0	2
65635	78550	5	1	0	0	0	1
65635	78831	5	1	0	0	0	1
65635	81282	5	1	1	0	0	2
65635	91186	5	2	3	0	2	7
65635	94135	5	1	3	0	0	4
65635	212959	4	0	2	0	0	2
65635	217218	4	0	0	0	0	0
65635	300712	4	1	1	0	0	2
65635	483613	4	0	0	0	0	0
65635	483615	4	1	0	0	0	1
65635	483620	4	0	1	0	0	1
65635	483622	4	1	2	0	0	3
65635	483625	4	1	2	0	0	3
65635	483628	4	1	4	0	0	5
65635	483638	4	0	1	0	0	1
65635	483639	4	0	1	0	2	3
65635	483640	4	0	1	0	0	1
65635	483643	4	1	1	0	1	3
65635	483644	4	1	1	0	0	2
65635	483647	4	0	2	0	0	2
65635	483649	4	1	0	0	0	1
65635	483652	4	1	1	0	0	2
65635	483654	4	0	2	0	2	4
65635	483656	4	2	2	0	0	4
65635	483662	4	0	2	0	0	2
65635	483666	4	2	1	0	0	3
65635	483673	4	0	0	1	0	1
65635	483681	4	1	0	0	0	1
65635	483686	4	1	2	0	0	3
65635	483687	4	0	0	0	0	0
65635	65595	4	2	3	0	0	5
65635	101906	3	0	2	2	2	6
65635	102216	3	1	1	0	0	2
65635	103012	3	0	0	1	0	1
65635	197177	3	0	0	0	0	0
65635	201373	3	1	0	0	0	1
65635	206062	3	0	2	0	0	2
65635	211423	3	0	1	0	0	1
65635	214819	3	1	1	0	0	2
65635	300710	3	0	0	1	0	1
65635	300717	3	0	3	0	0	3
65635	300718	3	0	2	0	0	2
65635	300719	3	0	2	2	2	6
65635	483612	3	1	1	0	0	2
65635	483626	3	0	2	0	0	2
65635	483630	3	1	2	0	0	3
65635	483632	3	1	1	0	0	2
65635	483641	3	0	0	0	0	0
65635	483648	3	1	0	0	0	1
65635	483650	3	1	0	0	0	1
65635	483657	3	2	1	0	0	3
65635	483658	3	1	1	0	0	2
65635	483664	3	2	2	0	0	4
65635	483665	3	0	1	0	1	2
65635	483667	3	0	2	0	1	3
65635	483670	3	0	1	0	0	1
65635	483671	3	0	0	0	1	1
65635	483674	3	0	0	0	0	0
65635	483678	3	0	1	0	1	2
65635	70940	3	0	3	0	0	3
65635	197824	2	0	0	0	0	0
65635	199895	2	1	0	0	0	1
65635	210031	2	0	1	0	0	1
65635	218757	2	0	0	0	0	0
65635	218767	2	0	1	0	1	2
65635	220005	2	0	0	0	0	0
65635	300713	2	0	1	0	0	1
65635	300714	2	0	2	0	0	2
65635	300716	2	0	2	0	0	2
65635	483611	2	0	1	0	0	1
65635	483624	2	0	0	0	0	0
65635	483631	2	1	1	0	0	2
65635	483637	2	0	2	0	2	4
65635	483653	2	0	3	0	0	3
65635	483659	2	0	0	0	0	0
65635	483660	2	0	1	0	0	1
65635	483663	2	1	1	0	0	2
65635	483669	2	0	1	0	1	2
65635	483675	2	0	1	0	0	1
65635	483676	2	0	2	0	0	2
65635	483679	2	0	0	0	0	0
65635	483688	2	1	0	0	0	1
65635	483691	2	1	1	0	0	2
65635	483692	2	1	0	0	0	1
65635	54330	2	0	2	0	0	2
65635	59077	2	0	2	0	0	2
65635	187017	1	0	0	0	0	0
65635	192815	1	0	1	0	0	1
65635	203127	1	0	0	0	0	0
65635	214394	1	0	1	0	0	1
65635	300708	1	0	1	0	0	1
65635	483610	1	0	0	0	0	0
65635	483617	1	1	0	0	0	1
65635	483618	1	0	0	0	0	0
65635	483627	1	0	5	0	0	5
65635	483634	1	0	1	0	0	1
65635	483651	1	0	1	0	0	1
65635	483682	1	1	0	0	2	3
65635	483689	1	0	1	0	0	1
65635	71556	1	0	1	0	0	1
37049	371083	48	3	7	0	2	12
37049	202349	23	0	3	1	1	5
37049	293098	22	0	3	1	1	5
37049	371068	22	0	3	1	1	5
37049	371104	22	3	7	1	6	17
37049	82798	22	0	3	1	1	5
37049	371063	18	4	1	0	7	12
37049	371113	18	6	6	1	5	18
37049	201664	16	0	0	0	2	2
37049	371089	16	2	2	0	1	5
37049	371109	16	1	2	1	3	7
37049	371075	15	0	2	2	1	5
37049	371098	14	1	1	1	2	5
37049	371064	13	2	1	0	5	8
37049	108656	12	0	3	0	0	3
37049	293107	12	0	3	0	0	3
37049	371107	11	2	2	0	0	4
37049	371124	11	2	2	0	0	4
37049	371125	10	1	2	1	2	6
37049	207296	9	0	4	0	4	8
37049	293106	9	3	2	0	0	5
37049	371080	9	1	3	0	3	7
37049	371119	9	1	2	0	3	6
37049	371128	9	3	0	0	1	4
37049	50938	9	3	2	0	0	5
37049	214474	8	1	0	1	0	2
37049	215726	8	2	2	0	1	5
37049	293101	8	2	1	0	2	5
37049	293103	8	2	1	0	4	7
37049	371078	8	1	2	2	4	9
37049	371084	8	3	0	0	0	3
37049	371129	8	2	7	0	1	10
37049	371135	8	1	0	0	0	1
37049	52496	8	2	1	0	4	7
37049	219836	7	1	0	0	0	1
37049	293099	7	1	3	0	3	7
37049	293109	7	1	3	0	2	6
37049	371065	7	1	1	0	0	2
37049	371072	7	0	0	0	3	3
37049	371074	7	1	2	0	0	3
37049	371091	7	0	3	0	0	3
37049	371095	7	2	4	0	0	6
37049	371097	7	1	1	0	0	2
37049	371110	7	0	0	0	0	0
37049	371123	7	0	0	2	0	2
37049	371137	7	0	2	0	0	2
37049	57148	7	2	2	1	1	6
37049	87991	7	1	3	0	3	7
37049	183403	6	1	0	0	0	1
37049	186855	6	3	1	0	0	4
37049	188235	6	2	0	0	1	3
37049	191160	6	2	0	0	1	3
37049	211256	6	1	2	0	1	4
37049	213374	6	1	0	0	0	1
37049	213901	6	1	1	0	3	5
37049	214439	6	0	1	0	0	1
37049	293108	6	0	5	0	2	7
37049	293110	6	2	2	0	4	8
37049	371077	6	3	1	0	1	5
37049	371079	6	2	0	0	2	4
37049	371085	6	0	2	0	1	3
37049	371099	6	4	0	0	0	4
37049	371105	6	1	2	0	1	4
37049	55181	6	2	1	1	0	4
37049	62215	6	0	5	0	2	7
37049	188495	5	0	0	0	1	1
37049	202210	5	0	2	0	1	3
37049	209243	5	0	1	0	0	1
37049	209592	5	0	1	0	4	5
37049	212877	5	0	0	0	1	1
37049	217464	5	0	0	0	1	1
37049	293102	5	0	0	1	0	1
37049	371066	5	1	0	0	0	1
37049	371088	5	2	1	0	0	3
37049	371090	5	1	1	1	0	3
37049	371101	5	1	3	0	0	4
37049	371116	5	2	3	0	3	8
37049	71207	5	0	0	1	0	1
37049	193177	4	0	3	1	2	6
37049	199198	4	0	0	0	0	0
37049	293100	4	1	1	0	2	4
37049	293104	4	1	2	1	3	7
37049	371070	4	2	2	0	2	6
37049	371071	4	1	3	1	1	6
37049	371073	4	0	1	1	1	3
37049	371081	4	1	1	0	0	2
37049	371087	4	1	0	0	0	1
37049	371096	4	1	0	0	0	1
37049	371100	4	0	1	0	0	1
37049	371103	4	2	1	0	3	6
37049	371108	4	0	1	1	0	2
37049	371112	4	3	4	0	0	7
37049	371115	4	0	1	1	1	3
37049	371130	4	0	2	0	1	3
37049	371132	4	1	0	0	2	3
37049	371133	4	2	4	0	2	8
37049	371136	4	1	1	0	1	3
37049	371139	4	2	2	0	1	5
37049	57447	4	0	0	0	0	0
37049	87738	4	1	1	0	2	4
37049	185855	3	0	1	1	1	3
37049	195572	3	1	0	0	0	1
37049	201325	3	2	0	0	1	3
37049	201565	3	1	0	0	2	3
37049	203016	3	1	2	0	0	3
37049	206267	3	1	0	0	1	2
37049	207530	3	1	1	0	1	3
37049	207839	3	2	0	0	0	2
37049	214072	3	1	0	0	1	2
37049	218007	3	1	3	0	0	4
37049	371069	3	0	2	0	0	2
37049	371086	3	1	2	0	2	5
37049	371093	3	0	0	0	0	0
37049	371094	3	0	0	1	2	3
37049	371111	3	2	0	0	0	2
37049	371117	3	0	0	0	0	0
37049	371120	3	0	1	1	1	3
37049	371121	3	0	0	1	1	2
37049	371122	3	0	1	0	0	1
37049	371126	3	1	0	1	0	2
37049	371134	3	1	0	0	0	1
37049	371138	3	1	1	0	0	2
37049	63513	3	0	0	0	3	3
37049	88807	3	0	0	0	2	2
37049	187185	2	0	1	0	1	2
37049	196004	2	0	0	0	0	0
37049	199955	2	0	1	0	0	1
37049	210598	2	0	0	0	1	1
37049	212804	2	2	0	0	0	2
37049	215405	2	1	0	0	0	1
37049	216086	2	0	0	0	0	0
37049	218602	2	1	1	0	1	3
37049	293105	2	0	1	0	0	1
37049	371067	2	1	1	0	1	3
37049	371076	2	0	0	0	0	0
37049	371082	2	1	0	0	0	1
37049	371102	2	2	1	0	0	3
37049	371114	2	0	0	0	0	0
37049	371118	2	0	0	1	0	1
37049	371127	2	3	0	0	1	4
37049	371131	2	0	0	0	1	1
37049	90230	2	0	1	0	0	1
37049	195614	1	0	1	0	0	1
37049	207294	1	0	0	0	0	0
37049	371092	1	0	1	0	3	4
37049	371106	1	2	4	1	0	7
28098	50567	33	3	4	2	2	11
28098	100454	32	1	3	2	0	6
28098	79878	30	3	9	2	2	16
28098	407436	26	3	4	0	0	7
28098	75312	26	3	4	0	0	7
28098	103684	23	1	1	0	0	2
28098	99859	18	0	2	0	0	2
28098	407438	17	0	2	0	0	2
28098	181970	16	0	3	0	0	3
28098	186841	16	4	9	1	1	15
28098	290580	16	2	5	1	6	14
28098	407428	16	2	5	1	6	14
28098	407443	16	4	9	1	1	15
28098	50072	16	2	5	1	6	14
28098	57073	16	4	9	1	1	15
28098	58090	16	0	2	1	0	3
28098	623037	16	0	3	0	0	3
28098	59608	15	1	4	0	0	5
28098	65422	15	4	1	0	2	7
28098	187736	14	2	4	0	4	10
28098	58969	14	4	4	0	4	12
28098	67045	14	6	3	0	0	9
28098	74771	14	1	2	0	0	3
28098	82013	14	0	3	0	2	5
28098	198103	13	1	2	0	0	3
28098	73700	13	1	2	0	0	3
28098	290578	12	2	1	0	1	4
28098	290587	12	2	2	0	2	6
28098	623048	12	0	4	0	2	6
28098	78762	12	2	2	0	2	6
28098	98717	12	2	3	1	0	6
28098	290589	11	1	0	0	0	1
28098	407431	11	0	3	0	0	3
28098	51842	11	0	2	0	0	2
28098	623049	11	2	5	0	0	7
28098	80738	11	1	0	0	0	1
28098	97157	11	1	4	0	1	6
28098	407420	10	1	3	0	1	5
28098	57017	10	1	3	0	0	4
28098	63063	10	4	1	0	1	6
28098	92154	10	4	2	0	0	6
28098	98201	10	2	6	1	0	9
28098	107432	9	1	0	0	1	2
28098	193361	9	1	4	0	0	5
28098	207391	9	3	2	0	0	5
28098	220125	9	1	0	0	1	2
28098	407442	9	1	0	0	1	2
28098	407445	9	3	2	0	0	5
28098	61033	9	4	2	0	1	7
28098	623043	9	3	3	1	2	9
28098	67169	9	1	1	0	1	3
28098	86729	9	3	2	0	0	5
28098	97188	9	3	2	0	0	5
28098	102771	8	0	4	0	0	4
28098	106891	8	1	2	0	0	3
28098	220090	8	1	2	0	0	3
28098	221246	8	0	1	0	1	2
28098	290584	8	0	3	0	0	3
28098	290588	8	1	2	0	0	3
28098	407444	8	1	2	0	0	3
28098	61864	8	1	0	0	1	2
28098	623046	8	1	4	0	0	5
28098	102495	7	2	4	0	1	7
28098	195118	7	0	2	0	0	2
28098	205730	7	0	0	0	0	0
28098	290576	7	2	0	0	0	2
28098	407432	7	0	2	0	1	3
28098	407437	7	0	0	0	0	0
28098	407441	7	3	3	0	0	6
28098	75583	7	3	4	0	0	7
28098	76104	7	0	1	0	0	1
28098	89786	7	1	5	0	1	7
28098	201928	6	1	1	0	0	2
28098	214739	6	1	3	0	0	4
28098	290581	6	0	0	0	0	0
28098	290585	6	0	0	0	0	0
28098	407430	6	3	1	0	2	6
28098	407434	6	1	1	0	0	2
28098	55068	6	1	2	0	0	3
28098	623031	6	0	2	0	0	2
28098	623047	6	1	1	0	0	2
28098	62356	6	2	2	0	0	4
28098	71237	6	0	0	0	0	0
28098	81233	6	1	1	0	0	2
28098	83457	6	0	0	0	0	0
28098	189749	5	1	5	0	0	6
28098	290586	5	1	5	0	0	6
28098	407424	5	0	3	0	0	3
28098	407425	5	0	1	1	0	2
28098	49957	5	0	0	0	0	0
28098	623034	5	0	2	0	0	2
28098	623042	5	1	2	0	2	5
28098	623044	5	0	3	0	0	3
28098	623050	5	1	3	0	0	4
28098	81721	5	2	1	0	0	3
28098	81967	5	2	1	0	0	3
28098	85634	5	0	2	0	1	3
28098	104601	4	1	3	0	0	4
28098	290583	4	1	1	0	0	2
28098	407422	4	2	3	0	0	5
28098	407429	4	1	0	0	0	1
28098	407447	4	0	1	0	0	1
28098	61635	4	0	3	0	0	3
28098	623035	4	1	0	2	0	3
28098	623041	4	0	0	0	1	1
28098	67842	4	1	1	0	0	2
28098	88804	4	0	0	1	0	1
28098	90750	4	1	1	0	0	2
28098	95713	4	0	0	0	0	0
28098	210059	3	0	1	0	1	2
28098	290577	3	0	0	0	0	0
28098	407421	3	0	3	0	2	5
28098	407423	3	1	1	0	0	2
28098	407427	3	3	4	0	0	7
28098	407435	3	0	1	0	0	1
28098	407439	3	1	0	0	1	2
28098	407440	3	1	1	0	0	2
28098	407446	3	0	0	0	0	0
28098	623030	3	1	1	0	0	2
28098	623032	3	1	2	0	0	3
28098	623036	3	1	1	0	2	4
28098	623038	3	1	0	0	0	1
28098	623039	3	2	0	0	1	3
28098	623040	3	1	0	0	0	1
28098	71693	3	0	0	0	0	0
28098	78507	3	0	1	0	0	1
28098	99246	3	1	2	0	0	3
28098	185319	2	0	0	0	0	0
28098	196569	2	0	2	0	0	2
28098	221127	2	1	0	0	0	1
28098	221128	2	1	0	0	0	1
28098	221501	2	1	1	0	0	2
28098	407418	2	0	1	0	0	1
28098	407426	2	0	1	0	0	1
28098	59546	2	1	1	0	0	2
28098	209367	1	0	1	0	0	1
28098	213580	1	1	3	0	0	4
28098	407419	1	1	3	0	0	4
28098	407433	1	0	2	0	0	2
28098	54474	1	0	1	0	0	1
28098	623033	1	0	1	0	1	2
28098	623045	1	0	3	0	3	6
28098	66720	1	0	0	0	0	0
51817	185426	25	4	5	0	0	9
51817	457689	25	0	3	0	0	3
51817	457725	25	4	5	0	0	9
51817	457726	19	1	5	4	1	11
51817	296924	17	3	3	0	0	6
51817	188894	14	2	2	1	1	6
51817	96630	14	0	2	0	2	4
51817	100615	13	5	7	0	2	14
51817	296928	13	2	2	1	1	6
51817	457687	13	3	1	0	2	6
51817	457704	13	1	2	0	0	3
51817	59902	13	2	2	1	1	6
51817	457699	12	4	7	0	0	11
51817	457757	12	2	5	0	0	7
51817	220189	11	0	0	0	1	1
51817	457742	11	0	3	2	3	8
51817	457762	11	0	3	2	3	8
51817	206313	10	1	1	1	1	4
51817	457746	9	3	1	0	1	5
51817	296920	8	3	2	4	1	10
51817	457686	8	0	2	4	2	8
51817	457693	8	2	4	2	2	10
51817	457708	8	0	0	0	0	0
51817	457724	8	2	1	0	0	3
51817	52532	8	3	2	4	1	10
51817	101151	7	0	2	0	2	4
51817	296919	7	1	1	1	0	3
51817	296923	7	0	2	0	2	4
51817	457700	7	2	6	0	0	8
51817	457702	7	1	0	0	0	1
51817	457717	7	4	7	0	2	13
51817	457733	7	1	3	0	0	4
51817	457747	7	3	3	0	0	6
51817	457755	7	1	3	0	0	4
51817	457756	7	3	1	0	0	4
51817	457759	7	3	2	4	2	11
51817	457760	7	1	0	0	0	1
51817	90997	7	1	1	1	0	3
51817	100087	6	3	0	2	0	5
51817	102161	6	3	0	0	1	4
51817	213339	6	2	3	0	1	6
51817	214780	6	3	0	0	1	4
51817	296911	6	3	0	2	0	5
51817	296922	6	3	0	0	1	4
51817	457688	6	1	0	1	0	2
51817	457694	6	1	0	3	4	8
51817	457715	6	1	3	0	1	5
51817	457749	6	1	1	1	0	3
51817	457752	6	1	2	1	0	4
51817	101812	5	1	1	0	2	4
51817	208029	5	1	0	0	1	2
51817	296914	5	1	1	0	2	4
51817	296915	5	1	2	1	0	4
51817	296918	5	1	3	0	1	5
51817	296926	5	0	1	0	2	3
51817	457697	5	1	2	0	0	3
51817	457719	5	1	1	0	0	2
51817	457723	5	1	2	0	1	4
51817	457727	5	0	1	0	0	1
51817	457737	5	0	0	0	1	1
51817	457764	5	1	0	0	2	3
51817	457769	5	0	1	0	0	1
51817	457770	5	0	0	0	0	0
51817	457772	5	1	2	0	0	3
51817	51035	5	1	2	1	0	4
51817	184561	4	1	3	0	0	4
51817	190246	4	0	3	0	0	3
51817	192272	4	1	2	0	0	3
51817	198526	4	3	1	0	0	4
51817	205509	4	1	0	0	0	1
51817	214660	4	2	3	0	0	5
51817	218494	4	1	0	0	1	2
51817	296913	4	0	1	0	0	1
51817	296921	4	1	0	0	1	2
51817	457684	4	1	0	0	0	1
51817	457690	4	0	1	0	1	2
51817	457691	4	0	1	0	1	2
51817	457692	4	0	1	0	1	2
51817	457695	4	0	0	0	1	1
51817	457698	4	1	1	0	0	2
51817	457707	4	1	1	0	0	2
51817	457713	4	1	0	0	0	1
51817	457722	4	0	2	0	0	2
51817	457730	4	4	4	2	0	10
51817	457731	4	1	2	0	0	3
51817	457736	4	0	0	0	1	1
51817	457740	4	0	2	0	0	2
51817	457745	4	1	0	0	0	1
51817	457753	4	1	1	0	0	2
51817	457754	4	2	3	0	0	5
51817	457763	4	2	2	0	1	5
51817	457768	4	5	1	1	2	9
51817	457771	4	2	0	0	1	3
51817	183188	3	0	2	0	0	2
51817	184062	3	0	0	0	1	1
51817	196534	3	0	0	0	0	0
51817	199243	3	0	0	0	0	0
51817	204477	3	0	2	0	1	3
51817	208778	3	2	2	0	0	4
51817	296912	3	1	0	0	0	1
51817	296916	3	2	3	0	0	5
51817	296917	3	1	2	0	1	4
51817	296927	3	0	2	0	4	6
51817	457685	3	0	0	0	2	2
51817	457701	3	0	0	1	0	1
51817	457705	3	0	2	0	0	2
51817	457709	3	0	1	0	0	1
51817	457710	3	0	0	1	0	1
51817	457714	3	1	1	0	0	2
51817	457718	3	0	0	0	0	0
51817	457729	3	2	2	0	0	4
51817	457734	3	2	2	0	3	7
51817	457735	3	1	1	0	1	3
51817	457738	3	1	1	0	1	3
51817	457739	3	0	0	0	1	1
51817	457741	3	3	0	0	0	3
51817	457750	3	0	1	0	0	1
51817	457765	3	0	2	0	4	6
51817	457766	3	0	2	0	0	2
51817	53737	3	1	2	0	1	4
51817	90251	3	2	3	0	0	5
51817	186453	2	1	0	0	0	1
51817	195800	2	2	1	0	0	3
51817	205638	2	1	1	0	0	2
51817	207524	2	0	4	1	0	5
51817	218670	2	0	1	0	0	1
51817	296925	2	0	0	1	0	1
51817	296929	2	1	1	0	0	2
51817	457696	2	1	0	0	0	1
51817	457703	2	1	0	0	1	2
51817	457706	2	1	2	1	0	4
51817	457711	2	1	0	0	1	2
51817	457712	2	2	1	0	0	3
51817	457721	2	0	2	0	0	2
51817	457732	2	1	1	0	0	2
51817	457748	2	1	1	0	0	2
51817	457758	2	0	0	0	0	0
51817	457761	2	0	2	0	0	2
51817	457767	2	3	1	0	0	4
51817	214384	1	0	3	0	1	4
51817	457716	1	0	0	0	0	0
51817	457720	1	1	1	0	1	3
51817	457728	1	1	0	0	3	4
51817	457743	1	1	0	0	0	1
51817	457744	1	1	0	0	0	1
58214	93149	35	4	6	0	2	12
58214	603330	32	2	3	2	0	7
58214	210672	29	0	6	1	0	7
58214	603311	25	0	6	1	0	7
58214	106763	20	3	2	0	0	5
58214	198922	19	0	3	0	2	5
58214	298425	19	0	3	0	2	5
58214	74500	19	0	3	0	2	5
58214	200587	17	1	2	0	0	3
58214	298422	17	1	2	0	0	3
58214	603313	17	0	1	0	2	3
58214	78813	17	1	2	0	0	3
58214	91836	17	0	1	0	2	3
58214	603293	16	0	4	0	2	6
58214	51287	14	0	1	0	0	1
58214	603309	14	0	1	0	0	1
58214	603317	14	1	2	0	0	3
58214	603318	14	1	2	0	0	3
58214	188353	13	0	4	1	1	6
58214	603301	13	0	2	0	0	2
58214	298441	12	4	2	0	1	7
58214	194905	10	1	1	0	0	2
58214	298424	10	2	3	1	0	6
58214	603329	10	1	1	0	1	3
58214	200491	9	0	0	0	0	0
58214	603316	9	0	0	0	0	0
58214	603331	9	1	1	0	1	3
58214	75086	9	3	1	0	0	4
58214	98163	9	1	0	1	1	3
58214	217546	8	3	1	0	2	6
58214	298440	8	0	1	0	2	3
58214	59292	8	1	1	0	0	2
58214	76967	8	0	1	0	2	3
58214	203245	7	0	1	0	0	1
58214	210528	7	0	0	0	0	0
58214	213011	7	1	3	0	0	4
58214	55512	7	0	0	1	0	1
58214	603327	7	4	2	1	0	7
58214	89913	7	1	2	0	1	4
58214	101170	6	0	0	0	1	1
58214	104206	6	0	0	0	1	1
58214	190399	6	3	5	0	2	10
58214	210967	6	0	0	2	0	2
58214	217050	6	0	0	0	1	1
58214	217260	6	0	0	0	0	0
58214	298434	6	0	0	0	1	1
58214	298437	6	0	0	0	1	1
58214	298442	6	1	1	1	0	3
58214	298444	6	0	1	0	2	3
58214	49337	6	0	1	0	2	3
58214	602738	6	0	2	0	1	3
58214	603310	6	0	0	0	1	1
58214	603320	6	0	0	0	1	1
58214	103239	5	0	0	0	1	1
58214	106227	5	1	2	1	0	4
58214	204881	5	2	1	0	0	3
58214	204882	5	2	1	0	0	3
58214	212812	5	0	0	0	0	0
58214	218712	5	0	1	0	1	2
58214	218866	5	1	0	1	0	2
58214	219685	5	1	2	1	0	4
58214	298430	5	1	0	1	0	2
58214	298431	5	3	0	0	0	3
58214	298438	5	0	0	0	1	1
58214	298439	5	0	0	0	0	0
58214	53756	5	3	0	0	0	3
58214	602736	5	0	0	0	0	0
58214	603303	5	2	2	0	0	4
58214	603307	5	2	2	0	0	4
58214	603308	5	0	2	0	3	5
58214	603314	5	0	0	0	0	0
58214	603325	5	1	0	0	0	1
58214	603340	5	0	0	0	0	0
58214	184849	4	2	1	0	2	5
58214	184850	4	2	1	0	2	5
58214	184963	4	0	1	0	0	1
58214	193876	4	2	3	0	0	5
58214	198376	4	0	1	0	0	1
58214	205433	4	0	1	0	1	2
58214	220175	4	0	1	0	0	1
58214	221609	4	0	1	0	2	3
58214	298426	4	1	1	0	4	6
58214	298427	4	1	2	0	0	3
58214	298428	4	2	3	0	0	5
58214	298429	4	0	1	0	0	1
58214	298433	4	0	1	0	0	1
58214	298436	4	2	1	0	2	5
58214	54296	4	2	1	0	2	5
58214	602739	4	0	2	0	0	2
58214	603298	4	1	2	0	0	3
58214	603312	4	1	1	0	0	2
58214	603323	4	1	0	0	1	2
58214	603324	4	0	1	0	0	1
58214	603332	4	0	1	0	0	1
58214	603334	4	1	0	0	0	1
58214	603336	4	0	3	0	0	3
58214	61348	4	1	2	0	0	3
58214	84737	4	0	1	0	0	1
58214	89044	4	2	3	0	0	5
58214	184443	3	1	0	0	0	1
58214	191101	3	0	0	0	1	1
58214	207444	3	1	2	0	0	3
58214	212664	3	2	2	0	0	4
58214	298423	3	0	1	0	0	1
58214	298432	3	0	1	0	0	1
58214	602737	3	0	0	0	0	0
58214	603294	3	1	2	0	0	3
58214	603299	3	0	1	0	0	1
58214	603304	3	0	2	0	0	2
58214	603305	3	0	1	0	0	1
58214	603319	3	2	2	0	0	4
58214	603322	3	1	0	0	4	5
58214	603326	3	0	1	0	0	1
58214	603333	3	0	0	0	0	0
58214	603335	3	0	1	0	2	3
58214	603337	3	0	2	0	0	2
58214	79570	3	0	1	0	0	1
58214	99623	3	0	1	0	0	1
58214	183812	2	0	3	0	0	3
58214	196647	2	0	1	0	0	1
58214	204500	2	0	1	0	0	1
58214	218760	2	0	0	0	0	0
58214	218792	2	0	0	0	0	0
58214	298435	2	0	0	0	0	0
58214	298443	2	1	0	0	0	1
58214	603292	2	1	3	0	0	4
58214	603302	2	0	1	0	1	2
58214	603306	2	0	0	0	0	0
58214	603315	2	1	1	0	0	2
58214	603321	2	1	0	0	2	3
58214	603328	2	0	1	0	0	1
58214	603338	2	0	1	0	0	1
58214	603339	2	0	0	0	0	0
58214	603341	2	0	0	0	0	0
58214	200315	1	1	0	0	0	1
58214	211192	1	0	0	0	0	0
58214	219937	1	0	1	0	0	1
58214	603295	1	0	1	0	2	3
58214	603296	1	0	1	0	0	1
58214	603297	1	0	0	0	0	0
58214	603300	1	0	3	0	2	5
3978	496470	18	0	0	2	0	2
3978	283889	16	2	2	0	1	5
3978	496485	9	4	5	0	0	9
3978	221808	8	2	2	0	1	5
3978	283893	8	2	1	1	1	5
3978	496448	8	0	2	0	0	2
3978	496453	8	1	3	1	0	5
3978	496389	7	0	0	0	0	0
3978	496413	7	1	1	1	0	3
3978	496445	7	1	0	0	0	1
3978	496449	7	1	1	0	0	2
3978	496474	7	0	0	0	0	0
3978	496477	7	1	1	0	0	2
3978	496406	6	1	1	0	0	2
3978	496423	6	2	3	0	1	6
3978	496434	6	1	2	0	0	3
3978	496446	6	2	2	0	0	4
3978	496466	6	1	1	0	0	2
3978	216836	5	0	5	0	0	5
3978	283888	5	1	2	0	0	3
3978	283891	5	0	1	0	0	1
3978	283894	5	0	0	0	1	1
3978	283898	5	0	2	0	0	2
3978	496372	5	1	2	1	0	4
3978	496403	5	1	1	0	2	4
3978	496405	5	2	0	0	1	3
3978	496408	5	1	2	0	0	3
3978	496412	5	0	1	0	0	1
3978	496415	5	0	1	0	0	1
3978	496418	5	0	1	0	0	1
3978	496425	5	0	3	0	1	4
3978	496432	5	2	1	0	0	3
3978	496443	5	0	1	1	0	2
3978	496457	5	1	0	0	0	1
3978	496459	5	2	1	0	2	5
3978	496472	5	1	1	0	0	2
3978	496473	5	0	2	0	0	2
3978	186633	4	2	1	0	0	3
3978	189784	4	0	1	0	2	3
3978	202707	4	0	3	0	0	3
3978	283890	4	1	2	0	0	3
3978	283892	4	0	0	1	0	1
3978	496373	4	2	1	0	0	3
3978	496377	4	1	2	0	0	3
3978	496381	4	2	1	0	0	3
3978	496394	4	1	1	0	0	2
3978	496407	4	1	1	0	0	2
3978	496409	4	1	2	0	1	4
3978	496416	4	0	2	0	0	2
3978	496417	4	1	3	2	1	7
3978	496430	4	1	0	0	0	1
3978	496435	4	0	3	0	1	4
3978	496437	4	0	0	0	0	0
3978	496439	4	2	2	0	2	6
3978	496450	4	1	1	0	0	2
3978	496452	4	0	2	1	0	3
3978	496460	4	1	1	0	0	2
3978	496465	4	0	3	0	1	4
3978	496483	4	0	0	0	0	0
3978	496484	4	0	2	0	0	2
3978	185628	3	1	2	0	0	3
3978	190314	3	0	0	0	0	0
3978	206228	3	0	1	0	0	1
3978	217220	3	0	2	0	0	2
3978	283895	3	0	2	0	0	2
3978	283896	3	1	1	0	0	2
3978	496378	3	1	2	0	4	7
3978	496379	3	0	2	1	0	3
3978	496380	3	0	0	0	0	0
3978	496382	3	0	0	0	0	0
3978	496390	3	1	1	0	0	2
3978	496392	3	0	0	0	0	0
3978	496393	3	0	0	1	0	1
3978	496395	3	0	0	0	0	0
3978	496397	3	0	1	0	0	1
3978	496398	3	1	1	0	0	2
3978	496401	3	0	2	0	0	2
3978	496404	3	1	1	0	0	2
3978	496419	3	2	1	0	1	4
3978	496420	3	1	2	0	1	4
3978	496421	3	1	2	0	0	3
3978	496426	3	1	0	0	1	2
3978	496431	3	0	1	0	0	1
3978	496442	3	1	1	0	1	3
3978	496455	3	0	2	0	0	2
3978	496456	3	0	2	0	0	2
3978	496458	3	0	2	0	0	2
3978	496462	3	1	1	0	0	2
3978	496463	3	0	0	0	0	0
3978	496467	3	1	1	0	0	2
3978	496468	3	0	0	0	0	0
3978	496469	3	0	2	0	0	2
3978	496475	3	1	1	0	0	2
3978	496480	3	1	1	0	0	2
3978	190033	2	0	1	0	0	1
3978	195935	2	0	2	0	0	2
3978	200129	2	0	0	0	0	0
3978	203079	2	0	1	0	0	1
3978	220992	2	0	1	0	0	1
3978	283897	2	0	0	0	0	0
3978	496374	2	0	0	0	0	0
3978	496384	2	2	5	0	1	8
3978	496387	2	0	1	0	0	1
3978	496388	2	0	2	0	0	2
3978	496399	2	0	2	0	0	2
3978	496400	2	1	0	0	0	1
3978	496402	2	0	1	0	0	1
3978	496411	2	0	0	0	2	2
3978	496422	2	2	0	0	0	2
3978	496424	2	0	3	0	0	3
3978	496427	2	1	0	0	0	1
3978	496429	2	0	0	0	1	1
3978	496436	2	0	0	0	0	0
3978	496438	2	0	0	0	0	0
3978	496440	2	0	0	0	0	0
3978	496444	2	1	1	0	0	2
3978	496447	2	1	0	0	0	1
3978	496451	2	0	2	0	0	2
3978	496454	2	2	1	0	0	3
3978	496461	2	0	0	0	0	0
3978	496471	2	1	3	0	0	4
3978	496476	2	1	0	0	1	2
3978	496479	2	1	2	0	0	3
3978	496481	2	0	2	0	0	2
3978	496482	2	1	2	0	0	3
3978	185734	1	0	1	1	0	2
3978	193914	1	0	0	0	0	0
3978	207826	1	0	2	0	0	2
3978	218661	1	0	1	0	0	1
3978	496375	1	1	1	1	0	3
3978	496376	1	0	2	0	1	3
3978	496385	1	0	0	0	0	0
3978	496386	1	0	0	0	0	0
3978	496391	1	0	1	0	0	1
3978	496396	1	0	2	0	0	2
3978	496410	1	0	0	0	0	0
3978	496414	1	1	1	0	0	2
3978	496428	1	0	0	0	0	0
3978	496433	1	0	3	0	0	3
3978	496441	1	0	3	0	0	3
3978	496464	1	0	0	0	0	0
3978	496478	1	0	0	0	0	0
45203	191663	26	3	2	1	1	7
45203	391895	20	1	1	1	1	4
45203	391808	16	1	0	1	1	3
45203	391911	15	1	1	0	1	3
45203	97476	15	2	2	0	5	9
45203	212177	10	2	1	0	1	4
45203	391811	10	2	1	0	1	4
45203	391812	10	2	1	0	1	4
45203	391910	10	1	1	2	1	5
45203	391916	10	0	0	0	1	1
45203	391814	9	1	0	3	1	5
45203	391815	9	1	0	3	1	5
45203	391828	9	0	2	1	2	5
45203	391879	9	3	0	0	3	6
45203	391835	8	1	7	1	2	11
45203	391836	8	4	3	2	1	10
45203	391871	8	0	1	0	1	2
45203	391880	8	2	2	0	2	6
45203	391888	8	0	0	2	1	3
45203	391890	8	2	0	0	0	2
45203	391893	8	2	3	0	1	6
45203	391924	8	0	1	0	1	2
45203	391926	8	3	1	0	0	4
45203	295342	7	2	1	0	1	4
45203	391897	7	1	0	0	0	1
45203	391920	7	1	0	0	1	2
45203	76823	7	2	1	0	1	4
45203	185694	6	0	1	0	1	2
45203	191587	6	0	2	0	0	2
45203	203050	6	2	0	0	2	4
45203	218708	6	2	1	0	6	9
45203	295340	6	0	1	0	1	2
45203	391818	6	2	0	0	2	4
45203	391819	6	2	3	2	1	8
45203	391824	6	0	0	0	0	0
45203	391825	6	0	0	0	0	0
45203	391839	6	1	1	0	1	3
45203	391844	6	0	2	1	4	7
45203	391845	6	1	1	0	3	5
45203	391847	6	3	0	0	0	3
45203	391849	6	1	0	3	2	6
45203	391882	6	2	1	0	0	3
45203	391896	6	0	0	2	2	4
45203	391900	6	2	0	1	2	5
45203	391905	6	2	0	0	0	2
45203	391908	6	1	1	0	0	2
45203	391909	6	1	5	1	0	7
45203	62837	6	0	1	0	1	2
45203	207275	5	0	1	0	1	2
45203	391810	5	1	0	0	0	1
45203	391822	5	1	1	0	1	3
45203	391833	5	1	3	0	0	4
45203	391840	5	0	0	2	0	2
45203	391852	5	0	0	0	1	1
45203	391872	5	4	0	0	3	7
45203	391873	5	2	0	0	0	2
45203	391876	5	1	0	0	2	3
45203	391881	5	0	1	0	0	1
45203	391903	5	0	0	0	0	0
45203	391921	5	0	0	1	0	1
45203	391923	5	0	0	0	2	2
45203	391925	5	0	1	0	1	2
45203	205832	4	3	1	0	0	4
45203	207836	4	1	1	1	1	4
45203	391817	4	1	2	0	0	3
45203	391820	4	0	2	0	1	3
45203	391823	4	0	0	0	0	0
45203	391826	4	3	1	1	1	6
45203	391831	4	1	0	0	2	3
45203	391832	4	2	2	0	2	6
45203	391838	4	0	0	0	0	0
45203	391846	4	0	0	0	0	0
45203	391848	4	0	1	1	0	2
45203	391854	4	1	1	0	1	3
45203	391855	4	2	0	0	0	2
45203	391859	4	0	0	0	1	1
45203	391868	4	0	0	0	1	1
45203	391885	4	0	1	0	0	1
45203	391889	4	0	1	0	1	2
45203	391906	4	0	0	0	2	2
45203	391912	4	2	1	0	3	6
45203	198598	3	0	0	0	1	1
45203	213996	3	1	1	0	0	2
45203	214266	3	0	0	1	0	1
45203	295339	3	1	0	0	1	2
45203	391816	3	2	1	0	2	5
45203	391827	3	1	1	0	2	4
45203	391841	3	0	1	0	1	2
45203	391842	3	0	1	0	1	2
45203	391843	3	2	0	0	0	2
45203	391850	3	1	3	0	1	5
45203	391856	3	0	2	0	1	3
45203	391863	3	1	1	0	0	2
45203	391864	3	0	0	0	1	1
45203	391866	3	1	0	0	0	1
45203	391867	3	0	0	0	2	2
45203	391869	3	0	1	0	0	1
45203	391877	3	0	1	1	0	2
45203	391884	3	0	0	0	1	1
45203	391886	3	1	0	0	1	2
45203	391887	3	1	0	0	1	2
45203	391891	3	1	0	0	1	2
45203	391892	3	1	0	1	0	2
45203	391899	3	1	0	0	0	1
45203	391902	3	0	0	0	1	1
45203	391913	3	1	2	0	0	3
45203	391917	3	0	2	0	0	2
45203	391922	3	1	0	0	0	1
45203	194811	2	0	0	0	0	0
45203	199805	2	0	0	0	0	0
45203	208131	2	1	0	0	1	2
45203	295338	2	0	1	0	0	1
45203	391809	2	1	2	0	0	3
45203	391821	2	0	2	0	1	3
45203	391829	2	0	1	0	1	2
45203	391830	2	1	0	0	2	3
45203	391834	2	0	0	0	0	0
45203	391837	2	2	0	0	3	5
45203	391851	2	0	1	0	0	1
45203	391853	2	1	0	0	1	2
45203	391857	2	0	0	0	1	1
45203	391858	2	2	1	0	1	4
45203	391860	2	2	1	0	1	4
45203	391862	2	0	1	0	0	1
45203	391865	2	0	0	1	1	2
45203	391874	2	0	1	0	0	1
45203	391875	2	1	0	0	1	2
45203	391878	2	3	1	0	0	4
45203	391883	2	3	0	0	1	4
45203	391894	2	0	2	0	0	2
45203	391898	2	1	0	0	1	2
45203	391901	2	0	1	1	2	4
45203	391904	2	0	0	0	0	0
45203	391907	2	0	1	0	1	2
45203	391914	2	0	0	0	0	0
45203	391915	2	0	1	0	0	1
45203	391918	2	0	0	0	0	0
45203	84722	2	0	1	0	0	1
45203	196511	1	0	0	0	0	0
45203	295341	1	0	0	0	0	0
45203	391861	1	1	1	0	0	2
45203	391870	1	0	1	0	2	3
45203	391919	1	0	0	0	1	1
20259	288644	28	1	2	1	0	4
20259	71463	28	1	2	1	0	4
20259	99515	28	4	2	0	1	7
20259	98557	27	5	3	1	1	10
20259	288650	26	0	2	0	0	2
20259	443809	25	0	2	0	0	2
20259	103457	24	1	2	0	0	3
20259	80944	24	1	2	0	0	3
20259	288649	17	4	3	1	5	13
20259	63285	17	4	3	1	5	13
20259	288646	14	0	1	0	0	1
20259	68902	14	0	1	0	0	1
20259	288643	13	2	4	0	0	6
20259	288648	13	0	6	3	0	9
20259	88633	13	0	5	3	0	8
20259	105869	9	0	1	0	0	1
20259	219289	9	0	1	0	0	1
20259	443759	9	0	1	0	0	1
20259	443793	9	1	4	0	1	6
20259	443796	9	0	2	0	0	2
20259	66606	9	1	2	0	0	3
20259	68966	8	0	0	0	0	0
20259	74253	8	1	2	2	0	5
20259	90164	8	0	4	0	0	4
20259	98113	8	3	3	0	0	6
20259	102027	7	0	1	0	0	1
20259	288647	7	0	0	0	0	0
20259	97469	7	1	0	0	1	2
20259	188282	6	0	2	1	1	4
20259	288642	6	1	2	0	0	3
20259	443737	6	0	0	0	0	0
20259	443741	6	0	1	0	1	2
20259	443755	6	0	1	0	0	1
20259	443760	6	3	2	0	0	5
20259	443763	6	0	3	0	0	3
20259	443772	6	0	1	0	0	1
20259	443814	6	4	1	0	0	5
20259	56001	6	1	2	0	0	3
20259	288639	5	2	0	0	0	2
20259	443731	5	2	0	0	0	2
20259	443758	5	0	2	0	0	2
20259	443764	5	1	1	0	2	4
20259	71637	5	2	0	0	0	2
20259	443770	4	1	1	0	0	2
20259	443776	4	1	3	0	0	4
20259	443777	4	2	1	0	0	3
20259	443798	4	2	1	0	0	3
20259	443802	4	1	0	0	0	1
20259	443806	4	2	1	0	0	3
20259	56281	4	1	3	0	0	4
20259	105240	3	0	1	0	1	2
20259	221944	3	2	1	0	0	3
20259	288640	3	1	1	0	0	2
20259	288641	3	0	0	0	0	0
20259	443726	3	0	1	0	0	1
20259	443728	3	0	1	0	1	2
20259	443732	3	0	2	0	0	2
20259	443739	3	1	2	0	1	4
20259	443740	3	1	1	0	1	3
20259	443744	3	0	0	0	0	0
20259	443745	3	0	0	0	0	0
20259	443749	3	0	3	0	0	3
20259	443750	3	0	3	0	0	3
20259	443754	3	1	3	0	1	5
20259	443765	3	1	0	0	0	1
20259	443767	3	1	1	0	0	2
20259	443768	3	0	0	0	0	0
20259	443769	3	0	0	0	0	0
20259	443773	3	1	1	0	0	2
20259	443775	3	0	1	0	0	1
20259	443779	3	0	0	0	0	0
20259	443783	3	0	1	0	2	3
20259	443788	3	1	1	0	0	2
20259	443790	3	0	1	0	0	1
20259	443794	3	0	2	0	0	2
20259	443795	3	1	1	0	1	3
20259	443799	3	0	2	0	0	2
20259	443805	3	0	1	0	0	1
20259	443813	3	0	0	0	0	0
20259	443815	3	0	0	0	0	0
20259	49511	3	1	1	0	0	2
20259	53222	3	1	0	0	0	1
20259	62303	3	1	2	0	1	4
20259	77889	3	2	0	0	0	2
20259	92821	3	0	0	0	0	0
20259	288638	2	1	0	0	1	2
20259	288645	2	0	0	0	0	0
20259	414025	2	0	0	0	1	1
20259	443727	2	0	0	0	0	0
20259	443729	2	0	1	0	0	1
20259	443730	2	0	1	0	1	2
20259	443734	2	0	1	0	0	1
20259	443742	2	0	1	0	0	1
20259	443747	2	0	2	0	0	2
20259	443748	2	1	0	0	0	1
20259	443752	2	0	1	0	0	1
20259	443753	2	0	0	0	0	0
20259	443757	2	0	0	0	0	0
20259	443762	2	0	1	0	0	1
20259	443766	2	0	1	0	0	1
20259	443771	2	1	1	0	0	2
20259	443778	2	0	0	0	0	0
20259	443780	2	2	1	0	0	3
20259	443781	2	0	0	0	2	2
20259	443782	2	0	0	0	0	0
20259	443784	2	0	1	0	0	1
20259	443786	2	0	4	0	0	4
20259	443787	2	0	0	0	0	0
20259	443789	2	0	0	0	0	0
20259	443791	2	0	0	0	0	0
20259	443800	2	0	0	0	0	0
20259	443803	2	2	1	0	2	5
20259	443804	2	0	1	0	1	2
20259	443807	2	0	2	0	0	2
20259	443808	2	0	0	0	1	1
20259	443811	2	1	0	0	1	2
20259	443812	2	0	0	0	0	0
20259	443816	2	0	1	0	0	1
20259	71670	2	1	0	0	1	2
20259	94578	2	0	1	0	0	1
20259	414026	1	0	0	0	1	1
20259	414027	1	0	0	0	0	0
20259	414028	1	0	0	0	0	0
20259	414029	1	0	1	0	0	1
20259	443725	1	0	2	0	0	2
20259	443733	1	0	0	0	0	0
20259	443735	1	0	0	0	0	0
20259	443736	1	0	0	0	0	0
20259	443738	1	0	0	0	0	0
20259	443743	1	0	1	0	0	1
20259	443746	1	0	1	0	0	1
20259	443751	1	0	3	0	0	3
20259	443756	1	0	0	0	0	0
20259	443761	1	0	1	0	0	1
20259	443774	1	0	1	0	0	1
20259	443785	1	0	0	0	0	0
20259	443792	1	0	1	0	0	1
20259	443797	1	0	0	0	0	0
20259	443801	1	1	0	0	0	1
20259	443810	1	0	0	0	0	0
69915	214821	10	2	1	0	3	6
69915	387973	10	3	2	0	2	7
69915	387915	9	2	1	0	0	3
69915	387956	9	3	3	0	1	7
69915	387931	8	2	0	0	0	2
69915	387935	8	2	1	1	0	4
69915	387936	8	2	1	1	0	4
69915	387950	8	0	0	0	0	0
69915	387970	8	2	1	0	0	3
69915	387995	8	1	1	0	3	5
69915	197056	7	0	0	0	0	0
69915	274663	7	1	2	0	3	6
69915	387929	7	3	1	0	1	5
69915	387930	7	6	3	0	3	12
69915	387934	7	1	0	0	0	1
69915	387939	7	3	0	0	0	3
69915	387940	7	2	2	0	0	4
69915	189770	6	2	0	0	0	2
69915	387908	6	3	4	0	1	8
69915	387921	6	0	0	0	1	1
69915	387922	6	5	3	0	0	8
69915	387937	6	2	2	0	1	5
69915	387958	6	3	0	0	0	3
69915	387963	6	1	1	0	0	2
69915	387966	6	1	0	1	0	2
69915	387968	6	1	0	0	0	1
69915	387972	6	1	0	1	0	2
69915	387980	6	3	3	0	0	6
69915	387984	6	2	1	0	2	5
69915	387990	6	1	2	0	0	3
69915	198535	5	1	0	0	0	1
69915	217434	5	1	0	0	1	2
69915	219887	5	0	1	0	0	1
69915	274650	5	3	0	0	0	3
69915	274655	5	2	1	0	0	3
69915	274657	5	1	1	1	0	3
69915	387913	5	1	2	0	0	3
69915	387914	5	2	1	0	1	4
69915	387919	5	1	1	0	2	4
69915	387924	5	0	2	0	0	2
69915	387932	5	2	1	0	0	3
69915	387942	5	1	3	0	1	5
69915	387954	5	2	1	0	0	3
69915	387960	5	2	2	0	0	4
69915	387978	5	0	1	0	3	4
69915	387997	5	2	2	0	0	4
69915	387998	5	2	4	0	0	6
69915	388009	5	2	2	0	0	4
69915	205747	4	1	0	0	0	1
69915	206157	4	0	0	0	0	0
69915	206533	4	4	1	0	0	5
69915	208101	4	0	0	0	0	0
69915	220259	4	0	0	0	0	0
69915	274651	4	3	2	0	0	5
69915	274654	4	1	0	0	0	1
69915	274660	4	2	1	0	1	4
69915	387916	4	2	1	0	0	3
69915	387920	4	1	5	0	1	7
69915	387923	4	2	0	0	0	2
69915	387933	4	1	0	0	0	1
69915	387943	4	0	0	0	0	0
69915	387948	4	1	3	0	0	4
69915	387949	4	0	1	0	0	1
69915	387952	4	4	0	0	0	4
69915	387955	4	0	2	0	0	2
69915	387957	4	0	2	1	0	3
69915	387961	4	2	1	0	0	3
69915	387974	4	1	0	0	0	1
69915	387981	4	0	0	0	1	1
69915	387988	4	3	3	0	1	7
69915	387992	4	3	1	0	0	4
69915	388006	4	1	2	0	0	3
69915	388008	4	0	2	0	1	3
69915	192342	3	1	0	0	0	1
69915	274653	3	1	1	0	1	3
69915	274658	3	0	2	0	1	3
69915	274662	3	0	1	0	3	4
69915	274665	3	1	0	0	0	1
69915	387907	3	2	0	0	1	3
69915	387910	3	1	1	0	0	2
69915	387911	3	0	1	0	0	1
69915	387912	3	1	1	0	0	2
69915	387917	3	1	0	0	0	1
69915	387927	3	2	1	0	0	3
69915	387941	3	1	0	0	0	1
69915	387945	3	3	1	0	0	4
69915	387951	3	0	3	0	0	3
69915	387953	3	1	1	0	0	2
69915	387959	3	3	0	0	0	3
69915	387962	3	0	0	0	0	0
69915	387969	3	0	0	0	0	0
69915	387971	3	0	0	0	0	0
69915	387975	3	0	2	0	0	2
69915	387977	3	1	0	0	0	1
69915	387986	3	2	0	0	0	2
69915	387989	3	0	2	0	0	2
69915	387991	3	0	1	0	0	1
69915	387993	3	2	1	0	0	3
69915	387994	3	0	1	0	3	4
69915	387996	3	1	0	0	0	1
69915	387999	3	1	0	0	0	1
69915	388001	3	2	0	0	0	2
69915	388002	3	1	0	0	0	1
69915	388005	3	0	2	0	0	2
69915	183819	2	2	2	0	0	4
69915	184555	2	0	0	0	0	0
69915	185775	2	0	1	0	0	1
69915	189237	2	0	0	0	0	0
69915	213880	2	2	1	0	0	3
69915	274649	2	1	1	0	2	4
69915	274652	2	1	0	0	0	1
69915	274661	2	1	0	0	0	1
69915	274664	2	1	1	0	0	2
69915	274666	2	1	0	0	0	1
69915	387909	2	1	1	0	0	2
69915	387918	2	1	0	0	0	1
69915	387925	2	0	1	0	0	1
69915	387926	2	3	2	0	0	5
69915	387938	2	0	0	0	0	0
69915	387944	2	1	2	0	0	3
69915	387946	2	0	0	0	0	0
69915	387947	2	1	0	0	0	1
69915	387965	2	1	1	0	0	2
69915	387967	2	1	1	0	0	2
69915	387976	2	1	0	0	0	1
69915	387979	2	1	0	0	0	1
69915	387985	2	0	1	0	1	2
69915	387987	2	2	0	0	0	2
69915	388000	2	0	1	0	2	3
69915	388004	2	1	1	0	0	2
69915	388007	2	3	1	0	1	5
69915	388010	2	0	2	0	1	3
69915	199253	1	2	1	0	0	3
69915	205993	1	0	0	0	0	0
69915	216334	1	1	0	0	0	1
69915	274656	1	1	1	0	0	2
69915	274659	1	1	0	0	0	1
69915	387928	1	2	0	0	0	2
69915	387964	1	1	0	0	0	1
69915	387982	1	2	2	0	1	5
69915	387983	1	1	1	0	0	2
69915	388003	1	2	1	0	1	4
38078	293386	71	4	16	5	5	30
38078	56780	71	4	16	5	5	30
38078	61734	61	5	4	2	1	12
38078	293373	55	5	4	2	1	12
38078	57530	43	3	3	1	0	7
38078	533267	38	0	8	1	1	10
38078	83215	38	0	8	1	1	10
38078	51899	37	3	2	2	2	9
38078	533300	37	3	2	2	2	9
38078	63841	37	2	4	1	1	8
38078	533279	36	3	15	5	5	28
38078	293385	33	4	10	2	2	18
38078	79929	33	4	10	2	2	18
38078	96179	33	3	5	0	0	8
38078	107253	30	3	4	1	0	8
38078	91798	30	1	4	0	3	8
38078	533269	29	3	4	1	0	8
38078	533278	29	1	4	0	3	8
38078	67198	29	2	0	0	0	2
38078	533293	28	2	4	1	4	11
38078	533305	28	2	2	4	0	8
38078	57083	28	2	4	1	4	11
38078	106984	27	1	3	0	0	4
38078	220918	27	1	3	0	0	4
38078	533298	27	1	4	0	0	5
38078	533299	27	1	3	0	0	4
38078	533308	27	1	0	1	1	3
38078	59430	27	1	4	0	0	5
38078	202336	26	1	5	1	2	9
38078	533301	26	4	4	0	1	9
38078	56072	26	1	3	5	3	12
38078	85531	26	2	3	2	0	7
38078	96030	26	4	4	0	1	9
38078	293375	25	1	5	1	2	9
38078	533266	25	1	5	1	2	9
38078	533283	25	1	2	0	0	3
38078	82804	25	1	5	1	2	9
38078	293393	24	5	4	0	0	9
38078	52256	24	5	4	0	0	9
38078	533277	24	1	3	5	3	12
38078	533291	24	0	1	0	0	1
38078	533292	24	0	6	1	1	8
38078	533302	24	1	4	0	0	5
38078	70013	24	1	4	0	0	5
38078	85431	24	1	2	0	0	3
38078	183876	23	0	5	0	1	6
38078	533289	23	4	4	1	3	12
38078	103487	22	2	0	0	0	2
38078	533309	22	5	4	0	0	9
38078	67332	22	2	1	1	0	4
38078	104938	21	0	2	0	0	2
38078	106903	21	3	3	0	1	7
38078	533303	21	0	2	0	0	2
38078	533307	21	3	3	0	1	7
38078	82054	21	0	4	0	1	5
38078	107447	20	0	4	0	0	4
38078	533270	20	0	4	0	0	4
38078	58213	20	5	5	0	1	11
38078	198099	19	0	4	0	1	5
38078	293378	19	2	4	1	5	12
38078	50095	19	2	4	1	5	12
38078	533268	19	2	4	1	5	12
38078	533296	19	2	2	0	1	5
38078	73704	19	0	4	0	1	5
38078	293379	18	1	3	1	1	6
38078	533271	18	1	3	1	1	6
38078	80782	18	1	3	1	1	6
38078	92098	18	0	0	0	0	0
38078	293377	17	1	2	1	0	4
38078	56949	17	1	2	1	0	4
38078	293374	16	0	1	0	0	1
38078	533274	16	0	1	1	0	2
38078	533280	16	5	4	0	6	15
38078	533286	16	1	0	0	0	1
38078	533288	16	0	2	0	0	2
38078	533295	16	1	2	0	0	3
38078	533297	16	1	5	1	0	7
38078	72522	16	0	2	0	0	2
38078	82968	16	5	4	0	6	15
38078	83644	16	1	5	1	0	7
38078	206989	15	2	2	2	0	6
38078	65496	15	0	0	0	0	0
38078	68874	15	0	1	1	0	2
38078	106051	14	1	0	0	0	1
38078	293389	14	3	4	0	2	9
38078	533294	14	3	4	0	2	9
38078	79710	14	2	3	0	0	5
38078	91470	14	3	4	0	2	9
38078	293392	13	3	2	0	1	6
38078	533287	13	0	2	1	0	3
38078	54222	13	3	2	0	1	6
38078	54480	13	1	2	1	0	4
38078	102269	12	2	5	1	1	9
38078	189024	12	3	3	0	0	6
38078	293388	12	2	5	1	1	9
38078	533281	12	2	3	2	0	7
38078	533306	12	3	3	0	0	6
38078	58724	12	1	0	0	0	1
38078	61056	12	3	3	0	0	6
38078	72085	12	2	3	2	0	7
38078	210785	11	2	3	0	0	5
38078	293376	11	3	5	1	0	9
38078	293387	11	2	3	0	0	5
38078	50948	11	3	5	1	0	9
38078	533290	11	1	4	0	0	5
38078	55484	11	2	3	0	0	5
38078	59631	11	0	0	0	0	0
38078	86736	11	1	2	0	1	4
38078	533304	10	3	2	0	1	6
38078	104573	9	2	6	0	0	8
38078	219395	9	0	0	0	0	0
38078	293382	9	2	4	0	0	6
38078	533285	9	2	0	0	0	2
38078	53392	9	3	0	0	2	5
38078	81976	9	2	2	3	0	7
38078	90834	9	2	4	0	0	6
38078	533276	8	4	2	0	1	7
38078	65631	8	1	1	0	1	3
38078	196804	7	0	1	0	0	1
38078	198692	7	2	2	0	0	4
38078	293390	7	2	0	0	0	2
38078	533272	7	2	2	0	0	4
38078	533275	7	1	0	1	0	2
38078	533282	7	2	3	3	1	9
38078	533284	7	2	2	0	0	4
38078	60788	7	2	0	0	0	2
38078	74629	7	2	2	0	0	4
38078	191799	6	1	1	0	0	2
38078	204137	6	2	2	0	1	5
38078	67666	6	0	1	0	0	1
38078	293380	5	1	1	0	2	4
38078	293383	5	2	5	0	0	7
38078	293384	5	1	1	0	0	2
38078	64476	5	1	1	0	0	2
38078	84431	5	2	2	0	1	5
38078	97746	5	1	1	0	2	4
38078	101723	3	0	2	0	0	2
38078	293381	3	0	2	0	0	2
38078	74165	3	0	2	0	0	2
38078	209110	2	0	1	1	0	2
38078	208462	1	0	0	0	0	0
62439	83164	47	7	12	0	3	22
62439	73558	26	0	1	0	0	1
62439	69742	22	2	1	0	1	4
62439	103393	21	4	0	1	5	10
62439	100558	18	0	3	0	0	3
62439	299618	15	0	3	2	1	6
62439	535356	14	3	1	0	0	4
62439	56879	13	0	1	0	0	1
62439	96420	13	0	1	0	0	1
62439	84948	12	1	0	0	0	1
62439	68002	11	2	1	0	2	5
62439	193942	10	0	0	1	0	1
62439	535366	9	1	2	1	1	5
62439	94790	9	1	4	0	0	5
62439	215277	8	1	2	0	0	3
62439	299616	8	3	0	0	0	3
62439	535348	8	1	2	1	1	5
62439	55300	8	1	1	0	0	2
62439	299617	7	0	0	0	1	1
62439	535323	7	2	2	0	0	4
62439	535369	7	2	1	0	0	3
62439	535378	7	1	0	0	0	1
62439	68317	7	1	2	0	3	6
62439	187763	6	0	2	0	0	2
62439	535294	6	1	1	0	1	3
62439	535304	6	0	4	0	0	4
62439	535313	6	0	1	0	2	3
62439	535321	6	0	3	0	0	3
62439	535335	6	1	0	0	0	1
62439	535336	6	0	2	0	0	2
62439	535343	6	2	0	0	0	2
62439	535352	6	0	0	0	1	1
62439	535357	6	2	0	0	0	2
62439	535360	6	2	0	0	0	2
62439	535362	6	2	4	1	0	7
62439	535371	6	3	3	0	0	6
62439	535372	6	2	1	0	0	3
62439	535376	6	1	2	0	0	3
62439	65866	6	0	2	0	0	2
62439	190449	5	0	2	1	0	3
62439	299615	5	0	0	1	0	1
62439	535286	5	1	2	0	1	4
62439	535291	5	1	1	0	0	2
62439	535295	5	0	3	0	0	3
62439	535300	5	1	1	0	0	2
62439	535302	5	1	1	0	0	2
62439	535314	5	0	0	0	0	0
62439	535318	5	1	4	0	0	5
62439	535332	5	2	0	0	0	2
62439	535334	5	1	0	0	0	1
62439	535340	5	0	2	0	0	2
62439	535345	5	0	4	0	1	5
62439	535347	5	4	0	0	0	4
62439	535350	5	1	3	0	0	4
62439	535354	5	0	0	0	0	0
62439	535370	5	2	2	0	1	5
62439	535387	5	0	2	0	0	2
62439	65386	5	2	1	0	3	6
62439	89060	5	0	0	1	0	1
62439	98908	5	1	1	0	1	3
62439	203092	4	2	2	0	0	4
62439	204512	4	2	0	0	0	2
62439	299614	4	2	2	0	0	4
62439	535287	4	1	1	0	0	2
62439	535296	4	0	1	0	0	1
62439	535297	4	0	0	1	1	2
62439	535298	4	1	2	0	0	3
62439	535305	4	4	1	0	0	5
62439	535312	4	1	0	0	0	1
62439	535316	4	2	0	0	0	2
62439	535317	4	1	1	1	0	3
62439	535320	4	2	1	0	0	3
62439	535324	4	0	3	0	3	6
62439	535337	4	0	2	0	0	2
62439	535338	4	1	2	0	0	3
62439	535349	4	3	2	0	0	5
62439	535351	4	0	1	0	0	1
62439	535353	4	0	1	0	0	1
62439	535359	4	3	1	0	0	4
62439	535367	4	1	0	0	0	1
62439	535375	4	4	0	0	2	6
62439	535384	4	1	4	0	0	5
62439	535391	4	3	2	0	0	5
62439	535392	4	3	0	0	0	3
62439	535285	3	1	0	0	0	1
62439	535288	3	0	0	0	0	0
62439	535289	3	0	0	1	0	1
62439	535301	3	0	1	0	0	1
62439	535303	3	0	0	0	1	1
62439	535306	3	1	2	0	0	3
62439	535308	3	0	2	0	0	2
62439	535310	3	0	0	2	0	2
62439	535319	3	1	1	0	0	2
62439	535322	3	1	0	0	0	1
62439	535328	3	0	1	0	0	1
62439	535329	3	0	1	0	0	1
62439	535330	3	0	1	0	0	1
62439	535331	3	0	0	0	1	1
62439	535339	3	0	1	0	0	1
62439	535341	3	1	0	0	0	1
62439	535346	3	0	1	0	0	1
62439	535355	3	1	0	0	0	1
62439	535361	3	0	1	0	0	1
62439	535365	3	2	1	0	0	3
62439	535368	3	0	3	0	0	3
62439	535379	3	0	0	0	0	0
62439	535381	3	0	2	0	0	2
62439	535383	3	0	2	0	0	2
62439	535389	3	1	1	0	1	3
62439	535299	2	1	1	0	0	2
62439	535309	2	1	1	0	0	2
62439	535325	2	0	0	0	2	2
62439	535326	2	0	0	1	0	1
62439	535327	2	1	1	0	0	2
62439	535333	2	0	0	0	0	0
62439	535344	2	1	1	0	0	2
62439	535363	2	0	2	0	0	2
62439	535364	2	0	0	0	0	0
62439	535373	2	1	1	0	0	2
62439	535380	2	0	1	0	0	1
62439	535390	2	0	2	0	1	3
62439	216877	1	1	0	0	0	1
62439	535283	1	0	1	0	0	1
62439	535284	1	0	1	0	0	1
62439	535290	1	0	1	0	0	1
62439	535292	1	0	0	0	0	0
62439	535293	1	1	0	0	1	2
62439	535307	1	0	0	0	0	0
62439	535311	1	0	0	0	0	0
62439	535315	1	0	0	0	0	0
62439	535342	1	0	2	0	2	4
62439	535358	1	0	0	0	0	0
62439	535374	1	0	2	0	1	3
62439	535377	1	0	1	0	0	1
62439	535382	1	0	0	0	0	0
62439	535385	1	0	2	0	0	2
62439	535386	1	0	1	0	0	1
62439	535388	1	1	0	0	0	1
62439	535393	1	0	3	0	0	3
36795	199046	39	3	4	0	3	10
36795	292986	39	3	4	0	3	10
36795	210670	34	3	2	3	3	11
36795	511341	34	3	2	3	3	11
36795	184100	19	2	5	1	2	10
36795	511313	19	1	7	0	0	8
36795	511353	17	1	5	1	2	9
36795	292978	16	3	2	0	3	8
36795	292989	15	2	2	1	4	9
36795	511317	14	1	1	0	3	5
36795	203238	13	1	1	0	1	3
36795	511332	13	0	2	0	0	2
36795	511311	12	0	1	1	0	2
36795	292993	11	2	0	0	2	4
36795	210914	10	0	1	2	0	3
36795	292984	10	2	3	0	0	5
36795	511337	10	5	1	0	3	9
36795	511339	10	2	5	0	0	7
36795	511343	10	2	0	1	0	3
36795	511347	10	0	1	2	0	3
36795	511349	10	1	1	0	2	4
36795	292982	9	1	0	0	1	2
36795	188355	8	0	2	0	1	3
36795	292979	8	2	3	1	0	6
36795	292992	8	0	2	1	0	3
36795	292996	8	0	1	0	2	3
36795	189932	7	1	1	0	0	2
36795	190403	7	0	1	0	0	1
36795	214010	7	0	2	2	1	5
36795	216987	7	0	2	1	0	3
36795	221594	7	1	0	1	1	3
36795	511329	7	1	1	1	0	3
36795	511335	7	1	1	1	0	3
36795	511346	7	0	1	0	0	1
36795	511357	7	0	2	1	0	3
36795	511364	7	1	1	0	4	6
36795	186017	6	1	2	1	0	4
36795	192260	6	1	0	0	0	1
36795	203043	6	1	2	0	3	6
36795	203044	6	1	2	0	3	6
36795	292987	6	1	1	0	2	4
36795	511318	6	3	0	0	1	4
36795	511331	6	1	2	0	3	6
36795	511340	6	1	3	0	0	4
36795	511379	6	0	2	0	0	2
36795	188258	5	1	0	0	1	2
36795	192208	5	0	0	0	0	0
36795	193895	5	0	3	0	0	3
36795	194918	5	1	3	0	0	4
36795	209403	5	0	1	0	0	1
36795	214089	5	0	3	1	0	4
36795	215298	5	0	0	0	2	2
36795	219953	5	0	2	0	0	2
36795	292995	5	2	3	0	2	7
36795	511314	5	1	0	0	0	1
36795	511326	5	1	1	0	1	3
36795	511336	5	1	1	1	0	3
36795	511355	5	3	2	0	0	5
36795	511356	5	0	0	1	2	3
36795	511358	5	2	1	0	0	3
36795	511360	5	1	2	0	0	3
36795	511378	5	1	4	0	2	7
36795	206726	4	1	1	0	1	3
36795	208365	4	2	3	0	0	5
36795	214480	4	1	1	0	6	8
36795	217210	4	0	0	2	0	2
36795	217278	4	0	0	0	0	0
36795	292980	4	1	1	0	1	3
36795	292985	4	2	2	0	0	4
36795	292997	4	0	0	0	0	0
36795	292998	4	0	3	0	0	3
36795	511321	4	0	1	0	0	1
36795	511322	4	0	3	1	1	5
36795	511328	4	1	4	0	1	6
36795	511330	4	0	3	0	0	3
36795	511334	4	0	0	0	0	0
36795	511338	4	2	2	0	1	5
36795	511344	4	1	1	0	3	5
36795	511366	4	1	1	0	0	2
36795	511368	4	0	1	0	0	1
36795	511369	4	1	2	0	1	4
36795	511373	4	0	1	0	0	1
36795	511376	4	1	2	0	0	3
36795	511377	4	1	1	0	0	2
36795	182349	3	0	1	0	0	1
36795	184452	3	2	0	0	1	3
36795	206908	3	0	2	0	0	2
36795	216062	3	2	1	0	0	3
36795	216063	3	2	1	0	0	3
36795	218724	3	0	0	0	0	0
36795	292981	3	2	1	0	0	3
36795	292983	3	0	2	0	0	2
36795	292988	3	0	1	0	1	2
36795	292990	3	1	0	0	0	1
36795	292994	3	0	2	0	0	2
36795	511307	3	0	0	0	0	0
36795	511308	3	0	1	0	1	2
36795	511315	3	1	1	0	0	2
36795	511316	3	1	0	0	0	1
36795	511320	3	0	1	0	1	2
36795	511324	3	0	3	0	0	3
36795	511325	3	1	2	0	0	3
36795	511327	3	3	1	0	0	4
36795	511345	3	1	1	0	0	2
36795	511351	3	0	0	0	0	0
36795	511352	3	0	1	0	1	2
36795	511361	3	0	1	0	0	1
36795	511362	3	1	1	0	2	4
36795	511367	3	0	4	0	0	4
36795	511371	3	0	1	0	1	2
36795	511375	3	0	1	0	1	2
36795	185139	2	1	0	0	0	1
36795	187210	2	2	1	0	1	4
36795	196057	2	1	1	0	1	3
36795	201973	2	0	0	0	0	0
36795	204499	2	2	1	0	0	3
36795	210534	2	0	0	0	0	0
36795	292991	2	0	0	0	0	0
36795	511306	2	0	1	0	0	1
36795	511309	2	1	1	0	0	2
36795	511310	2	0	0	0	1	1
36795	511312	2	2	2	0	0	4
36795	511319	2	0	1	0	1	2
36795	511323	2	2	1	0	1	4
36795	511333	2	0	3	0	2	5
36795	511342	2	1	0	0	0	1
36795	511359	2	0	1	0	0	1
36795	511365	2	1	3	0	0	4
36795	511370	2	1	2	0	2	5
36795	511372	2	2	2	0	1	5
36795	200321	1	1	0	0	0	1
36795	208665	1	0	0	0	0	0
36795	220278	1	0	0	0	0	0
36795	292999	1	0	0	0	0	0
36795	511348	1	0	0	0	0	0
36795	511350	1	0	1	0	0	1
36795	511354	1	0	1	0	0	1
36795	511363	1	0	1	0	0	1
36795	511374	1	0	1	0	0	1
19309	563954	22	1	1	3	0	5
19309	563993	22	1	6	1	1	9
19309	563951	18	1	2	0	2	5
19309	563999	17	1	4	2	0	7
19309	564006	17	1	0	1	0	2
19309	563960	16	1	6	1	2	10
19309	563987	15	1	4	1	0	6
19309	563972	13	3	1	0	4	8
19309	563957	12	2	2	0	0	4
19309	184607	11	3	0	0	0	3
19309	220573	11	0	1	1	2	4
19309	186328	10	2	0	0	0	2
19309	563963	10	1	4	0	1	6
19309	569984	10	1	1	0	2	4
19309	563947	9	3	3	1	2	9
19309	563955	9	1	3	0	2	6
19309	563956	9	5	3	0	1	9
19309	564008	9	2	1	0	1	4
19309	569994	9	0	2	0	0	2
19309	570005	9	2	1	1	0	4
19309	78494	9	3	3	1	2	9
19309	184283	8	1	1	0	2	4
19309	206356	8	0	0	0	0	0
19309	563953	8	6	2	0	0	8
19309	563989	8	3	4	0	0	7
19309	563991	8	1	1	0	0	2
19309	569996	8	2	2	0	0	4
19309	217176	7	1	1	1	1	4
19309	220569	7	1	2	0	0	3
19309	563967	7	0	2	0	1	3
19309	563986	7	1	1	0	0	2
19309	564005	7	2	1	0	0	3
19309	564009	7	1	1	0	2	4
19309	569987	7	0	2	0	1	3
19309	563973	6	0	1	0	0	1
19309	564001	6	1	2	1	0	4
19309	564002	6	0	1	0	0	1
19309	569979	6	1	2	0	1	4
19309	569980	6	1	2	0	0	3
19309	569989	6	2	3	0	0	5
19309	206388	5	0	0	1	0	1
19309	207726	5	2	3	1	1	7
19309	216772	5	0	0	0	1	1
19309	218829	5	1	0	0	0	1
19309	563942	5	0	0	0	0	0
19309	563943	5	0	0	0	2	2
19309	563946	5	0	0	0	2	2
19309	563949	5	0	3	0	2	5
19309	563961	5	2	0	0	1	3
19309	563969	5	2	0	0	1	3
19309	563974	5	0	2	1	1	4
19309	563983	5	0	1	0	0	1
19309	563984	5	2	0	0	0	2
19309	563992	5	3	1	0	1	5
19309	563995	5	0	0	0	1	1
19309	563996	5	2	0	0	0	2
19309	564000	5	1	1	0	2	4
19309	569977	5	0	1	0	0	1
19309	569981	5	0	1	0	0	1
19309	570003	5	2	1	0	0	3
19309	570004	5	1	1	0	1	3
19309	570007	5	0	2	1	0	3
19309	563959	4	0	1	1	0	2
19309	563964	4	3	2	0	0	5
19309	563968	4	1	2	1	0	4
19309	563970	4	2	0	0	0	2
19309	563975	4	1	2	0	0	3
19309	563985	4	0	2	0	0	2
19309	563988	4	0	0	0	0	0
19309	563998	4	1	0	0	0	1
19309	564003	4	2	0	0	0	2
19309	569971	4	0	2	0	0	2
19309	569974	4	0	1	0	0	1
19309	569982	4	0	0	0	1	1
19309	569992	4	0	1	1	0	2
19309	569997	4	1	2	0	0	3
19309	570000	4	1	1	0	0	2
19309	570011	4	2	2	0	0	4
19309	102023	3	0	1	0	2	3
19309	182316	3	1	0	0	1	2
19309	189738	3	0	0	0	0	0
19309	206930	3	0	0	0	0	0
19309	211696	3	0	0	0	1	1
19309	218000	3	1	1	0	0	2
19309	563941	3	1	1	0	1	3
19309	563962	3	0	1	0	1	2
19309	563966	3	1	0	0	0	1
19309	563971	3	0	0	0	0	0
19309	563979	3	0	1	0	0	1
19309	563997	3	3	0	0	0	3
19309	564004	3	1	2	1	1	5
19309	564010	3	2	1	0	1	4
19309	569972	3	1	0	0	0	1
19309	569990	3	2	0	0	0	2
19309	569991	3	1	2	0	0	3
19309	569998	3	0	1	0	0	1
19309	569999	3	0	1	0	0	1
19309	570006	3	0	1	0	0	1
19309	570008	3	1	2	0	1	4
19309	570010	3	2	1	0	0	3
19309	570012	3	1	2	0	1	4
19309	185347	2	2	1	0	0	3
19309	200869	2	0	0	0	0	0
19309	203207	2	0	0	0	0	0
19309	210155	2	1	1	0	0	2
19309	217170	2	0	2	0	0	2
19309	563944	2	0	0	0	0	0
19309	563945	2	2	0	0	0	2
19309	563950	2	0	1	0	1	2
19309	563952	2	0	0	0	1	1
19309	563958	2	0	4	0	0	4
19309	563977	2	0	3	0	0	3
19309	563980	2	1	2	0	0	3
19309	563990	2	0	0	0	1	1
19309	563994	2	0	0	0	0	0
19309	564007	2	0	0	0	2	2
19309	564011	2	2	1	0	0	3
19309	569970	2	1	0	0	1	2
19309	569975	2	0	0	0	0	0
19309	569983	2	0	0	0	0	0
19309	569986	2	0	2	0	0	2
19309	569988	2	0	0	0	0	0
19309	569993	2	0	2	0	0	2
19309	569995	2	1	1	0	0	2
19309	570001	2	3	0	0	0	3
19309	192097	1	0	0	0	0	0
19309	205365	1	0	0	0	0	0
19309	216310	1	1	0	0	0	1
19309	563948	1	0	0	0	0	0
19309	563965	1	0	1	0	0	1
19309	563978	1	1	0	0	0	1
19309	563981	1	1	0	0	0	1
19309	563982	1	1	1	0	0	2
19309	569973	1	0	1	0	0	1
19309	569976	1	0	0	0	0	0
19309	569978	1	1	0	0	0	1
19309	569985	1	0	0	0	0	0
19309	570002	1	0	1	0	0	1
19309	570009	1	2	0	0	0	2
67088	439043	17	1	2	0	0	3
67088	439091	15	2	0	0	1	3
67088	439065	12	1	3	0	1	5
67088	273753	9	0	0	0	1	1
67088	439048	9	1	2	0	0	3
67088	439061	9	2	1	0	0	3
67088	439103	9	4	0	0	0	4
67088	273750	8	0	1	0	1	2
67088	439035	8	2	1	0	1	4
67088	101210	7	2	2	0	0	4
67088	273761	7	2	2	0	0	4
67088	439038	7	1	1	0	2	4
67088	439059	7	1	1	0	0	2
67088	439069	7	2	2	0	1	5
67088	439090	7	2	2	0	1	5
67088	103776	6	0	2	0	1	3
67088	273757	6	1	3	0	1	5
67088	273766	6	0	2	0	1	3
67088	439034	6	5	4	0	1	10
67088	439044	6	1	1	0	1	3
67088	439046	6	2	0	0	2	4
67088	439047	6	2	2	0	1	5
67088	439054	6	2	2	0	0	4
67088	439079	6	3	2	0	0	5
67088	439083	6	2	1	0	0	3
67088	439093	6	1	0	0	0	1
67088	439096	6	2	2	0	0	4
67088	439105	6	1	0	1	1	3
67088	183415	5	1	1	0	2	4
67088	184776	5	2	0	0	0	2
67088	197113	5	1	1	0	0	2
67088	273760	5	4	0	1	0	5
67088	273763	5	2	1	0	1	4
67088	273765	5	2	0	0	1	3
67088	439039	5	4	0	1	0	5
67088	439041	5	3	0	0	0	3
67088	439045	5	2	1	0	0	3
67088	439072	5	0	1	0	2	3
67088	439078	5	1	1	0	1	3
67088	439081	5	2	0	0	1	3
67088	439084	5	1	0	0	0	1
67088	439085	5	4	0	0	1	5
67088	439094	5	1	2	0	3	6
67088	439110	5	0	0	0	1	1
67088	439113	5	3	1	0	0	4
67088	439114	5	2	0	0	1	3
67088	439115	5	0	0	0	1	1
67088	439119	5	1	3	0	1	5
67088	54338	5	2	0	0	1	3
67088	94151	5	2	1	0	1	4
67088	193251	4	0	0	0	0	0
67088	193252	4	0	0	0	0	0
67088	198084	4	2	0	0	1	3
67088	205491	4	0	1	0	1	2
67088	206220	4	1	1	0	0	2
67088	206903	4	2	1	0	2	5
67088	206909	4	1	0	0	2	3
67088	273749	4	1	1	0	1	3
67088	273758	4	1	2	0	1	4
67088	273762	4	1	1	0	1	3
67088	273764	4	2	1	0	0	3
67088	439036	4	1	4	0	0	5
67088	439042	4	1	0	0	1	2
67088	439050	4	0	0	0	1	1
67088	439051	4	3	2	0	0	5
67088	439055	4	2	2	0	1	5
67088	439056	4	1	2	0	0	3
67088	439057	4	2	0	0	1	3
67088	439063	4	1	1	0	1	3
67088	439064	4	0	1	0	1	2
67088	439075	4	2	3	0	0	5
67088	439082	4	0	2	0	1	3
67088	439086	4	0	0	0	1	1
67088	439088	4	1	2	0	1	4
67088	439089	4	1	0	0	0	1
67088	439092	4	0	1	0	0	1
67088	439098	4	1	1	0	1	3
67088	439099	4	1	1	0	0	2
67088	439101	4	0	1	0	3	4
67088	439106	4	2	2	0	0	4
67088	439112	4	1	1	0	2	4
67088	439116	4	0	0	0	0	0
67088	439117	4	2	1	0	0	3
67088	70843	4	1	1	0	1	3
67088	70941	4	1	2	0	1	4
67088	184557	3	0	0	0	1	1
67088	194507	3	0	0	0	1	1
67088	211081	3	1	0	0	1	2
67088	216738	3	0	1	0	1	2
67088	273751	3	0	0	0	1	1
67088	273752	3	0	0	0	1	1
67088	273754	3	1	1	0	1	3
67088	273767	3	0	0	0	0	0
67088	439037	3	0	1	0	1	2
67088	439052	3	1	0	0	0	1
67088	439053	3	1	2	1	0	4
67088	439058	3	0	2	0	0	2
67088	439060	3	3	2	0	1	6
67088	439062	3	0	0	0	0	0
67088	439067	3	1	0	0	0	1
67088	439076	3	1	1	1	0	3
67088	439100	3	0	0	0	0	0
67088	439107	3	2	2	0	2	6
67088	439108	3	0	1	0	0	1
67088	439120	3	0	3	0	0	3
67088	191187	2	0	1	0	0	1
67088	273747	2	0	0	1	0	1
67088	273748	2	0	4	0	0	4
67088	273756	2	1	0	0	2	3
67088	273759	2	1	1	0	2	4
67088	439049	2	0	0	0	1	1
67088	439068	2	3	2	0	0	5
67088	439070	2	0	0	0	0	0
67088	439074	2	1	0	0	3	4
67088	439077	2	1	1	0	0	2
67088	439095	2	0	0	0	0	0
67088	439104	2	0	0	1	0	1
67088	439109	2	0	0	0	0	0
67088	439118	2	2	0	0	0	2
67088	58634	2	1	1	0	2	4
67088	64665	2	0	0	1	0	1
67088	91203	2	0	4	0	0	4
67088	91975	2	1	0	0	2	3
67088	198257	1	1	1	0	0	2
67088	207663	1	0	0	0	0	0
67088	209796	1	1	0	0	1	2
67088	273755	1	1	0	0	1	2
67088	273768	1	0	0	0	0	0
67088	439040	1	1	0	0	1	2
67088	439066	1	1	0	0	0	1
67088	439071	1	0	1	0	1	2
67088	439073	1	0	0	0	0	0
67088	439080	1	0	1	0	0	1
67088	439087	1	0	0	0	0	0
67088	439097	1	0	0	0	1	1
67088	439102	1	0	1	1	2	4
67088	439111	1	1	1	0	0	2
18457	182761	23	0	3	1	2	6
18457	182765	22	0	3	1	2	6
18457	183625	22	1	1	0	2	4
18457	288065	22	0	3	1	2	6
18457	203520	21	3	0	2	0	5
18457	288063	20	3	1	1	3	8
18457	288064	20	4	3	1	2	10
18457	434289	20	4	3	1	2	10
18457	91356	19	5	2	0	2	9
18457	217522	18	0	1	0	0	1
18457	197256	17	1	0	0	1	2
18457	434309	16	3	2	0	0	5
18457	434332	16	1	0	0	1	2
18457	434316	15	1	5	1	7	14
18457	188724	14	3	5	3	1	12
18457	288067	14	3	5	3	1	12
18457	288061	13	1	2	1	1	5
18457	55893	13	1	2	1	1	5
18457	106808	11	1	0	0	1	2
18457	288066	11	1	0	0	0	1
18457	434271	11	4	0	3	3	10
18457	434326	11	3	0	0	1	4
18457	434337	11	1	1	0	0	2
18457	91941	11	1	0	0	0	1
18457	434318	10	2	1	1	0	4
18457	190588	9	0	1	0	0	1
18457	434295	9	0	2	0	3	5
18457	434296	9	1	2	1	0	4
18457	183790	8	0	1	2	1	4
18457	188366	8	0	1	0	3	4
18457	195518	8	1	1	2	0	4
18457	221005	8	1	2	0	1	4
18457	434301	8	1	4	0	3	8
18457	208922	7	0	1	0	0	1
18457	208943	7	0	1	0	1	2
18457	434272	7	1	2	0	0	3
18457	434285	7	1	0	0	1	2
18457	434293	7	2	0	1	4	7
18457	434327	7	3	1	1	0	5
18457	183828	6	2	0	0	2	4
18457	196648	6	0	0	0	1	1
18457	203715	6	1	1	0	0	2
18457	434290	6	0	0	0	0	0
18457	434292	6	0	0	2	0	2
18457	434298	6	1	0	2	0	3
18457	434307	6	0	2	0	2	4
18457	434311	6	0	0	0	1	1
18457	434321	6	2	0	1	0	3
18457	434333	6	0	0	1	1	2
18457	434335	6	2	0	0	0	2
18457	434341	6	4	3	0	2	9
18457	434342	6	4	3	0	2	9
18457	434344	6	2	1	0	2	5
18457	55142	6	2	2	0	0	4
18457	183112	5	1	1	2	0	4
18457	190587	5	0	0	0	0	0
18457	434278	5	0	0	2	2	4
18457	434280	5	0	0	0	0	0
18457	434282	5	2	0	0	0	2
18457	434283	5	1	0	0	0	1
18457	434287	5	0	0	0	2	2
18457	434330	5	1	0	0	0	1
18457	434336	5	0	0	0	0	0
18457	108121	4	0	0	0	1	1
18457	184358	4	0	0	2	2	4
18457	192386	4	0	0	0	1	1
18457	195529	4	0	0	0	0	0
18457	196434	4	1	0	0	0	1
18457	205733	4	1	1	0	1	3
18457	212962	4	0	1	0	2	3
18457	434270	4	1	1	0	0	2
18457	434277	4	0	0	0	0	0
18457	434281	4	0	0	0	0	0
18457	434286	4	0	1	0	2	3
18457	434288	4	2	0	1	0	3
18457	434291	4	0	0	0	1	1
18457	434308	4	0	1	0	0	1
18457	434310	4	1	0	0	1	2
18457	434317	4	0	0	0	0	0
18457	434323	4	2	3	0	0	5
18457	434328	4	0	0	1	1	2
18457	434339	4	0	1	0	3	4
18457	434348	4	0	1	0	1	2
18457	77411	4	0	0	0	1	1
18457	193356	3	1	0	0	0	1
18457	201941	3	2	1	0	4	7
18457	203419	3	3	1	0	0	4
18457	214729	3	0	2	1	0	3
18457	219002	3	0	0	0	0	0
18457	434274	3	0	1	0	0	1
18457	434297	3	1	0	0	0	1
18457	434302	3	1	3	0	0	4
18457	434304	3	0	2	0	0	2
18457	434306	3	2	0	1	1	4
18457	434313	3	0	0	0	1	1
18457	434314	3	1	0	1	2	4
18457	434322	3	1	3	0	2	6
18457	434331	3	0	0	1	0	1
18457	434334	3	0	0	1	1	2
18457	434343	3	2	0	0	0	2
18457	434345	3	1	1	1	0	3
18457	434346	3	0	1	0	0	1
18457	84666	3	1	0	0	0	1
18457	183829	2	0	0	0	0	0
18457	188324	2	1	0	0	2	3
18457	201630	2	0	0	0	0	0
18457	217862	2	0	0	0	0	0
18457	434273	2	0	0	0	0	0
18457	434275	2	0	0	0	1	1
18457	434299	2	1	0	0	0	1
18457	434300	2	0	0	0	0	0
18457	434303	2	0	0	0	0	0
18457	434305	2	3	0	0	1	4
18457	434315	2	0	1	0	2	3
18457	434319	2	1	0	0	1	2
18457	434320	2	1	0	2	0	3
18457	434325	2	0	0	0	1	1
18457	434329	2	0	0	1	0	1
18457	434338	2	0	0	0	0	0
18457	434340	2	1	0	0	0	1
18457	434347	2	0	0	0	0	0
18457	434349	2	1	1	0	0	2
18457	183114	1	0	0	0	0	0
18457	183624	1	0	0	0	0	0
18457	186920	1	0	0	0	1	1
18457	214534	1	0	0	0	0	0
18457	216579	1	0	1	0	1	2
18457	216582	1	0	0	0	0	0
18457	288062	1	1	1	0	2	4
18457	434276	1	2	0	2	0	4
18457	434279	1	1	1	0	0	2
18457	434284	1	1	1	1	0	3
18457	434294	1	1	1	0	0	2
18457	434312	1	1	0	0	0	1
18457	434324	1	0	2	0	0	2
33300	608318	30	1	2	3	6	12
33300	608327	24	2	2	2	4	10
33300	88781	19	0	0	1	1	2
33300	187327	17	0	1	0	3	4
33300	192697	17	0	2	0	4	6
33300	292010	16	0	2	0	4	6
33300	608332	16	0	2	0	4	6
33300	65971	16	0	2	0	4	6
33300	212196	14	1	5	3	1	10
33300	608322	14	1	5	3	1	10
33300	608323	14	1	5	3	1	10
33300	608324	14	1	5	3	1	10
33300	608325	14	1	5	3	1	10
33300	608331	13	0	0	1	0	1
33300	185895	12	1	0	0	4	5
33300	608315	11	1	0	0	1	2
33300	608352	11	0	0	0	1	1
33300	108638	10	1	1	0	3	5
33300	211574	10	1	1	1	8	11
33300	608342	10	1	0	0	1	2
33300	608349	10	1	1	1	8	11
33300	292009	9	3	2	1	0	6
33300	52476	9	3	2	1	0	6
33300	608359	9	0	1	2	1	4
33300	608361	9	1	3	1	2	7
33300	608392	9	1	1	0	2	4
33300	292012	8	1	1	1	3	6
33300	608317	8	1	1	0	1	3
33300	608320	8	2	0	0	2	4
33300	608348	8	4	1	0	6	11
33300	608360	8	1	1	1	3	6
33300	183413	7	0	4	0	1	5
33300	200004	7	1	0	0	0	1
33300	608314	7	0	0	0	1	1
33300	608329	7	0	0	0	0	0
33300	608338	7	1	3	1	2	7
33300	608382	7	1	0	0	1	2
33300	199794	6	1	0	0	1	2
33300	200785	6	0	1	0	2	3
33300	292007	6	0	2	0	0	2
33300	292014	6	0	1	0	2	3
33300	608343	6	1	1	0	2	4
33300	608350	6	2	1	3	0	6
33300	608363	6	1	0	0	0	1
33300	608381	6	2	1	0	0	3
33300	608388	6	0	2	0	0	2
33300	608391	6	2	2	0	0	4
33300	608397	6	1	0	0	1	2
33300	76705	6	0	1	0	2	3
33300	77538	6	0	0	0	0	0
33300	191176	5	1	0	0	1	2
33300	192904	5	0	2	0	0	2
33300	198125	5	2	0	0	1	3
33300	214090	5	0	1	0	1	2
33300	608313	5	1	0	1	1	3
33300	608328	5	1	0	2	1	4
33300	608330	5	3	2	1	0	6
33300	608333	5	1	0	0	2	3
33300	608337	5	0	0	1	0	1
33300	608345	5	0	2	1	1	4
33300	608358	5	2	0	0	1	3
33300	608366	5	0	5	0	2	7
33300	608375	5	2	0	0	0	2
33300	608393	5	0	1	0	5	6
33300	608394	5	1	0	0	0	1
33300	185519	4	0	0	0	0	0
33300	194921	4	0	0	1	0	1
33300	196128	4	0	1	0	0	1
33300	197214	4	0	2	0	0	2
33300	204984	4	2	0	0	0	2
33300	213361	4	0	0	0	0	0
33300	215764	4	0	0	1	1	2
33300	216916	4	1	1	0	2	4
33300	292011	4	0	0	0	1	1
33300	608326	4	0	0	0	1	1
33300	608336	4	0	1	0	0	1
33300	608340	4	2	0	0	0	2
33300	608341	4	0	2	2	0	4
33300	608344	4	1	2	0	0	3
33300	608353	4	0	0	0	2	2
33300	608357	4	0	0	1	0	1
33300	608384	4	1	0	0	0	1
33300	608385	4	1	0	0	1	2
33300	608386	4	1	0	1	0	2
33300	608390	4	1	1	0	1	3
33300	608398	4	0	0	0	1	1
33300	70245	4	0	0	0	1	1
33300	103348	3	0	0	0	0	0
33300	182722	3	0	1	0	0	1
33300	198161	3	1	1	0	1	3
33300	204607	3	0	0	0	0	0
33300	211832	3	3	0	0	0	3
33300	220580	3	0	2	0	2	4
33300	292008	3	0	0	0	0	0
33300	292013	3	0	0	0	0	0
33300	292015	3	1	0	0	0	1
33300	608319	3	0	0	0	1	1
33300	608321	3	2	0	0	0	2
33300	608339	3	1	0	1	0	2
33300	608346	3	0	1	0	0	1
33300	608347	3	0	0	0	2	2
33300	608351	3	0	0	0	0	0
33300	608354	3	0	0	1	0	1
33300	608356	3	0	0	0	0	0
33300	608362	3	1	2	1	0	4
33300	608364	3	0	0	0	0	0
33300	608365	3	1	0	0	0	1
33300	608367	3	1	1	1	2	5
33300	608368	3	0	0	0	0	0
33300	608369	3	1	0	0	0	1
33300	608370	3	0	0	0	0	0
33300	608372	3	0	1	0	1	2
33300	608374	3	1	0	0	1	2
33300	608380	3	1	1	0	0	2
33300	608383	3	0	0	0	1	1
33300	608387	3	0	0	0	1	1
33300	608389	3	1	3	0	1	5
33300	189180	2	1	0	0	0	1
33300	190309	2	0	0	1	0	1
33300	201212	2	0	0	0	1	1
33300	206412	2	1	1	0	1	3
33300	220053	2	1	0	0	0	1
33300	608316	2	1	1	0	0	2
33300	608335	2	0	4	0	0	4
33300	608371	2	0	1	0	0	1
33300	608373	2	0	0	1	1	2
33300	608377	2	0	1	0	1	2
33300	608378	2	0	1	0	2	3
33300	608395	2	0	1	0	3	4
33300	67235	2	0	1	0	0	1
33300	203317	1	0	0	0	0	0
33300	205335	1	1	0	0	0	1
33300	206502	1	0	0	0	1	1
33300	608334	1	0	0	0	0	0
33300	608355	1	1	1	0	0	2
33300	608376	1	0	0	0	0	0
33300	608379	1	1	1	0	0	2
33300	608396	1	0	1	0	0	1
69299	530725	20	4	2	1	0	7
69299	202535	18	3	5	1	0	9
69299	274396	18	3	5	1	0	9
69299	186147	14	2	2	0	0	4
69299	274397	13	2	2	0	0	4
69299	274394	10	1	0	2	2	5
69299	530705	10	5	3	2	1	11
69299	530719	10	2	1	0	0	3
69299	217324	9	0	3	0	0	3
69299	530711	9	2	2	0	2	6
69299	274390	8	1	3	0	0	4
69299	530704	8	2	3	0	0	5
69299	530728	8	2	2	0	1	5
69299	192655	7	4	1	2	1	8
69299	212956	7	2	1	1	0	4
69299	530736	7	2	3	0	1	6
69299	530741	7	1	2	1	0	4
69299	191591	6	1	2	0	2	5
69299	197446	6	0	0	0	0	0
69299	209993	6	2	3	3	0	8
69299	211353	6	0	1	0	1	2
69299	216433	6	2	5	1	0	8
69299	274389	6	2	3	3	0	8
69299	274402	6	4	1	2	0	7
69299	530692	6	1	2	0	0	3
69299	530702	6	0	3	0	0	3
69299	530731	6	0	1	0	0	1
69299	530745	6	2	1	0	0	3
69299	530755	6	1	1	1	1	4
69299	530757	6	1	1	0	1	3
69299	530759	6	1	2	0	0	3
69299	530762	6	0	3	0	0	3
69299	274400	5	0	2	1	0	3
69299	274401	5	0	2	0	0	2
69299	530688	5	0	2	0	0	2
69299	530690	5	0	1	0	1	2
69299	530708	5	1	3	0	0	4
69299	530712	5	2	0	0	0	2
69299	530713	5	0	1	0	0	1
69299	530724	5	0	2	0	0	2
69299	530735	5	0	0	0	2	2
69299	189644	4	0	1	0	0	1
69299	193408	4	0	1	2	0	3
69299	194389	4	0	0	0	1	1
69299	208393	4	3	0	0	0	3
69299	211203	4	2	1	0	0	3
69299	215958	4	0	1	1	0	2
69299	274393	4	0	1	0	0	1
69299	274399	4	0	1	0	0	1
69299	530700	4	1	1	1	0	3
69299	530701	4	1	1	1	0	3
69299	530706	4	1	2	0	1	4
69299	530722	4	1	1	0	0	2
69299	530723	4	1	2	0	0	3
69299	530727	4	1	4	0	0	5
69299	530734	4	1	1	0	0	2
69299	530738	4	0	0	0	0	0
69299	530743	4	0	3	0	0	3
69299	530744	4	0	1	0	1	2
69299	530756	4	0	1	0	0	1
69299	530760	4	0	1	0	0	1
69299	530763	4	1	0	0	0	1
69299	530766	4	0	1	0	0	1
69299	530775	4	0	2	0	1	3
69299	530776	4	2	1	0	0	3
69299	195775	3	0	0	0	0	0
69299	197885	3	0	0	0	0	0
69299	198369	3	0	2	0	0	2
69299	201544	3	0	0	0	0	0
69299	204366	3	0	0	1	1	2
69299	220182	3	0	1	0	0	1
69299	530691	3	1	2	0	2	5
69299	530707	3	0	1	0	0	1
69299	530709	3	2	2	1	0	5
69299	530710	3	0	1	0	0	1
69299	530715	3	0	1	0	0	1
69299	530717	3	1	1	0	0	2
69299	530729	3	0	4	0	0	4
69299	530739	3	1	1	0	0	2
69299	530746	3	0	1	0	0	1
69299	530748	3	0	0	0	0	0
69299	530749	3	0	3	0	0	3
69299	530761	3	0	1	0	0	1
69299	530764	3	0	0	0	1	1
69299	530768	3	1	3	0	1	5
69299	530769	3	0	2	0	1	3
69299	530770	3	0	3	0	0	3
69299	530774	3	0	3	0	1	4
69299	530777	3	0	0	0	0	0
69299	530780	3	1	1	1	0	3
69299	182675	2	0	1	0	0	1
69299	200604	2	0	2	0	0	2
69299	207079	2	0	0	0	1	1
69299	207365	2	0	1	0	0	1
69299	210500	2	0	0	1	0	1
69299	215743	2	0	1	0	0	1
69299	274391	2	0	0	0	0	0
69299	274392	2	0	1	0	0	1
69299	274395	2	0	2	0	0	2
69299	274398	2	0	2	0	0	2
69299	530683	2	0	0	0	0	0
69299	530684	2	0	2	0	0	2
69299	530685	2	0	1	0	0	1
69299	530689	2	0	1	0	0	1
69299	530716	2	0	0	2	0	2
69299	530718	2	0	0	0	0	0
69299	530720	2	0	2	0	0	2
69299	530721	2	0	2	0	1	3
69299	530730	2	0	1	0	0	1
69299	530737	2	0	1	0	0	1
69299	530740	2	0	3	0	0	3
69299	530742	2	1	1	0	0	2
69299	530750	2	0	1	1	2	4
69299	530751	2	0	0	0	0	0
69299	530752	2	0	1	0	0	1
69299	530753	2	0	0	0	0	0
69299	530758	2	0	1	0	1	2
69299	530765	2	1	1	0	0	2
69299	530767	2	1	1	0	0	2
69299	530771	2	0	2	0	0	2
69299	530773	2	1	1	0	0	2
69299	207082	1	0	1	0	0	1
69299	211127	1	0	0	0	0	0
69299	214529	1	0	3	0	0	3
69299	216880	1	0	0	0	0	0
69299	274388	1	1	0	0	0	1
69299	530686	1	0	2	0	0	2
69299	530687	1	0	0	0	0	0
69299	530703	1	0	1	0	0	1
69299	530714	1	0	1	0	0	1
69299	530726	1	0	1	0	1	2
69299	530732	1	0	1	0	0	1
69299	530733	1	1	0	0	0	1
69299	530747	1	0	2	0	0	2
69299	530754	1	2	1	0	0	3
69299	530772	1	1	1	0	0	2
69299	530778	1	0	0	0	0	0
69299	530779	1	0	1	0	0	1
60459	96102	26	4	2	0	4	10
60459	100765	19	3	2	1	3	9
60459	190284	17	1	0	2	1	4
60459	212074	17	1	4	1	3	9
60459	198289	16	2	2	1	3	8
60459	450380	16	2	2	1	3	8
60459	450391	16	4	0	2	2	8
60459	63899	13	0	0	0	0	0
60459	183434	12	0	3	0	1	4
60459	299068	11	3	4	2	0	9
60459	71428	11	3	4	2	0	9
60459	213075	10	0	0	0	2	2
60459	450412	10	2	2	1	2	7
60459	105317	8	3	2	0	2	7
60459	299060	8	1	1	0	0	2
60459	299063	8	3	2	0	1	6
60459	299072	8	3	2	0	2	7
60459	299076	8	0	2	0	1	3
60459	74035	8	3	2	0	1	6
60459	80507	8	1	1	1	1	4
60459	92813	8	1	1	0	0	2
60459	191148	7	0	0	1	0	1
60459	204182	7	1	1	0	1	3
60459	212810	7	1	0	0	0	1
60459	450393	7	1	2	2	0	5
60459	450420	7	0	1	0	0	1
60459	187995	6	0	0	0	0	0
60459	188358	6	0	0	0	0	0
60459	189326	6	1	3	0	3	7
60459	193389	6	1	1	0	2	4
60459	195837	6	1	1	0	1	3
60459	450399	6	0	2	0	0	2
60459	51076	6	0	1	0	1	2
60459	88174	6	0	1	0	1	2
60459	89971	6	1	0	0	3	4
60459	95775	6	1	3	1	1	6
60459	183268	5	1	2	0	0	3
60459	186644	5	1	1	0	0	2
60459	188599	5	1	2	1	3	7
60459	205945	5	0	0	0	0	0
60459	299069	5	1	4	0	1	6
60459	299071	5	1	2	1	3	7
60459	450377	5	0	3	0	0	3
60459	450381	5	0	3	0	1	4
60459	450386	5	2	0	2	0	4
60459	450396	5	0	1	0	1	2
60459	450413	5	0	1	1	1	3
60459	450425	5	0	0	0	1	1
60459	450426	5	0	3	1	2	6
60459	59932	5	1	2	1	3	7
60459	91084	5	1	4	0	1	6
60459	101182	4	0	1	0	2	3
60459	182129	4	1	0	0	1	2
60459	203955	4	0	1	1	0	2
60459	204080	4	0	1	0	2	3
60459	207159	4	1	0	0	2	3
60459	208181	4	1	0	0	2	3
60459	214243	4	1	1	0	2	4
60459	219034	4	1	2	1	1	5
60459	299061	4	1	2	0	2	5
60459	299064	4	0	2	0	0	2
60459	299067	4	1	0	0	2	3
60459	299073	4	1	1	0	1	3
60459	299075	4	0	1	0	2	3
60459	450390	4	0	1	0	2	3
60459	450394	4	0	0	0	1	1
60459	450397	4	2	0	0	2	4
60459	450407	4	1	1	0	0	2
60459	450410	4	2	0	0	0	2
60459	450417	4	1	2	1	1	5
60459	57155	4	0	0	0	1	1
60459	71453	4	1	2	0	2	5
60459	75161	4	1	2	0	0	3
60459	82291	4	0	2	0	0	2
60459	188307	3	0	1	0	1	2
60459	299059	3	0	1	0	1	2
60459	299062	3	1	0	0	2	3
60459	299070	3	0	0	0	1	1
60459	450374	3	0	0	0	0	0
60459	450376	3	1	0	0	3	4
60459	450385	3	2	0	2	0	4
60459	450387	3	1	1	0	0	2
60459	450395	3	0	2	0	0	2
60459	450401	3	0	1	0	1	2
60459	450405	3	1	2	0	1	4
60459	450406	3	1	1	0	1	3
60459	450408	3	0	1	0	1	2
60459	450414	3	0	1	0	0	1
60459	450416	3	3	2	0	1	6
60459	450418	3	1	0	0	0	1
60459	450422	3	1	1	0	0	2
60459	51312	3	1	0	0	2	3
60459	53962	3	0	0	0	1	1
60459	71503	3	0	1	0	1	2
60459	76276	3	1	0	0	0	1
60459	186652	2	0	0	0	2	2
60459	189935	2	0	0	0	0	0
60459	196480	2	2	0	0	0	2
60459	215171	2	0	1	0	0	1
60459	217742	2	0	1	0	1	2
60459	299066	2	3	2	0	0	5
60459	450379	2	0	0	0	1	1
60459	450382	2	1	0	0	0	1
60459	450384	2	0	2	0	1	3
60459	450388	2	0	0	1	1	2
60459	450389	2	0	0	0	0	0
60459	450392	2	0	1	0	1	2
60459	450398	2	0	2	0	0	2
60459	450402	2	0	0	0	0	0
60459	450404	2	0	0	0	0	0
60459	450409	2	1	1	0	1	3
60459	450415	2	0	2	0	0	2
60459	450424	2	0	2	0	1	3
60459	450427	2	0	0	0	3	3
60459	450428	2	1	2	0	0	3
60459	450429	2	0	0	0	2	2
60459	74852	2	2	0	0	0	2
60459	75619	2	3	2	0	0	5
60459	191270	1	2	0	0	1	3
60459	191647	1	0	0	0	1	1
60459	196403	1	0	1	0	2	3
60459	208517	1	0	0	0	0	0
60459	212742	1	0	0	0	0	0
60459	216090	1	0	2	1	0	3
60459	299065	1	0	2	0	0	2
60459	299074	1	0	0	0	0	0
60459	450375	1	0	0	0	1	1
60459	450378	1	0	0	1	1	2
60459	450383	1	1	0	0	0	1
60459	450400	1	0	0	0	0	0
60459	450403	1	0	1	1	0	2
60459	450411	1	1	1	0	1	3
60459	450419	1	0	0	0	0	0
60459	450421	1	0	1	1	0	2
60459	450423	1	1	0	0	0	1
60459	80614	1	0	2	0	0	2
31567	206594	10	1	1	0	1	3
31567	507839	10	3	2	1	1	7
31567	291527	9	1	2	0	2	5
31567	499844	9	1	1	1	0	3
31567	507863	9	3	2	0	0	5
31567	208924	8	1	0	0	3	4
31567	499843	8	2	0	1	1	4
31567	507873	8	0	2	0	0	2
31567	507910	8	2	0	0	0	2
31567	523863	8	1	0	0	2	3
31567	182627	7	1	0	2	0	3
31567	206440	7	0	1	0	0	1
31567	507851	7	0	0	0	0	0
31567	507881	7	5	1	1	0	7
31567	507895	7	1	0	1	0	2
31567	507927	7	0	2	1	0	3
31567	507931	7	1	0	0	0	1
31567	499845	6	0	2	1	0	3
31567	499846	6	0	0	0	1	1
31567	507843	6	1	0	0	0	1
31567	507870	6	0	2	0	0	2
31567	507884	6	1	3	0	0	4
31567	507889	6	1	1	0	2	4
31567	507929	6	2	0	0	0	2
31567	507938	6	3	2	0	1	6
31567	507941	6	1	1	0	1	3
31567	185846	5	0	1	0	0	1
31567	507838	5	1	2	0	0	3
31567	507842	5	1	2	0	0	3
31567	507846	5	0	1	0	0	1
31567	507848	5	0	0	0	1	1
31567	507857	5	2	2	0	1	5
31567	507882	5	0	1	0	0	1
31567	507902	5	1	1	0	0	2
31567	507905	5	1	0	0	1	2
31567	507906	5	1	0	0	0	1
31567	507907	5	2	0	0	0	2
31567	507925	5	2	1	0	0	3
31567	507830	4	0	0	0	0	0
31567	507834	4	0	4	0	0	4
31567	507836	4	1	1	1	0	3
31567	507852	4	0	0	0	3	3
31567	507854	4	1	0	0	0	1
31567	507861	4	0	2	0	1	3
31567	507869	4	0	2	0	0	2
31567	507872	4	0	0	0	1	1
31567	507876	4	0	1	0	1	2
31567	507877	4	0	1	0	0	1
31567	507883	4	1	1	0	1	3
31567	507899	4	1	0	0	0	1
31567	507904	4	1	2	0	0	3
31567	507911	4	1	2	0	0	3
31567	507912	4	0	1	0	0	1
31567	507920	4	0	0	0	0	0
31567	507923	4	2	0	0	0	2
31567	507933	4	0	0	0	0	0
31567	507935	4	0	0	0	0	0
31567	507940	4	2	0	0	0	2
31567	523862	4	2	2	0	0	4
31567	188291	3	0	0	0	0	0
31567	195956	3	0	2	0	0	2
31567	206371	3	0	0	0	0	0
31567	210594	3	0	0	0	1	1
31567	217064	3	0	0	0	0	0
31567	291526	3	0	0	0	0	0
31567	507832	3	1	3	0	0	4
31567	507840	3	1	0	0	0	1
31567	507847	3	1	2	0	0	3
31567	507855	3	4	1	0	0	5
31567	507856	3	1	0	0	0	1
31567	507859	3	1	0	0	0	1
31567	507864	3	3	0	1	2	6
31567	507866	3	3	0	0	0	3
31567	507867	3	0	0	0	0	0
31567	507868	3	2	1	0	0	3
31567	507878	3	0	1	0	1	2
31567	507880	3	0	0	0	0	0
31567	507885	3	0	1	0	3	4
31567	507886	3	0	0	0	0	0
31567	507887	3	0	0	0	0	0
31567	507891	3	3	0	0	0	3
31567	507900	3	0	0	0	0	0
31567	507908	3	0	2	0	0	2
31567	507914	3	0	2	0	0	2
31567	507915	3	0	0	0	0	0
31567	507918	3	0	1	1	0	2
31567	507919	3	2	0	0	0	2
31567	507926	3	0	1	0	0	1
31567	507928	3	4	0	0	0	4
31567	507930	3	2	1	0	0	3
31567	507936	3	0	0	0	0	0
31567	185099	2	1	0	0	0	1
31567	194313	2	0	1	0	1	2
31567	212908	2	1	0	0	0	1
31567	291528	2	3	0	0	0	3
31567	507835	2	1	0	0	0	1
31567	507837	2	0	3	1	1	5
31567	507871	2	0	2	0	0	2
31567	507879	2	0	0	0	0	0
31567	507888	2	2	1	0	0	3
31567	507896	2	0	1	0	0	1
31567	507897	2	0	0	0	0	0
31567	507901	2	0	1	0	0	1
31567	507903	2	0	1	0	0	1
31567	507916	2	1	0	0	1	2
31567	507917	2	0	0	0	0	0
31567	507921	2	0	1	0	1	2
31567	507924	2	0	0	0	1	1
31567	507932	2	2	1	0	0	3
31567	565715	2	0	0	0	0	0
31567	216288	1	0	0	0	0	0
31567	507831	1	0	2	0	0	2
31567	507833	1	1	0	0	1	2
31567	507841	1	2	2	1	0	5
31567	507844	1	2	0	0	1	3
31567	507845	1	0	0	0	0	0
31567	507849	1	1	5	1	0	7
31567	507850	1	2	1	0	0	3
31567	507853	1	0	0	0	0	0
31567	507858	1	0	0	0	0	0
31567	507860	1	0	0	0	0	0
31567	507862	1	0	0	0	0	0
31567	507865	1	1	0	0	0	1
31567	507874	1	2	1	0	0	3
31567	507875	1	0	0	0	0	0
31567	507890	1	0	0	0	0	0
31567	507892	1	0	0	0	0	0
31567	507893	1	1	1	0	0	2
31567	507894	1	0	0	0	0	0
31567	507898	1	1	1	0	0	2
31567	507909	1	0	0	0	0	0
31567	507913	1	0	0	0	0	0
31567	507922	1	0	0	0	0	0
31567	507937	1	2	1	0	0	3
31567	507939	1	1	0	0	0	1
31567	523861	1	2	1	1	0	4
57915	107464	29	1	6	0	2	9
57915	480538	29	1	6	0	2	9
57915	50607	27	0	7	3	0	10
57915	100620	23	2	9	1	0	12
57915	84853	22	8	7	1	3	19
57915	103516	21	1	0	0	1	2
57915	480546	20	0	2	0	0	2
57915	102737	19	2	6	0	3	11
57915	298335	19	2	6	0	3	11
57915	85843	19	0	7	1	0	8
57915	207384	18	2	6	0	1	9
57915	480552	18	2	6	0	1	9
57915	83734	18	1	5	0	1	7
57915	86743	18	2	6	0	1	9
57915	208321	17	3	4	0	2	9
57915	208322	17	3	4	0	2	9
57915	480540	17	3	4	0	2	9
57915	480542	17	2	3	0	1	6
57915	61091	17	2	4	0	1	7
57915	65650	17	3	2	1	0	6
57915	83246	17	0	6	0	2	8
57915	91685	17	0	5	0	0	5
57915	58662	16	0	7	0	1	8
57915	91834	16	3	4	0	2	9
57915	195687	15	5	0	0	0	5
57915	59291	15	1	0	0	2	3
57915	69576	15	5	0	0	0	5
57915	187680	14	1	3	0	2	6
57915	480550	14	0	5	1	0	6
57915	480551	14	5	0	0	0	5
57915	55391	14	3	1	0	5	9
57915	59614	14	0	2	0	0	2
57915	107752	13	1	3	0	2	6
57915	480530	13	2	0	0	3	5
57915	59317	13	2	3	1	2	8
57915	99900	13	0	0	1	0	1
57915	480534	12	2	1	0	1	4
57915	53456	12	1	3	0	0	4
57915	81751	12	4	2	0	2	8
57915	85435	12	3	5	0	3	11
57915	98662	12	2	0	1	2	5
57915	106221	11	1	2	0	0	3
57915	219481	11	1	2	0	0	3
57915	298338	11	1	1	0	0	2
57915	56961	11	1	1	0	0	2
57915	298339	10	2	3	0	3	8
57915	50113	10	2	3	0	3	8
57915	68940	10	1	5	0	0	6
57915	80842	10	2	2	1	1	6
57915	103704	9	0	1	1	0	2
57915	298343	9	1	4	1	1	7
57915	480526	9	1	0	1	0	2
57915	480541	9	2	3	0	3	8
57915	52286	9	1	4	1	1	7
57915	61273	9	0	2	0	1	3
57915	84879	9	1	4	0	0	5
57915	98161	9	3	2	1	1	7
57915	221475	8	2	1	0	1	4
57915	298342	8	0	2	0	0	2
57915	480535	8	0	2	0	0	2
57915	480545	8	1	0	0	1	2
57915	51549	8	1	2	0	0	3
57915	54294	8	0	2	0	0	2
57915	55099	8	3	1	0	3	7
57915	188626	7	1	3	0	0	4
57915	191789	7	0	3	0	0	3
57915	298340	7	3	0	0	2	5
57915	49943	7	0	2	0	0	2
57915	50681	7	2	2	0	0	4
57915	74168	7	2	2	0	0	4
57915	97785	7	3	0	0	2	5
57915	184840	6	0	2	0	0	2
57915	197134	6	2	1	0	1	4
57915	298336	6	0	3	0	0	3
57915	298341	6	1	0	0	0	1
57915	480532	6	0	0	0	3	3
57915	480539	6	1	1	0	0	2
57915	480543	6	2	1	0	1	4
57915	480547	6	1	2	0	0	3
57915	480548	6	0	1	0	0	1
57915	50509	6	0	5	0	0	5
57915	58734	6	1	1	0	0	2
57915	64603	6	0	3	0	0	3
57915	72109	6	2	1	0	1	4
57915	92586	6	0	0	0	0	0
57915	104119	5	1	3	0	2	6
57915	107994	5	0	2	0	0	2
57915	211751	5	1	0	0	0	1
57915	298337	5	1	2	1	0	4
57915	480516	5	0	3	0	1	4
57915	51063	5	1	2	1	0	4
57915	56388	5	0	1	0	0	1
57915	77548	5	0	1	0	0	1
57915	94592	5	1	2	1	1	5
57915	98893	5	0	0	0	0	0
57915	194656	4	0	1	0	0	1
57915	220748	4	0	1	0	0	1
57915	298334	4	0	1	0	0	1
57915	480507	4	1	2	0	2	5
57915	480509	4	1	2	0	3	6
57915	480528	4	1	1	0	0	2
57915	480537	4	1	0	0	0	1
57915	55549	4	0	1	0	0	1
57915	103639	3	3	1	0	0	4
57915	298333	3	1	2	0	0	3
57915	480514	3	0	1	0	0	1
57915	480517	3	0	1	0	0	1
57915	480518	3	1	0	0	0	1
57915	480522	3	1	1	0	0	2
57915	480527	3	0	1	0	0	1
57915	480533	3	1	3	0	0	4
57915	480549	3	0	0	0	2	2
57915	86415	3	0	1	0	1	2
57915	95688	3	0	0	0	0	0
57915	480508	2	1	2	0	0	3
57915	480519	2	0	1	0	0	1
57915	480520	2	0	1	0	0	1
57915	480531	2	0	0	0	0	0
57915	480536	2	0	1	0	0	1
57915	480544	2	0	1	0	1	2
57915	49924	2	0	1	0	0	1
57915	53154	2	0	2	0	0	2
57915	99185	2	0	0	0	0	0
57915	99293	2	1	0	0	0	1
57915	480510	1	0	1	0	1	2
57915	480511	1	0	1	0	0	1
57915	480512	1	1	0	0	0	1
57915	480513	1	0	1	0	0	1
57915	480515	1	1	0	0	0	1
57915	480521	1	0	0	0	0	0
57915	480523	1	1	1	0	0	2
57915	480524	1	1	1	0	0	2
57915	480525	1	0	1	0	0	1
57915	480529	1	0	1	0	0	1
57915	73067	1	0	0	0	0	0
68348	196391	19	7	0	1	1	9
68348	611572	10	2	0	0	0	2
68348	611601	10	1	0	0	0	1
68348	611568	9	1	0	0	0	1
68348	611550	8	1	0	0	0	1
68348	611608	8	2	1	0	0	3
68348	611527	7	7	0	0	0	7
68348	611562	7	1	0	0	0	1
68348	611571	7	1	0	0	0	1
68348	611583	7	2	0	0	0	2
68348	611584	7	1	1	1	1	4
68348	611590	7	3	0	0	1	4
68348	611592	7	5	0	0	1	6
68348	611594	7	2	0	0	0	2
68348	611599	7	1	0	0	0	1
68348	611532	6	3	0	0	0	3
68348	611537	6	1	0	0	0	1
68348	611551	6	2	0	0	0	2
68348	611591	6	2	1	0	0	3
68348	611605	6	1	0	0	1	2
68348	611607	6	5	0	0	1	6
68348	611609	6	2	0	0	0	2
68348	611613	6	1	0	0	2	3
68348	208224	5	1	1	0	0	2
68348	611518	5	1	1	1	0	3
68348	611526	5	1	0	0	0	1
68348	611536	5	5	0	0	1	6
68348	611538	5	2	1	0	0	3
68348	611542	5	6	0	0	0	6
68348	611573	5	4	1	0	0	5
68348	611575	5	1	0	0	0	1
68348	611582	5	1	1	0	0	2
68348	611596	5	1	0	0	0	1
68348	611602	5	3	0	0	0	3
68348	611617	5	2	0	1	0	3
68348	611491	4	2	0	0	1	3
68348	611492	4	5	0	0	0	5
68348	611496	4	2	0	1	0	3
68348	611510	4	1	0	0	0	1
68348	611524	4	3	0	0	0	3
68348	611543	4	3	0	0	0	3
68348	611544	4	4	0	0	0	4
68348	611546	4	2	0	0	0	2
68348	611548	4	0	0	0	0	0
68348	611569	4	0	0	0	0	0
68348	611570	4	1	0	0	2	3
68348	611604	4	1	0	0	0	1
68348	611606	4	2	0	0	0	2
68348	611610	4	2	0	0	0	2
68348	611611	4	2	0	0	0	2
68348	611615	4	2	2	0	0	4
68348	611616	4	3	0	0	0	3
68348	611618	4	3	0	0	0	3
68348	189164	3	1	0	0	0	1
68348	611495	3	0	0	0	0	0
68348	611500	3	1	0	0	0	1
68348	611503	3	1	0	0	0	1
68348	611507	3	3	0	0	0	3
68348	611508	3	1	0	1	0	2
68348	611511	3	3	0	1	0	4
68348	611512	3	3	0	0	0	3
68348	611513	3	2	0	0	0	2
68348	611514	3	1	0	0	0	1
68348	611529	3	2	0	0	0	2
68348	611535	3	1	0	0	0	1
68348	611539	3	3	0	0	0	3
68348	611541	3	0	0	0	0	0
68348	611545	3	3	0	0	0	3
68348	611557	3	1	1	0	0	2
68348	611558	3	4	0	0	0	4
68348	611566	3	0	0	0	0	0
68348	611580	3	2	0	0	0	2
68348	611589	3	4	0	0	0	4
68348	611593	3	0	0	0	0	0
68348	611595	3	2	0	0	0	2
68348	611614	3	2	0	0	0	2
68348	611619	3	1	0	0	0	1
68348	611620	3	1	0	1	0	2
68348	611499	2	0	0	0	0	0
68348	611501	2	2	0	0	0	2
68348	611504	2	2	1	0	0	3
68348	611505	2	1	0	0	0	1
68348	611515	2	1	0	0	0	1
68348	611516	2	2	0	0	1	3
68348	611522	2	3	0	0	0	3
68348	611530	2	1	0	0	0	1
68348	611534	2	0	0	0	0	0
68348	611540	2	2	0	0	0	2
68348	611547	2	2	0	0	0	2
68348	611549	2	3	0	0	0	3
68348	611552	2	0	0	0	0	0
68348	611553	2	2	1	0	0	3
68348	611554	2	4	1	0	0	5
68348	611555	2	1	0	0	0	1
68348	611556	2	2	0	0	0	2
68348	611559	2	1	0	0	0	1
68348	611561	2	0	0	0	0	0
68348	611564	2	0	0	0	0	0
68348	611565	2	1	0	0	0	1
68348	611574	2	0	0	0	0	0
68348	611576	2	2	0	0	0	2
68348	611577	2	3	0	0	0	3
68348	611578	2	1	0	0	0	1
68348	611579	2	2	0	0	0	2
68348	611581	2	0	0	0	0	0
68348	611585	2	1	0	0	0	1
68348	611586	2	1	1	0	1	3
68348	611598	2	3	0	0	0	3
68348	611600	2	0	0	0	0	0
68348	611603	2	2	0	0	1	3
68348	611612	2	1	0	0	0	1
68348	611622	2	1	0	1	0	2
68348	611490	1	2	0	0	0	2
68348	611493	1	1	0	0	0	1
68348	611494	1	3	0	0	0	3
68348	611497	1	1	0	0	0	1
68348	611498	1	1	0	0	0	1
68348	611502	1	0	0	0	0	0
68348	611506	1	1	0	0	0	1
68348	611509	1	1	0	0	0	1
68348	611517	1	1	0	0	0	1
68348	611519	1	1	0	0	0	1
68348	611520	1	1	0	0	0	1
68348	611521	1	1	0	0	0	1
68348	611523	1	1	0	0	0	1
68348	611525	1	0	0	0	0	0
68348	611528	1	0	0	0	0	0
68348	611531	1	2	0	0	0	2
68348	611533	1	1	0	0	0	1
68348	611560	1	1	0	0	0	1
68348	611563	1	1	0	1	0	2
68348	611567	1	1	1	0	0	2
68348	611587	1	0	0	1	0	1
68348	611588	1	3	0	0	0	3
68348	611597	1	0	0	0	0	0
68348	611621	1	3	0	0	0	3
39084	210209	39	2	6	0	1	9
39084	480564	26	3	4	0	3	10
39084	100487	22	4	0	1	1	6
39084	101285	18	1	1	0	0	2
39084	293709	15	4	1	1	2	8
39084	57449	15	4	1	1	2	8
39084	101093	13	4	2	0	0	6
39084	185997	13	2	6	0	1	9
39084	293719	13	2	6	0	1	9
39084	293730	13	4	2	0	0	6
39084	480565	13	2	6	0	1	9
39084	210870	12	1	4	0	0	5
39084	480585	12	1	4	0	0	5
39084	480566	11	0	1	0	0	1
39084	480571	10	3	1	0	0	4
39084	480573	10	2	1	0	0	3
39084	480589	10	1	4	1	1	7
39084	188779	9	1	0	0	1	2
39084	204049	9	3	1	0	0	4
39084	221583	9	0	2	1	0	3
39084	293727	9	1	0	0	1	2
39084	464594	9	3	2	0	5	10
39084	480556	9	2	0	0	1	3
39084	220545	8	1	0	0	0	1
39084	293715	8	2	0	0	0	2
39084	293722	8	1	1	0	0	2
39084	464588	8	2	1	0	0	3
39084	464592	8	1	2	0	1	4
39084	480572	8	1	0	0	0	1
39084	480575	8	0	0	1	0	1
39084	480577	8	1	1	0	0	2
39084	480594	8	0	0	1	1	2
39084	71138	8	2	0	0	0	2
39084	220229	7	1	0	0	1	2
39084	293710	7	1	0	0	0	1
39084	293716	7	0	1	0	0	1
39084	293721	7	5	0	0	0	5
39084	464589	7	1	1	0	0	2
39084	464590	7	0	2	0	2	4
39084	464593	7	2	1	0	3	6
39084	480567	7	0	0	0	0	0
39084	480591	7	2	3	0	2	7
39084	52501	7	5	0	0	0	5
39084	97958	7	1	0	0	0	1
39084	100066	6	1	0	0	0	1
39084	210013	6	0	1	0	0	1
39084	214198	6	1	0	0	0	1
39084	218744	6	4	0	0	0	4
39084	293712	6	1	0	0	0	1
39084	293728	6	3	0	0	0	3
39084	464586	6	2	1	0	0	3
39084	480554	6	3	0	0	1	4
39084	480563	6	0	1	0	0	1
39084	480578	6	2	1	0	0	3
39084	480581	6	2	1	0	3	6
39084	480584	6	0	2	0	0	2
39084	480587	6	3	0	0	0	3
39084	480588	6	1	1	1	0	3
39084	91958	6	3	0	0	0	3
39084	184299	5	0	1	0	1	2
39084	188038	5	1	2	0	0	3
39084	192162	5	4	0	0	0	4
39084	207141	5	0	1	1	0	2
39084	208684	5	0	3	0	0	3
39084	293706	5	0	1	0	0	1
39084	293718	5	1	0	0	0	1
39084	480558	5	1	2	0	0	3
39084	480559	5	2	1	0	1	4
39084	480561	5	0	0	0	0	0
39084	480579	5	0	1	0	0	1
39084	480580	5	0	1	0	0	1
39084	480593	5	0	3	0	0	3
39084	79158	5	1	0	0	0	1
39084	93001	5	0	1	0	0	1
39084	190746	4	0	1	0	0	1
39084	195749	4	1	0	0	0	1
39084	197034	4	2	2	0	0	4
39084	206045	4	0	1	0	0	1
39084	211632	4	0	1	0	0	1
39084	464587	4	1	0	0	1	2
39084	480557	4	0	1	0	0	1
39084	480562	4	2	1	0	0	3
39084	480568	4	0	0	0	0	0
39084	480569	4	1	0	0	0	1
39084	480570	4	2	1	0	0	3
39084	480582	4	1	1	0	0	2
39084	480586	4	3	0	1	0	4
39084	480590	4	0	1	0	0	1
39084	189930	3	0	0	0	1	1
39084	196457	3	1	0	0	0	1
39084	200091	3	0	0	0	0	0
39084	204303	3	0	0	0	0	0
39084	214295	3	1	0	0	0	1
39084	293704	3	0	0	0	0	0
39084	293711	3	1	1	0	0	2
39084	293713	3	1	0	0	0	1
39084	293724	3	1	0	0	0	1
39084	293729	3	1	0	2	1	4
39084	464583	3	2	0	0	2	4
39084	464584	3	2	3	0	0	5
39084	464585	3	0	2	0	0	2
39084	480555	3	0	0	0	0	0
39084	480576	3	1	1	0	0	2
39084	71466	3	0	0	0	0	0
39084	72004	3	1	0	0	0	1
39084	72462	3	1	0	2	1	4
39084	105293	2	1	0	0	0	1
39084	182288	2	1	0	0	0	1
39084	206987	2	1	0	0	0	1
39084	293703	2	0	1	0	0	1
39084	293705	2	0	1	0	0	1
39084	293708	2	0	0	0	0	0
39084	293714	2	0	0	0	0	0
39084	293717	2	0	0	0	0	0
39084	293720	2	1	0	0	0	1
39084	293723	2	1	0	0	0	1
39084	464591	2	0	0	0	0	0
39084	53700	2	1	0	0	0	1
39084	70827	2	0	1	0	0	1
39084	84436	2	0	0	0	0	0
39084	84713	2	0	1	0	0	1
39084	192453	1	0	1	0	0	1
39084	195677	1	1	1	0	0	2
39084	199881	1	1	0	0	1	2
39084	205258	1	0	0	0	0	0
39084	293707	1	0	1	0	0	1
39084	293725	1	0	0	0	0	0
39084	293726	1	0	0	0	0	0
39084	480560	1	1	0	0	0	1
39084	480574	1	0	3	0	0	3
39084	480583	1	0	2	0	0	2
39084	480592	1	0	0	0	0	0
39084	64486	1	0	1	0	0	1
39084	71020	1	0	0	0	0	0
10706	202281	36	0	2	1	1	4
10706	590367	35	0	2	1	1	4
10706	82650	35	0	2	1	1	4
10706	198966	32	0	3	0	0	3
10706	285810	32	0	3	0	0	3
10706	74330	32	0	3	0	0	3
10706	590396	19	1	5	0	0	6
10706	78719	19	2	5	0	1	8
10706	590408	15	0	2	0	3	5
10706	91719	15	0	2	0	3	5
10706	105756	13	1	2	0	0	3
10706	219391	13	1	2	0	0	3
10706	285805	12	0	2	0	2	4
10706	221857	11	2	6	0	3	11
10706	80665	11	0	2	0	2	4
10706	221364	10	1	1	1	0	3
10706	55127	10	4	2	0	0	6
10706	57853	10	0	1	1	0	2
10706	590380	10	2	2	1	0	5
10706	590385	10	1	1	0	0	2
10706	590386	10	1	2	0	0	3
10706	200711	9	0	1	0	0	1
10706	221579	9	1	2	0	2	5
10706	285807	9	0	2	0	0	2
10706	76452	9	0	2	0	0	2
10706	195108	8	0	2	0	0	2
10706	195479	8	2	2	0	0	4
10706	285802	8	1	1	0	0	2
10706	285803	8	2	1	1	0	4
10706	285806	8	1	1	3	0	5
10706	590401	8	0	5	0	1	6
10706	70746	8	1	1	0	0	2
10706	85854	8	2	2	0	2	6
10706	88759	8	1	1	2	0	4
10706	209852	7	0	1	0	2	3
10706	285811	7	2	2	0	0	4
10706	590404	7	2	2	0	0	4
10706	590405	7	0	3	1	2	6
10706	105419	6	0	1	0	2	3
10706	107581	6	0	1	0	0	1
10706	191344	6	0	1	0	0	1
10706	194772	6	0	2	0	0	2
10706	211294	6	1	3	0	2	6
10706	285804	6	0	1	0	2	3
10706	590390	6	0	3	0	0	3
10706	590391	6	0	3	0	0	3
10706	590406	6	1	4	0	0	5
10706	590407	6	1	1	0	0	2
10706	62347	6	1	1	0	2	4
10706	66599	6	0	1	0	1	2
10706	100979	5	1	1	0	0	2
10706	184285	5	2	0	1	1	4
10706	190540	5	0	1	0	0	1
10706	193513	5	1	2	0	0	3
10706	199844	5	1	1	0	1	3
10706	200553	5	0	2	0	2	4
10706	211651	5	1	4	0	3	8
10706	285808	5	1	1	0	0	2
10706	285809	5	0	0	0	2	2
10706	52386	5	0	3	0	0	3
10706	590366	5	1	1	0	0	2
10706	590370	5	0	2	0	0	2
10706	590374	5	0	0	0	1	1
10706	590384	5	1	1	0	0	2
10706	590388	5	1	2	0	1	4
10706	590397	5	0	2	0	2	4
10706	590409	5	1	2	0	1	4
10706	72279	5	0	2	0	2	4
10706	74683	5	0	2	0	2	4
10706	108012	4	1	1	0	0	2
10706	183683	4	0	2	0	0	2
10706	187879	4	2	2	0	3	7
10706	188945	4	0	1	0	0	1
10706	190011	4	0	1	0	2	3
10706	191048	4	1	1	0	0	2
10706	191743	4	0	1	0	0	1
10706	197830	4	0	0	0	0	0
10706	201766	4	0	1	1	0	2
10706	205449	4	0	4	0	0	4
10706	213360	4	0	1	0	0	1
10706	215816	4	1	1	0	0	2
10706	220339	4	1	2	0	0	3
10706	285801	4	1	1	0	0	2
10706	50388	4	1	0	0	0	1
10706	590377	4	1	0	0	4	5
10706	590381	4	1	1	0	0	2
10706	590383	4	0	1	0	0	1
10706	590402	4	0	0	0	0	0
10706	183831	3	0	0	0	0	0
10706	184399	3	0	1	0	0	1
10706	189393	3	0	0	0	0	0
10706	199952	3	0	1	0	0	1
10706	203663	3	0	0	0	0	0
10706	217124	3	3	1	0	0	4
10706	220689	3	1	1	0	0	2
10706	285800	3	0	1	0	0	1
10706	50438	3	2	3	0	0	5
10706	590365	3	0	1	0	1	2
10706	590376	3	0	0	0	0	0
10706	590392	3	0	1	0	2	3
10706	590395	3	1	1	0	2	4
10706	590398	3	2	1	0	0	3
10706	64269	3	0	1	0	0	1
10706	88797	3	0	0	0	1	1
10706	182149	2	0	1	0	0	1
10706	194085	2	0	1	0	0	1
10706	198478	2	0	2	0	0	2
10706	207166	2	1	0	0	0	1
10706	217357	2	0	2	0	0	2
10706	50490	2	0	0	0	1	1
10706	590363	2	0	1	0	0	1
10706	590373	2	1	1	0	0	2
10706	590375	2	0	3	0	0	3
10706	590378	2	0	2	0	0	2
10706	590379	2	1	0	0	0	1
10706	590387	2	1	0	0	0	1
10706	590389	2	0	0	0	1	1
10706	590393	2	1	0	0	0	1
10706	590399	2	1	1	0	1	3
10706	590400	2	0	1	0	0	1
10706	590403	2	0	0	0	0	0
10706	107161	1	0	1	0	0	1
10706	219933	1	0	1	0	0	1
10706	590361	1	0	0	0	0	0
10706	590362	1	0	1	0	1	2
10706	590364	1	0	0	0	0	0
10706	590368	1	0	1	0	0	1
10706	590369	1	0	1	0	0	1
10706	590371	1	2	0	0	0	2
10706	590372	1	0	0	0	0	0
10706	590382	1	0	1	0	0	1
10706	590394	1	0	2	0	0	2
10706	70530	1	0	1	0	0	1
10706	88832	1	0	0	0	0	0
18535	82389	31	4	3	0	1	8
18535	473910	12	3	0	0	1	4
18535	183771	11	0	2	0	0	2
18535	473801	11	2	2	0	0	4
18535	104307	10	0	0	0	0	0
18535	473804	10	0	0	0	1	1
18535	473819	10	0	1	0	1	2
18535	473824	10	0	1	0	2	3
18535	473848	10	1	2	1	1	5
18535	473825	9	0	0	1	0	1
18535	473856	9	2	0	0	3	5
18535	473862	9	1	0	0	1	2
18535	473904	9	0	5	0	2	7
18535	277072	8	0	1	0	0	1
18535	473810	8	0	0	1	2	3
18535	473840	8	0	2	1	1	4
18535	473850	8	2	2	0	1	5
18535	473861	8	1	2	0	4	7
18535	101345	7	2	1	1	0	4
18535	473805	7	1	0	0	0	1
18535	473815	7	0	2	1	0	3
18535	473885	7	2	0	0	0	2
18535	186191	6	1	1	0	0	2
18535	209576	6	0	1	0	1	2
18535	220131	6	3	0	0	0	3
18535	277076	6	1	1	0	1	3
18535	473813	6	1	1	0	2	4
18535	473823	6	1	1	0	0	2
18535	473842	6	0	1	0	0	1
18535	473847	6	0	0	0	0	0
18535	473849	6	0	0	0	0	0
18535	473853	6	0	1	0	0	1
18535	473880	6	0	0	0	1	1
18535	473901	6	0	0	0	1	1
18535	277071	5	1	1	0	0	2
18535	473803	5	2	4	0	0	6
18535	473808	5	0	1	0	0	1
18535	473809	5	0	1	0	1	2
18535	473814	5	2	1	0	0	3
18535	473829	5	2	0	0	0	2
18535	473831	5	0	2	0	1	3
18535	473834	5	0	1	0	0	1
18535	473858	5	1	1	0	1	3
18535	473859	5	0	1	0	0	1
18535	473864	5	1	0	1	0	2
18535	473875	5	1	0	1	1	3
18535	473876	5	2	1	0	0	3
18535	473878	5	1	1	0	0	2
18535	473884	5	2	0	0	2	4
18535	473893	5	0	0	0	1	1
18535	473902	5	1	0	0	1	2
18535	195285	4	0	2	1	0	3
18535	277078	4	1	1	0	0	2
18535	473807	4	1	0	0	0	1
18535	473811	4	3	2	0	0	5
18535	473816	4	1	0	1	0	2
18535	473818	4	1	0	0	0	1
18535	473820	4	0	0	1	0	1
18535	473826	4	1	4	0	1	6
18535	473830	4	0	0	0	0	0
18535	473832	4	0	0	0	1	1
18535	473833	4	0	0	0	0	0
18535	473836	4	0	0	0	0	0
18535	473844	4	2	0	0	0	2
18535	473845	4	0	0	0	0	0
18535	473852	4	0	0	0	0	0
18535	473867	4	0	1	0	0	1
18535	473877	4	1	0	0	0	1
18535	473886	4	0	1	0	0	1
18535	473888	4	0	1	0	0	1
18535	473899	4	1	1	0	1	3
18535	473905	4	1	0	0	0	1
18535	473909	4	0	1	0	0	1
18535	71980	4	0	2	0	0	2
18535	189497	3	0	1	0	0	1
18535	193586	3	0	1	0	0	1
18535	207124	3	1	2	0	0	3
18535	212971	3	1	1	0	0	2
18535	277073	3	1	0	0	0	1
18535	277075	3	0	1	0	0	1
18535	473802	3	1	0	0	0	1
18535	473822	3	0	0	0	0	0
18535	473828	3	0	1	0	1	2
18535	473835	3	0	1	0	0	1
18535	473855	3	2	1	0	0	3
18535	473865	3	0	0	1	0	1
18535	473868	3	0	0	0	0	0
18535	473869	3	0	0	0	0	0
18535	473870	3	0	0	0	0	0
18535	473873	3	0	1	0	0	1
18535	473874	3	2	0	0	3	5
18535	473883	3	1	1	0	0	2
18535	473889	3	0	0	0	0	0
18535	473890	3	1	0	0	0	1
18535	473892	3	0	1	0	0	1
18535	473896	3	0	1	0	0	1
18535	473906	3	0	2	0	1	3
18535	186649	2	1	0	0	1	2
18535	473800	2	0	0	0	0	0
18535	473806	2	1	0	0	1	2
18535	473812	2	0	0	0	0	0
18535	473821	2	0	1	0	0	1
18535	473827	2	0	0	0	0	0
18535	473837	2	0	1	0	0	1
18535	473838	2	1	1	0	0	2
18535	473839	2	0	0	0	0	0
18535	473841	2	1	0	0	0	1
18535	473854	2	0	0	0	1	1
18535	473857	2	0	1	0	0	1
18535	473871	2	1	2	0	0	3
18535	473872	2	0	1	0	0	1
18535	473881	2	0	1	0	0	1
18535	473882	2	0	0	0	0	0
18535	473891	2	0	0	0	0	0
18535	473894	2	0	0	0	0	0
18535	473895	2	0	0	0	0	0
18535	473897	2	0	0	0	0	0
18535	473898	2	0	1	0	0	1
18535	473903	2	2	3	2	0	7
18535	473907	2	0	2	0	0	2
18535	473908	2	0	2	0	0	2
18535	202593	1	1	0	0	0	1
18535	220279	1	0	1	0	0	1
18535	277074	1	0	0	0	0	0
18535	277077	1	0	0	0	0	0
18535	473817	1	0	0	2	1	3
18535	473843	1	0	1	0	0	1
18535	473846	1	2	0	0	0	2
18535	473851	1	2	1	0	0	3
18535	473860	1	1	0	0	0	1
18535	473863	1	1	0	0	1	2
18535	473866	1	0	1	0	0	1
18535	473879	1	0	1	0	1	2
18535	473887	1	1	0	0	0	1
18535	473900	1	0	0	0	0	0
571	82315	38	5	12	2	0	19
571	198797	36	3	4	1	3	11
571	283072	36	3	4	1	3	11
571	74297	36	3	4	1	3	11
571	504771	29	4	1	1	5	11
571	79768	25	2	1	1	1	5
571	101234	24	7	1	1	1	10
571	206991	20	4	3	1	0	8
571	504740	19	1	0	0	0	1
571	504739	18	3	3	0	0	6
571	57720	16	1	0	0	0	1
571	220118	15	2	3	0	2	7
571	504737	15	3	4	0	0	7
571	504738	15	3	4	0	0	7
571	107401	14	2	3	0	2	7
571	504772	14	2	3	0	2	7
571	55115	11	3	1	0	0	4
571	504735	10	1	2	0	0	3
571	59247	10	0	1	2	1	4
571	101948	9	6	1	0	0	7
571	188025	9	2	4	0	0	6
571	214744	9	6	1	0	0	7
571	283068	9	2	3	0	0	5
571	283073	9	6	1	0	0	7
571	504726	9	2	3	0	0	5
571	504775	9	1	1	0	0	2
571	92693	9	2	3	0	0	5
571	187818	8	1	0	2	0	3
571	208052	8	1	1	2	0	4
571	504730	8	1	3	1	1	6
571	504764	8	3	2	0	0	5
571	72499	8	1	6	0	0	7
571	107915	7	1	1	1	0	3
571	504770	7	1	1	1	0	3
571	51167	7	0	0	1	0	1
571	105230	6	0	3	0	0	3
571	105657	6	0	0	0	0	0
571	219549	6	0	0	0	0	0
571	283076	6	1	3	1	0	5
571	504731	6	2	2	0	1	5
571	504732	6	1	0	0	1	2
571	504753	6	2	1	0	0	3
571	504773	6	1	0	0	0	1
571	193412	5	0	3	0	2	5
571	195278	5	0	5	0	0	5
571	195330	5	1	2	0	1	4
571	203578	5	1	1	0	0	2
571	215859	5	1	2	0	0	3
571	283078	5	0	1	0	0	1
571	50206	5	1	2	0	0	3
571	50219	5	1	0	0	0	1
571	504724	5	0	4	0	0	4
571	504734	5	0	0	0	0	0
571	504742	5	2	0	0	0	2
571	504743	5	1	2	0	0	3
571	504769	5	1	0	0	0	1
571	504776	5	1	2	0	0	3
571	90499	5	0	1	0	0	1
571	100940	4	0	1	1	0	2
571	187214	4	1	1	0	0	2
571	192461	4	1	0	0	0	1
571	196620	4	0	0	0	2	2
571	204199	4	0	1	0	0	1
571	283077	4	0	1	1	0	2
571	504733	4	3	4	0	1	8
571	504741	4	1	1	0	0	2
571	504745	4	3	2	0	1	6
571	504749	4	2	2	1	0	5
571	504750	4	1	1	0	0	2
571	504754	4	1	0	1	0	2
571	504757	4	1	3	0	0	4
571	504766	4	0	2	0	1	3
571	504768	4	0	0	0	0	0
571	504777	4	3	3	0	0	6
571	51430	4	0	3	0	2	5
571	75059	4	3	3	0	0	6
571	104511	3	0	2	0	0	2
571	182237	3	0	1	0	0	1
571	189517	3	1	0	0	0	1
571	195543	3	1	1	0	0	2
571	211199	3	0	0	0	0	0
571	214257	3	1	0	1	0	2
571	283075	3	1	0	1	0	2
571	504722	3	1	1	0	0	2
571	504725	3	0	4	0	1	5
571	504727	3	1	1	0	0	2
571	504728	3	1	2	0	0	3
571	504729	3	0	0	0	0	0
571	504736	3	1	2	0	0	3
571	504744	3	2	0	0	0	2
571	504747	3	4	1	0	0	5
571	504752	3	1	1	0	1	3
571	504755	3	1	1	0	0	2
571	504760	3	2	2	0	1	5
571	504761	3	2	2	0	3	7
571	504762	3	0	1	0	0	1
571	504765	3	1	1	0	0	2
571	53611	3	1	0	1	0	2
571	57144	3	0	6	0	0	6
571	74152	3	1	0	1	0	2
571	98843	3	0	2	0	1	3
571	108424	2	0	0	0	0	0
571	195839	2	0	2	0	0	2
571	196433	2	1	0	0	0	1
571	208200	2	1	0	0	0	1
571	220316	2	0	2	0	0	2
571	283070	2	1	2	0	0	3
571	283071	2	0	1	0	0	1
571	504718	2	0	1	0	1	2
571	504723	2	0	1	0	0	1
571	504748	2	1	0	0	0	1
571	504751	2	0	0	0	0	0
571	504756	2	0	1	0	0	1
571	504758	2	0	0	0	0	0
571	504759	2	1	1	0	1	3
571	504763	2	0	3	0	0	3
571	504774	2	0	1	0	0	1
571	56136	2	1	2	0	0	3
571	61291	2	0	1	0	0	1
571	67213	2	1	0	0	0	1
571	94553	2	1	2	0	0	3
571	185317	1	1	1	0	0	2
571	191287	1	0	1	0	1	2
571	213435	1	0	2	0	0	2
571	283069	1	1	0	0	0	1
571	504719	1	1	1	0	1	3
571	504720	1	0	0	0	0	0
571	504721	1	1	1	0	0	2
571	504746	1	0	0	0	0	0
571	504767	1	1	2	0	0	3
571	54458	1	1	0	0	0	1
571	77884	1	0	1	0	0	1
11360	106533	48	0	6	0	2	8
11360	546240	20	0	0	0	1	1
11360	546249	10	6	3	0	0	9
11360	546251	8	3	1	0	0	4
11360	84376	8	4	2	0	1	7
11360	546234	7	3	1	0	0	4
11360	546235	7	4	0	0	0	4
11360	546297	7	4	1	0	1	6
11360	546299	7	3	2	0	1	6
11360	546327	7	1	0	0	1	2
11360	546202	6	0	2	1	0	3
11360	546222	6	4	1	0	0	5
11360	546267	6	3	0	0	0	3
11360	546300	6	2	4	0	0	6
11360	546198	5	1	2	1	0	4
11360	546213	5	2	1	0	0	3
11360	546223	5	0	0	0	0	0
11360	546236	5	0	0	0	0	0
11360	546253	5	1	0	0	0	1
11360	546278	5	1	1	0	0	2
11360	546283	5	3	1	0	0	4
11360	546295	5	0	0	0	0	0
11360	546325	5	3	4	0	0	7
11360	546210	4	0	0	0	0	0
11360	546216	4	1	0	0	0	1
11360	546218	4	1	0	0	1	2
11360	546229	4	1	0	0	0	1
11360	546239	4	1	2	0	0	3
11360	546256	4	1	0	0	0	1
11360	546257	4	3	0	0	0	3
11360	546264	4	3	0	0	0	3
11360	546268	4	1	0	0	0	1
11360	546269	4	2	0	0	0	2
11360	546271	4	2	1	0	0	3
11360	546273	4	0	2	0	0	2
11360	546284	4	0	2	0	0	2
11360	546286	4	0	0	0	0	0
11360	546292	4	0	0	0	1	1
11360	546293	4	1	0	0	0	1
11360	546303	4	1	0	0	0	1
11360	546305	4	0	0	0	0	0
11360	546318	4	1	0	0	0	1
11360	546321	4	3	2	0	0	5
11360	546324	4	1	0	0	0	1
11360	546328	4	0	1	1	0	2
11360	546201	3	2	0	0	0	2
11360	546207	3	2	0	0	0	2
11360	546208	3	0	0	0	0	0
11360	546209	3	0	0	0	1	1
11360	546211	3	0	1	0	0	1
11360	546215	3	1	1	0	0	2
11360	546221	3	1	1	0	1	3
11360	546224	3	3	0	0	0	3
11360	546226	3	0	0	0	0	0
11360	546228	3	2	0	0	0	2
11360	546231	3	0	0	0	0	0
11360	546244	3	1	0	0	0	1
11360	546248	3	0	1	0	0	1
11360	546258	3	1	0	0	0	1
11360	546260	3	3	2	0	0	5
11360	546265	3	2	1	0	0	3
11360	546266	3	3	3	0	0	6
11360	546270	3	1	0	0	1	2
11360	546275	3	1	0	0	0	1
11360	546276	3	3	0	0	0	3
11360	546277	3	4	1	0	0	5
11360	546285	3	1	1	0	1	3
11360	546294	3	1	0	0	0	1
11360	546298	3	0	1	0	1	2
11360	546306	3	0	2	0	0	2
11360	546307	3	1	1	0	0	2
11360	546310	3	1	0	0	0	1
11360	546313	3	2	0	0	0	2
11360	546314	3	2	1	0	0	3
11360	546315	3	2	0	0	2	4
11360	546319	3	3	1	0	0	4
11360	546320	3	1	0	0	0	1
11360	546322	3	0	0	1	0	1
11360	546326	3	3	0	0	1	4
11360	286052	2	0	0	0	0	0
11360	546199	2	1	0	0	0	1
11360	546200	2	2	1	0	0	3
11360	546203	2	0	0	0	0	0
11360	546205	2	3	0	0	0	3
11360	546214	2	2	0	0	0	2
11360	546217	2	1	0	0	0	1
11360	546219	2	1	1	0	2	4
11360	546227	2	0	0	0	0	0
11360	546230	2	2	0	0	1	3
11360	546233	2	1	0	0	0	1
11360	546237	2	1	0	0	0	1
11360	546241	2	1	0	0	0	1
11360	546243	2	1	0	0	1	2
11360	546250	2	2	1	0	0	3
11360	546252	2	2	1	0	0	3
11360	546255	2	2	1	0	1	4
11360	546259	2	1	1	0	0	2
11360	546261	2	1	0	0	0	1
11360	546262	2	0	0	0	0	0
11360	546263	2	0	0	0	1	1
11360	546272	2	1	0	0	0	1
11360	546274	2	0	0	0	1	1
11360	546279	2	1	0	0	0	1
11360	546280	2	0	2	0	0	2
11360	546281	2	2	0	0	0	2
11360	546282	2	2	1	0	0	3
11360	546287	2	1	1	0	3	5
11360	546289	2	3	1	0	0	4
11360	546296	2	1	1	0	0	2
11360	546309	2	2	0	0	0	2
11360	546311	2	1	1	0	0	2
11360	546312	2	2	0	0	0	2
11360	546316	2	0	1	0	0	1
11360	546317	2	2	3	1	1	7
11360	546323	2	1	1	0	0	2
11360	546204	1	1	0	1	0	2
11360	546206	1	1	0	0	0	1
11360	546212	1	1	0	0	0	1
11360	546220	1	2	0	0	0	2
11360	546225	1	1	0	0	0	1
11360	546232	1	1	0	0	1	2
11360	546238	1	0	1	0	0	1
11360	546242	1	1	0	0	0	1
11360	546245	1	0	0	0	0	0
11360	546246	1	0	0	0	0	0
11360	546247	1	1	0	0	0	1
11360	546254	1	0	0	0	0	0
11360	546288	1	1	1	0	0	2
11360	546290	1	2	0	0	0	2
11360	546291	1	1	1	0	0	2
11360	546301	1	1	0	0	0	1
11360	546302	1	2	1	1	1	5
11360	546304	1	3	0	0	0	3
11360	546308	1	1	0	0	0	1
36691	292963	77	3	14	4	1	22
36691	56778	77	3	14	4	1	22
36691	83210	40	1	9	0	0	10
36691	394977	39	1	9	0	0	10
36691	394953	35	4	10	0	0	14
36691	79334	32	3	9	0	1	13
36691	394956	31	3	9	0	1	13
36691	52825	29	1	0	0	1	2
36691	394973	25	1	5	0	0	6
36691	83367	25	1	5	0	0	6
36691	394951	22	1	5	0	1	7
36691	292959	21	1	1	1	2	5
36691	394979	21	1	1	1	2	5
36691	52247	21	1	1	1	2	5
36691	55269	21	2	3	2	0	7
36691	394946	19	2	1	2	0	5
36691	394955	18	3	1	0	0	4
36691	292964	17	0	3	0	0	3
36691	394961	17	1	4	0	1	6
36691	106033	16	0	1	0	0	1
36691	219160	16	0	1	0	0	1
36691	394950	16	0	0	0	0	0
36691	204391	15	1	3	0	1	5
36691	292954	15	1	0	0	0	1
36691	292955	15	2	3	0	1	6
36691	394959	15	1	7	0	0	8
36691	394983	15	3	1	0	1	5
36691	56943	15	1	0	0	0	1
36691	394945	14	0	1	0	0	1
36691	51892	14	0	2	0	0	2
36691	55240	14	5	4	1	4	14
36691	82214	14	0	2	1	0	3
36691	84426	14	1	4	1	1	7
36691	394949	13	1	2	1	0	4
36691	394982	13	3	2	0	0	5
36691	394984	13	5	1	0	0	6
36691	394962	12	1	0	0	0	1
36691	198736	11	1	3	0	0	4
36691	292958	11	1	3	0	0	4
36691	394914	11	4	3	1	0	8
36691	394938	11	0	2	0	1	3
36691	394939	11	0	2	0	1	3
36691	74421	11	1	3	0	0	4
36691	105570	10	2	7	0	1	10
36691	394948	10	1	2	1	0	4
36691	394960	10	2	3	0	2	7
36691	81562	10	2	1	1	0	4
36691	292962	9	0	0	0	0	0
36691	394915	9	1	1	0	0	2
36691	66424	9	2	2	0	1	5
36691	292956	8	1	7	0	0	8
36691	292960	8	1	3	0	0	4
36691	394912	8	0	2	0	1	3
36691	394944	8	1	5	0	1	7
36691	394957	8	1	2	1	0	4
36691	394975	8	1	2	1	0	4
36691	49643	8	0	1	0	0	1
36691	188528	7	2	2	0	0	4
36691	394947	7	1	2	0	0	3
36691	394978	7	1	1	0	0	2
36691	60025	7	2	2	0	0	4
36691	69520	7	1	1	0	0	2
36691	84868	7	2	3	0	1	6
36691	394917	6	1	1	0	0	2
36691	394942	6	2	1	0	0	3
36691	394954	6	0	4	0	2	6
36691	394958	6	0	5	0	1	6
36691	394964	6	2	1	1	0	4
36691	394976	6	2	2	1	1	6
36691	50089	6	1	7	0	0	8
36691	82038	6	0	2	0	0	2
36691	106899	5	0	4	2	0	6
36691	292961	5	1	1	0	2	4
36691	394920	5	1	2	2	0	5
36691	394928	5	0	3	0	0	3
36691	394970	5	1	1	0	0	2
36691	394974	5	0	2	0	0	2
36691	394981	5	1	1	0	0	2
36691	68780	5	0	2	0	0	2
36691	97739	5	1	1	0	2	4
36691	107585	4	0	0	0	0	0
36691	394933	4	3	1	0	0	4
36691	394934	4	0	1	0	0	1
36691	394943	4	0	0	0	0	0
36691	394963	4	0	1	0	1	2
36691	394972	4	1	1	0	1	3
36691	54940	4	0	1	0	0	1
36691	66620	4	1	1	0	0	2
36691	74163	4	2	2	0	0	4
36691	208448	3	1	1	0	0	2
36691	394909	3	0	0	0	0	0
36691	394913	3	0	2	1	0	3
36691	394919	3	1	3	0	0	4
36691	394927	3	3	2	0	0	5
36691	394932	3	0	1	0	1	2
36691	394937	3	1	1	0	1	3
36691	394940	3	1	0	0	0	1
36691	394969	3	2	2	0	0	4
36691	56325	3	2	0	0	0	2
36691	64103	3	0	1	0	0	1
36691	88482	3	0	2	0	0	2
36691	202171	2	0	1	0	0	1
36691	292957	2	0	2	0	1	3
36691	394910	2	2	0	0	1	3
36691	394911	2	2	2	1	0	5
36691	394916	2	1	1	0	1	3
36691	394923	2	0	2	0	0	2
36691	394925	2	1	1	0	0	2
36691	394930	2	0	0	0	0	0
36691	394936	2	0	1	0	0	1
36691	394941	2	0	0	0	0	0
36691	394965	2	0	2	0	0	2
36691	394966	2	1	1	0	0	2
36691	394967	2	1	0	0	0	1
36691	394971	2	0	0	0	0	0
36691	61777	2	0	2	0	1	3
36691	195692	1	2	2	0	0	4
36691	394906	1	0	1	0	0	1
36691	394907	1	1	0	0	0	1
36691	394908	1	0	2	0	0	2
36691	394918	1	1	1	0	0	2
36691	394921	1	0	1	0	0	1
36691	394922	1	0	1	0	0	1
36691	394924	1	1	2	0	1	4
36691	394926	1	0	1	0	1	2
36691	394929	1	0	2	0	0	2
36691	394931	1	3	3	0	0	6
36691	394935	1	0	1	0	0	1
36691	394952	1	0	2	0	1	3
36691	394968	1	0	0	0	0	0
36691	394980	1	1	0	0	0	1
36691	49934	1	0	3	0	0	3
129075	488631	25	5	2	0	0	7
129075	488655	24	2	0	0	0	2
129075	488602	19	0	0	0	0	0
129075	488672	19	4	4	1	2	11
129075	488690	18	3	2	2	0	7
129075	488608	13	1	1	0	0	2
129075	488609	13	1	1	0	0	2
129075	488611	13	1	1	0	0	2
129075	488612	13	1	1	0	0	2
129075	488635	13	2	0	0	0	2
129075	488671	13	1	1	0	0	2
129075	488646	12	1	0	0	0	1
129075	488665	12	1	2	0	0	3
129075	488641	10	3	1	0	0	4
129075	488650	10	1	2	0	0	3
129075	488681	10	1	3	0	0	4
129075	488695	10	3	2	0	0	5
129075	488583	9	1	2	0	0	3
129075	488607	9	1	3	0	1	5
129075	488615	9	2	3	0	0	5
129075	488644	9	0	3	0	3	6
129075	488586	8	0	1	0	1	2
129075	488596	8	0	2	0	0	2
129075	488597	8	0	2	0	0	2
129075	488599	8	0	2	0	0	2
129075	488617	8	1	3	0	0	4
129075	488676	8	1	2	0	0	3
129075	488683	8	0	1	0	2	3
129075	488594	7	1	1	0	1	3
129075	488613	7	0	2	1	1	4
129075	488618	7	1	2	0	0	3
129075	488652	7	1	1	0	0	2
129075	488657	7	0	3	1	1	5
129075	488660	7	3	3	0	0	6
129075	488677	7	1	0	1	0	2
129075	488687	7	1	1	0	0	2
129075	488643	6	2	5	0	0	7
129075	488645	6	1	2	1	0	4
129075	488648	6	2	3	0	0	5
129075	488680	6	1	3	0	2	6
129075	488682	6	1	4	0	0	5
129075	488689	6	1	1	0	0	2
129075	488691	6	3	3	1	0	7
129075	488693	6	2	4	0	0	6
129075	488697	6	3	0	0	2	5
129075	488703	6	1	1	0	0	2
129075	488590	5	0	1	2	0	3
129075	488603	5	4	2	0	0	6
129075	488605	5	0	0	0	0	0
129075	488614	5	3	2	0	0	5
129075	488626	5	0	1	0	0	1
129075	488634	5	1	2	0	0	3
129075	488640	5	0	4	0	0	4
129075	488656	5	1	2	0	0	3
129075	488662	5	0	4	1	0	5
129075	488679	5	0	3	0	0	3
129075	488684	5	0	1	0	0	1
129075	488700	5	0	2	1	0	3
129075	488582	4	0	0	0	1	1
129075	488600	4	0	0	0	0	0
129075	488604	4	0	2	0	1	3
129075	488616	4	1	3	0	0	4
129075	488620	4	1	1	0	0	2
129075	488632	4	1	0	0	1	2
129075	488636	4	3	0	0	0	3
129075	488638	4	2	1	0	0	3
129075	488639	4	1	2	0	2	5
129075	488658	4	0	1	0	2	3
129075	488673	4	2	0	0	0	2
129075	488674	4	0	0	0	0	0
129075	488675	4	0	1	0	0	1
129075	488692	4	1	2	0	1	4
129075	488694	4	5	0	0	0	5
129075	488696	4	1	2	0	0	3
129075	488702	4	1	4	0	1	6
129075	488704	4	1	0	0	0	1
129075	488707	4	0	1	0	0	1
129075	488708	4	1	2	0	0	3
129075	488581	3	0	1	0	0	1
129075	488585	3	0	0	0	0	0
129075	488588	3	0	1	0	0	1
129075	488595	3	3	1	0	0	4
129075	488601	3	2	1	1	0	4
129075	488622	3	1	0	0	0	1
129075	488628	3	0	0	0	0	0
129075	488633	3	0	2	1	0	3
129075	488642	3	0	1	0	1	2
129075	488647	3	1	3	0	0	4
129075	488651	3	0	1	0	1	2
129075	488654	3	1	0	0	0	1
129075	488661	3	0	1	0	0	1
129075	488663	3	1	1	0	1	3
129075	488667	3	0	1	0	2	3
129075	488668	3	1	0	0	0	1
129075	488669	3	3	0	0	1	4
129075	488686	3	1	2	0	0	3
129075	488688	3	1	1	0	1	3
129075	488698	3	0	1	0	0	1
129075	488705	3	1	2	0	0	3
129075	488575	2	0	0	0	0	0
129075	488579	2	0	1	0	0	1
129075	488587	2	1	2	0	0	3
129075	488591	2	0	1	0	1	2
129075	488593	2	0	0	0	0	0
129075	488619	2	0	2	1	0	3
129075	488621	2	0	1	0	1	2
129075	488624	2	1	1	0	3	5
129075	488625	2	1	1	0	0	2
129075	488629	2	1	2	0	0	3
129075	488637	2	0	1	0	0	1
129075	488664	2	1	2	0	0	3
129075	488666	2	2	0	0	0	2
129075	488678	2	1	1	0	0	2
129075	488699	2	1	2	0	1	4
129075	488701	2	0	1	0	0	1
129075	488706	2	1	0	0	0	1
129075	488576	1	0	0	0	1	1
129075	488577	1	0	1	0	0	1
129075	488578	1	0	1	0	0	1
129075	488580	1	1	0	0	0	1
129075	488584	1	0	0	0	1	1
129075	488589	1	1	2	0	0	3
129075	488592	1	0	0	0	1	1
129075	488606	1	3	1	0	0	4
129075	488623	1	1	0	0	0	1
129075	488627	1	1	1	0	0	2
129075	488630	1	2	1	0	0	3
129075	488649	1	0	0	0	3	3
129075	488653	1	0	1	0	0	1
129075	488659	1	0	0	0	0	0
129075	488670	1	2	1	0	1	4
129075	488685	1	3	1	0	2	6
129075	488709	1	0	2	0	0	2
69833	210644	31	7	5	1	0	13
69833	487629	29	7	5	1	0	13
69833	74544	29	1	1	0	2	4
69833	198921	19	2	1	0	0	3
69833	282885	18	2	1	0	0	3
69833	596335	14	1	1	0	1	3
69833	86713	14	0	6	1	2	9
69833	282884	13	1	1	1	1	4
69833	596320	13	1	2	0	2	5
69833	63266	13	1	1	1	1	4
69833	596336	12	4	1	0	1	6
69833	210881	11	1	1	2	0	4
69833	282897	11	1	1	1	0	3
69833	487631	11	1	1	2	0	4
69833	596316	11	1	0	0	1	2
69833	201723	10	2	3	0	0	5
69833	282895	10	3	3	0	0	6
69833	596349	10	3	2	1	1	7
69833	104224	9	5	1	0	5	11
69833	200781	9	3	3	0	0	6
69833	217045	9	5	1	0	5	11
69833	282892	9	5	1	0	5	11
69833	214011	8	0	2	2	1	5
69833	282883	8	0	0	0	1	1
69833	596345	8	1	0	0	0	1
69833	596355	8	1	2	0	0	3
69833	214693	7	1	0	0	0	1
69833	596323	7	3	0	0	0	3
69833	596326	7	1	1	0	0	2
69833	101226	6	1	0	0	0	1
69833	191351	6	1	0	0	0	1
69833	218945	6	1	0	0	0	1
69833	282880	6	0	0	0	0	0
69833	282886	6	0	0	0	0	0
69833	282889	6	0	1	0	0	1
69833	282891	6	1	0	0	0	1
69833	487627	6	0	4	0	0	4
69833	596328	6	1	3	1	1	6
69833	596330	6	0	1	0	1	2
69833	596334	6	2	0	0	0	2
69833	596342	6	2	1	0	0	3
69833	596352	6	2	1	0	1	4
69833	79328	6	0	0	0	0	0
69833	191098	5	1	2	0	0	3
69833	193872	5	3	0	0	0	3
69833	194904	5	1	2	0	0	3
69833	216684	5	1	3	0	0	4
69833	218711	5	0	2	0	0	2
69833	221593	5	1	1	0	0	2
69833	282890	5	3	1	0	1	5
69833	282893	5	2	0	0	0	2
69833	282898	5	2	1	0	0	3
69833	596329	5	1	2	0	0	3
69833	596339	5	0	2	0	0	2
69833	596348	5	1	0	0	0	1
69833	596351	5	0	2	0	0	2
69833	70858	5	2	0	0	0	2
69833	89941	5	3	3	1	0	7
69833	98173	5	1	2	0	1	4
69833	106340	4	0	1	0	0	1
69833	184431	4	0	0	0	1	1
69833	198427	4	1	1	0	0	2
69833	201835	4	0	0	0	1	1
69833	204890	4	0	0	0	0	0
69833	208888	4	1	2	0	0	3
69833	210535	4	0	2	0	0	2
69833	214208	4	0	0	0	0	0
69833	214484	4	1	0	0	0	1
69833	216784	4	2	1	0	0	3
69833	217256	4	0	0	1	1	2
69833	219689	4	0	1	0	0	1
69833	220340	4	1	2	0	0	3
69833	220999	4	0	0	0	0	0
69833	282888	4	3	0	0	0	3
69833	282894	4	0	0	1	1	2
69833	282899	4	1	0	0	0	1
69833	282900	4	0	2	0	0	2
69833	487628	4	0	0	0	0	0
69833	487633	4	0	2	0	1	3
69833	596315	4	1	0	0	0	1
69833	596318	4	0	1	0	0	1
69833	596321	4	0	2	0	0	2
69833	596325	4	0	1	0	0	1
69833	596331	4	0	1	0	0	1
69833	596333	4	0	1	0	1	2
69833	596343	4	1	0	0	0	1
69833	596346	4	0	0	0	0	0
69833	596347	4	0	2	0	0	2
69833	596356	4	1	1	0	0	2
69833	596357	4	1	2	0	0	3
69833	596358	4	0	1	0	0	1
69833	89071	4	3	0	0	0	3
69833	190398	3	0	3	0	1	4
69833	205429	3	0	1	0	0	1
69833	207122	3	1	0	0	0	1
69833	207448	3	0	0	0	0	0
69833	220648	3	0	0	0	0	0
69833	282881	3	0	0	0	0	0
69833	282887	3	1	0	0	0	1
69833	487623	3	3	1	0	0	4
69833	487626	3	0	1	0	0	1
69833	596322	3	1	2	0	0	3
69833	596332	3	0	0	0	0	0
69833	596337	3	0	1	0	0	1
69833	596340	3	0	2	0	0	2
69833	596344	3	0	1	0	0	1
69833	596350	3	3	0	0	0	3
69833	596353	3	0	1	0	1	2
69833	596354	3	0	1	0	0	1
69833	85045	3	2	1	0	0	3
69833	191605	2	0	0	0	1	1
69833	196572	2	0	1	0	0	1
69833	200316	2	1	0	0	0	1
69833	204609	2	1	0	0	1	2
69833	209099	2	1	0	0	0	1
69833	215704	2	1	0	0	0	1
69833	219936	2	0	0	0	0	0
69833	282896	2	0	0	0	0	0
69833	282901	2	0	0	0	0	0
69833	487632	2	1	0	0	2	3
69833	596324	2	0	0	0	0	0
69833	596327	2	0	0	0	0	0
69833	596338	2	0	1	0	0	1
69833	77102	2	0	0	0	0	0
69833	201292	1	0	0	0	0	0
69833	282882	1	0	0	0	0	0
69833	487624	1	0	2	0	0	2
69833	487625	1	1	0	0	0	1
69833	487630	1	2	1	0	0	3
69833	596317	1	0	0	0	0	0
69833	596319	1	0	0	0	0	0
69833	596341	1	0	1	0	0	1
69833	84766	1	0	0	0	0	0
62931	191065	32	7	2	0	4	13
62931	299767	31	7	2	0	4	13
62931	411490	31	7	2	0	4	13
62931	219734	23	4	3	3	6	16
62931	185402	22	2	3	0	2	7
62931	219129	15	0	0	0	1	1
62931	411520	13	1	3	0	0	4
62931	200466	11	0	2	0	0	2
62931	217027	11	1	2	1	0	4
62931	299760	11	0	2	1	0	3
62931	299773	11	1	2	1	0	4
62931	411484	11	1	1	0	0	2
62931	411492	11	0	2	0	0	2
62931	411526	11	2	3	1	0	6
62931	221366	10	0	1	0	0	1
62931	411491	10	1	1	0	0	2
62931	411536	10	1	2	1	0	4
62931	146042	9	1	5	0	0	6
62931	299766	9	1	1	0	0	2
62931	411471	9	0	4	0	0	4
62931	411535	9	0	4	0	0	4
62931	411537	9	3	1	0	1	5
62931	411498	8	1	5	0	2	8
62931	411500	8	0	2	0	0	2
62931	411505	8	0	3	0	1	4
62931	411506	8	1	0	0	0	1
62931	411532	8	3	1	0	0	4
62931	183294	7	1	0	0	0	1
62931	213415	7	1	1	0	0	2
62931	299771	7	0	1	0	0	1
62931	411478	7	0	2	0	0	2
62931	411480	7	0	1	0	0	1
62931	411495	7	1	2	0	1	4
62931	411507	7	2	1	2	0	5
62931	411518	7	0	1	0	0	1
62931	411522	7	3	6	0	3	12
62931	411528	7	3	2	0	0	5
62931	411539	7	0	0	0	0	0
62931	146040	6	3	2	1	3	9
62931	190436	6	0	0	0	0	0
62931	215871	6	0	0	0	0	0
62931	217388	6	0	2	0	0	2
62931	220251	6	1	0	0	1	2
62931	299772	6	0	1	0	0	1
62931	411494	6	0	2	0	0	2
62931	411499	6	3	1	0	0	4
62931	411501	6	3	2	0	0	5
62931	411502	6	2	2	0	0	4
62931	411511	6	0	2	0	0	2
62931	411514	6	1	1	0	0	2
62931	411516	6	1	1	0	0	2
62931	411521	6	0	1	0	0	1
62931	411523	6	0	1	0	0	1
62931	411538	6	3	0	0	0	3
62931	193559	5	0	1	0	1	2
62931	210047	5	0	1	0	0	1
62931	216727	5	1	1	0	0	2
62931	299763	5	1	3	2	2	8
62931	299764	5	0	3	1	0	4
62931	299765	5	1	2	0	0	3
62931	411474	5	1	2	0	0	3
62931	411476	5	1	3	1	0	5
62931	411483	5	1	2	0	1	4
62931	411488	5	1	3	0	0	4
62931	411493	5	0	2	0	0	2
62931	411497	5	0	2	0	3	5
62931	411508	5	0	0	0	0	0
62931	411513	5	1	2	0	0	3
62931	411517	5	0	1	0	0	1
62931	411527	5	1	3	0	0	4
62931	411530	5	2	0	0	0	2
62931	211314	4	0	2	0	1	3
62931	212946	4	1	1	0	0	2
62931	214065	4	1	1	0	0	2
62931	299768	4	0	3	1	0	4
62931	411486	4	1	0	0	0	1
62931	411487	4	1	0	0	0	1
62931	411496	4	1	1	0	0	2
62931	411504	4	0	1	0	0	1
62931	411509	4	0	2	0	0	2
62931	411512	4	1	1	0	0	2
62931	411524	4	1	1	0	0	2
62931	411525	4	1	3	0	2	6
62931	411529	4	1	2	0	1	4
62931	411533	4	2	1	0	0	3
62931	188950	3	0	1	0	0	1
62931	199191	3	1	2	0	0	3
62931	201294	3	0	1	0	0	1
62931	204473	3	2	4	0	1	7
62931	207434	3	1	0	0	1	2
62931	208707	3	0	0	0	0	0
62931	216033	3	1	2	0	0	3
62931	217301	3	0	3	0	0	3
62931	219976	3	0	3	0	0	3
62931	299769	3	0	2	0	0	2
62931	299770	3	0	2	0	0	2
62931	411470	3	0	2	0	0	2
62931	411473	3	0	1	0	0	1
62931	411503	3	1	1	0	0	2
62931	411510	3	1	0	0	0	1
62931	411531	3	1	0	0	0	1
62931	411541	3	1	1	0	0	2
62931	537870	3	0	1	0	0	1
62931	183505	2	1	1	0	0	2
62931	184469	2	0	1	0	1	2
62931	186128	2	0	0	0	0	0
62931	190472	2	0	2	0	0	2
62931	200263	2	0	0	0	0	0
62931	206718	2	0	2	0	0	2
62931	207178	2	0	1	0	0	1
62931	210329	2	0	2	0	0	2
62931	216544	2	2	0	0	0	2
62931	218611	2	0	2	0	0	2
62931	220341	2	2	3	0	0	5
62931	299759	2	1	0	0	0	1
62931	299761	2	0	0	0	0	0
62931	299762	2	2	0	0	1	3
62931	299774	2	0	0	0	0	0
62931	299775	2	0	0	0	0	0
62931	411477	2	0	2	0	0	2
62931	411479	2	0	2	0	0	2
62931	411481	2	0	1	0	0	1
62931	411485	2	0	0	0	0	0
62931	411489	2	0	1	0	1	2
62931	411515	2	1	0	0	0	1
62931	411519	2	1	0	0	0	1
62931	411540	2	0	0	0	0	0
62931	211836	1	0	2	0	0	2
62931	217365	1	0	0	0	0	0
62931	411472	1	1	1	0	0	2
62931	411475	1	0	0	0	0	0
62931	411482	1	3	3	0	0	6
62931	411534	1	0	1	0	0	1
33474	96659	69	1	0	0	0	1
33474	187862	67	3	6	0	5	14
33474	58862	67	3	6	0	5	14
33474	372818	45	3	5	0	5	13
33474	292130	43	4	12	2	7	25
33474	50083	43	4	12	2	7	25
33474	372828	42	4	12	2	7	25
33474	69104	33	0	3	1	2	6
33474	68980	30	4	9	0	5	18
33474	104025	29	6	7	0	2	15
33474	292131	29	6	7	0	2	15
33474	372830	27	6	7	0	2	15
33474	98669	27	2	1	0	0	3
33474	103476	26	0	1	0	0	1
33474	107527	26	2	5	1	1	9
33474	292121	26	2	5	1	1	9
33474	372823	26	2	5	1	1	9
33474	372829	26	2	1	0	0	3
33474	57525	26	0	4	0	0	4
33474	62825	26	2	4	2	1	9
33474	81725	26	2	7	0	1	10
33474	292122	25	0	4	0	0	4
33474	292128	25	1	9	3	4	17
33474	372824	25	0	4	0	0	4
33474	372827	25	1	8	3	3	15
33474	50919	25	1	9	3	4	17
33474	85954	25	1	5	0	0	6
33474	102949	23	1	7	3	0	11
33474	292120	23	1	7	3	0	11
33474	372822	23	1	7	3	0	11
33474	67662	23	2	9	0	3	14
33474	106826	22	1	5	0	0	6
33474	292117	22	3	7	0	3	13
33474	372814	22	3	7	0	3	13
33474	58157	22	3	4	0	2	9
33474	91449	22	3	7	0	3	13
33474	292118	20	0	6	0	4	10
33474	372816	20	0	6	0	4	10
33474	72519	20	5	3	0	0	8
33474	97345	20	0	6	0	4	10
33474	104397	19	4	2	2	1	9
33474	64121	19	3	5	2	3	13
33474	96143	19	0	2	0	0	2
33474	76249	18	1	3	0	0	4
33474	83990	18	2	5	1	2	10
33474	292125	17	2	5	0	0	7
33474	54208	17	2	5	0	0	7
33474	108815	16	1	0	0	0	1
33474	184704	16	2	5	0	0	7
33474	372826	16	2	5	0	0	7
33474	61047	15	0	3	1	4	8
33474	56318	14	1	6	0	0	7
33474	101349	13	0	1	1	0	2
33474	84058	13	0	4	0	0	4
33474	104234	12	2	1	0	1	4
33474	104817	12	1	1	0	1	3
33474	105996	12	0	1	0	0	1
33474	219068	12	0	1	0	0	1
33474	292132	12	1	1	0	1	3
33474	372799	12	1	1	0	1	3
33474	372825	12	2	1	0	1	4
33474	372831	12	1	1	0	1	3
33474	92571	12	5	1	0	2	8
33474	103322	11	3	2	0	0	5
33474	372815	11	2	1	0	2	5
33474	69512	11	2	1	0	2	5
33474	107907	10	2	5	0	0	7
33474	292124	10	2	5	0	0	7
33474	372819	10	3	2	0	0	5
33474	372821	10	1	4	0	0	5
33474	92458	10	3	0	1	0	4
33474	292119	9	1	3	0	0	4
33474	292123	9	1	5	0	4	10
33474	50667	9	1	3	0	0	4
33474	64843	9	1	5	0	4	10
33474	372810	8	1	1	1	0	3
33474	372812	8	3	3	0	0	6
33474	51874	8	0	3	0	0	3
33474	63305	8	2	1	0	2	5
33474	188819	7	2	6	2	2	12
33474	372807	7	2	1	0	0	3
33474	372820	7	0	0	1	1	2
33474	51340	7	2	1	0	0	3
33474	59833	7	2	6	2	2	12
33474	60935	7	2	4	1	0	7
33474	68777	7	0	0	0	0	0
33474	88298	7	2	1	0	1	4
33474	64079	6	1	2	2	0	5
33474	292129	5	4	2	0	0	6
33474	372779	5	4	2	0	1	7
33474	372792	5	0	0	0	0	0
33474	372802	5	0	3	1	0	4
33474	372817	5	1	3	0	0	4
33474	53870	5	4	2	0	0	6
33474	80431	5	0	1	0	0	1
33474	372781	4	0	0	0	0	0
33474	372796	4	2	1	0	0	3
33474	372811	4	0	0	0	0	0
33474	50456	4	0	3	0	0	3
33474	220669	3	0	1	0	0	1
33474	372778	3	0	2	0	0	2
33474	372785	3	0	1	0	0	1
33474	372787	3	2	1	0	0	3
33474	372798	3	2	0	0	0	2
33474	372803	3	0	1	0	1	2
33474	198948	2	0	1	0	0	1
33474	372774	2	0	2	0	0	2
33474	372776	2	0	2	0	0	2
33474	372788	2	0	1	0	0	1
33474	372793	2	2	0	0	0	2
33474	372800	2	1	1	0	0	2
33474	372801	2	0	3	0	0	3
33474	372804	2	0	1	0	1	2
33474	372808	2	0	3	0	0	3
33474	372809	2	0	2	0	0	2
33474	372813	2	0	3	0	0	3
33474	189588	1	0	0	0	0	0
33474	372775	1	0	0	0	0	0
33474	372777	1	1	1	0	0	2
33474	372780	1	0	0	0	0	0
33474	372782	1	0	1	0	0	1
33474	372783	1	1	1	0	1	3
33474	372784	1	1	1	0	0	2
33474	372786	1	0	2	1	0	3
33474	372789	1	0	0	0	0	0
33474	372790	1	0	0	0	0	0
33474	372791	1	0	1	0	0	1
33474	372794	1	1	1	0	0	2
33474	372795	1	0	0	0	0	0
33474	372797	1	0	0	1	0	1
33474	372805	1	0	1	0	0	1
33474	372806	1	1	2	0	0	3
178	182581	24	0	3	0	0	3
178	282969	19	1	1	0	0	2
178	282988	19	0	2	0	2	4
178	603704	17	2	4	0	4	10
178	188874	16	0	1	1	2	4
178	283002	16	0	1	1	2	4
178	282971	15	3	0	1	2	6
178	282998	15	2	1	0	3	6
178	214781	14	2	1	0	3	6
178	204845	13	1	1	1	0	3
178	192668	12	3	3	1	1	8
178	603701	12	4	3	2	1	10
178	282982	11	3	3	1	1	8
178	282996	11	2	1	0	2	5
178	603645	11	0	1	0	1	2
178	603649	11	0	1	0	3	4
178	603668	11	3	3	1	1	8
178	603694	11	1	2	0	1	4
178	206661	10	1	4	1	0	6
178	282997	10	1	2	0	2	5
178	603651	10	1	1	1	1	4
178	603670	10	3	3	1	0	7
178	603692	10	2	2	0	0	4
178	603705	10	4	4	2	0	10
178	603659	9	2	5	1	2	10
178	603667	9	4	2	1	1	8
178	603673	9	0	1	0	1	2
178	603685	9	2	0	0	0	2
178	603690	9	1	3	1	3	8
178	202807	8	1	1	0	3	5
178	282976	8	3	1	0	1	5
178	282978	8	0	2	1	0	3
178	282986	8	0	0	0	2	2
178	282999	8	1	3	0	3	7
178	283003	8	1	1	0	2	4
178	603657	8	1	2	0	2	5
178	603665	8	1	2	0	2	5
178	192127	7	2	2	0	1	5
178	282975	7	1	2	0	2	5
178	282983	7	2	3	0	2	7
178	603640	7	1	2	0	2	5
178	603656	7	0	1	1	2	4
178	603671	7	0	3	0	0	3
178	603672	7	0	4	0	0	4
178	603683	7	1	0	0	0	1
178	603686	7	0	0	0	1	1
178	603689	7	3	1	0	2	6
178	603693	7	1	3	0	0	4
178	200550	6	0	1	0	1	2
178	202711	6	0	1	0	0	1
178	217199	6	0	3	0	1	4
178	282977	6	1	1	0	3	5
178	282985	6	2	3	0	1	6
178	603646	6	0	1	0	1	2
178	603660	6	2	2	0	0	4
178	603661	6	1	2	0	0	3
178	603662	6	1	3	0	1	5
178	184817	5	1	4	0	0	5
178	191003	5	0	2	0	0	2
178	193254	5	1	1	2	1	5
178	194866	5	1	1	0	0	2
178	216015	5	1	2	0	3	6
178	282980	5	0	1	0	5	6
178	282992	5	1	4	0	0	5
178	282995	5	1	3	0	1	5
178	283001	5	2	2	0	0	4
178	603641	5	2	1	0	0	3
178	603642	5	0	2	0	0	2
178	603648	5	1	2	0	1	4
178	603654	5	1	1	2	0	4
178	603666	5	1	2	0	2	5
178	603678	5	1	0	0	2	3
178	603695	5	0	0	0	0	0
178	603696	5	2	3	0	2	7
178	603702	5	2	2	0	0	4
178	603703	5	2	1	0	0	3
178	196075	4	0	1	0	0	1
178	204528	4	1	1	0	2	4
178	207242	4	0	1	0	1	2
178	282981	4	0	0	0	1	1
178	282987	4	1	1	0	0	2
178	282991	4	1	0	0	1	2
178	283000	4	1	2	0	0	3
178	603643	4	0	1	0	0	1
178	603650	4	0	0	0	1	1
178	603652	4	0	1	0	1	2
178	603655	4	2	3	0	0	5
178	603664	4	0	2	0	0	2
178	603669	4	0	0	0	2	2
178	603675	4	0	6	0	1	7
178	603684	4	1	1	1	0	3
178	603706	4	1	0	2	0	3
178	204812	3	1	3	0	1	5
178	206962	3	1	1	0	0	2
178	215112	3	0	2	0	0	2
178	282972	3	0	1	0	0	1
178	282973	3	0	2	0	1	3
178	282974	3	1	0	0	0	1
178	282989	3	0	0	1	0	1
178	282993	3	1	1	0	1	3
178	603647	3	1	2	0	2	5
178	603676	3	1	1	0	0	2
178	603677	3	1	1	0	1	3
178	603680	3	1	0	0	5	6
178	603688	3	0	0	0	0	0
178	603691	3	1	0	0	0	1
178	603697	3	0	0	0	0	0
178	603698	3	0	0	0	2	2
178	603700	3	0	0	0	0	0
178	183736	2	0	3	0	0	3
178	192857	2	0	1	0	1	2
178	197173	2	0	2	0	0	2
178	201257	2	0	0	0	0	0
178	208757	2	1	0	0	1	2
178	282970	2	0	1	0	6	7
178	282979	2	0	2	0	0	2
178	282990	2	0	0	0	0	0
178	282994	2	1	0	0	0	1
178	603653	2	3	1	0	0	4
178	603658	2	0	1	0	0	1
178	603663	2	0	0	0	1	1
178	603679	2	0	0	0	1	1
178	603687	2	0	1	0	1	2
178	603699	2	0	2	0	0	2
178	205332	1	0	0	0	2	2
178	218718	1	0	2	0	1	3
178	282984	1	1	1	0	2	4
178	603644	1	0	2	0	0	2
178	603674	1	0	3	0	1	4
178	603682	1	0	0	0	0	0
58109	103934	34	3	7	0	2	12
58109	504301	28	1	5	1	1	8
58109	298390	27	4	8	0	2	14
58109	80022	27	4	8	0	2	14
58109	58442	24	1	6	0	1	8
58109	101297	23	8	3	0	0	11
58109	187558	22	3	4	2	3	12
58109	504317	22	3	4	2	3	12
58109	58900	22	3	4	2	3	12
58109	94651	22	0	3	1	0	4
58109	96181	22	3	5	0	0	8
58109	85844	21	0	5	0	0	5
58109	181959	20	1	2	1	0	4
58109	504304	20	1	2	1	0	4
58109	80843	19	0	3	0	0	3
58109	504302	18	3	3	0	1	7
58109	52002	18	1	6	0	1	8
58109	71974	18	1	3	0	1	5
58109	89735	16	5	5	0	3	13
58109	107831	15	1	4	1	0	6
58109	55511	15	5	2	0	0	7
58109	298380	14	1	1	0	0	2
58109	78811	13	2	2	0	0	4
58109	81270	12	0	3	0	0	3
58109	298387	11	0	2	1	2	5
58109	504306	11	0	2	1	2	5
58109	65651	11	0	3	0	1	4
58109	84880	11	2	6	0	0	8
58109	87360	11	0	4	0	1	5
58109	88654	11	0	2	1	2	5
58109	106225	10	0	0	0	0	0
58109	219375	10	0	0	0	0	0
58109	504311	10	0	2	0	0	2
58109	62366	10	5	1	0	1	7
58109	68999	10	0	5	0	0	5
58109	88522	10	1	3	0	0	4
58109	504305	9	0	1	0	0	1
58109	77971	9	1	4	1	0	6
58109	298388	8	0	3	0	0	3
58109	80402	8	1	2	0	0	3
58109	50418	7	1	3	0	2	6
58109	504278	7	1	0	0	1	2
58109	504303	7	0	1	0	0	1
58109	504313	7	0	1	0	0	1
58109	504316	7	1	0	1	0	2
58109	51200	7	0	2	0	1	3
58109	67826	7	1	1	1	0	3
58109	86927	7	2	4	0	1	7
58109	504274	6	0	0	1	0	1
58109	504277	6	1	2	0	0	3
58109	504293	6	0	3	0	1	4
58109	504308	6	0	1	0	1	2
58109	58999	6	4	3	0	0	7
58109	79712	6	0	3	0	0	3
58109	84136	6	1	3	0	0	4
58109	96191	6	0	2	2	1	5
58109	193345	5	2	3	0	1	6
58109	298382	5	2	0	0	0	2
58109	49964	5	1	2	1	0	4
58109	504291	5	1	2	0	0	3
58109	504297	5	3	1	0	0	4
58109	504309	5	3	3	0	2	8
58109	504310	5	1	1	0	0	2
58109	504318	5	2	1	2	0	5
58109	504321	5	1	1	0	1	3
58109	504322	5	1	0	0	0	1
58109	59701	5	2	0	0	0	2
58109	74169	5	1	4	0	0	5
58109	92496	5	0	2	1	1	4
58109	103065	4	0	2	0	1	3
58109	104935	4	0	3	0	0	3
58109	105347	4	0	5	0	0	5
58109	191847	4	0	0	0	0	0
58109	196602	4	0	1	0	1	2
58109	504279	4	0	3	0	0	3
58109	504281	4	1	1	0	0	2
58109	504284	4	0	1	0	0	1
58109	504285	4	1	3	0	0	4
58109	504298	4	1	1	0	0	2
58109	504300	4	1	1	0	0	2
58109	104852	3	1	1	1	1	4
58109	106738	3	1	0	0	0	1
58109	212858	3	0	0	0	0	0
58109	298379	3	0	0	0	0	0
58109	298384	3	1	0	0	0	1
58109	298385	3	0	1	0	0	1
58109	298386	3	1	1	0	0	2
58109	298391	3	2	1	0	0	3
58109	504273	3	0	1	0	0	1
58109	504275	3	0	1	0	0	1
58109	504280	3	1	1	0	0	2
58109	504295	3	2	1	0	0	3
58109	504296	3	1	0	0	0	1
58109	504315	3	1	4	1	1	7
58109	504320	3	1	2	0	0	3
58109	504323	3	0	2	0	0	2
58109	504324	3	0	0	0	1	1
58109	64604	3	0	0	0	0	0
58109	67904	3	1	1	0	0	2
58109	83435	3	0	1	0	0	1
58109	86416	3	0	1	0	2	3
58109	100631	2	0	2	0	0	2
58109	298383	2	0	1	0	0	1
58109	504271	2	0	2	0	1	3
58109	504276	2	0	3	0	0	3
58109	504283	2	2	3	0	0	5
58109	504287	2	0	1	0	0	1
58109	504288	2	1	1	1	1	4
58109	504289	2	0	4	0	0	4
58109	504290	2	0	2	0	0	2
58109	504292	2	0	2	0	0	2
58109	504307	2	1	2	0	0	3
58109	504312	2	0	1	0	0	1
58109	55358	2	0	1	0	0	1
58109	66637	2	2	0	0	0	2
58109	66759	2	2	1	0	0	3
58109	72691	2	0	1	0	0	1
58109	184515	1	1	0	0	0	1
58109	298389	1	0	2	0	0	2
58109	504267	1	0	0	0	0	0
58109	504268	1	0	1	0	2	3
58109	504269	1	0	1	0	0	1
58109	504270	1	0	1	0	0	1
58109	504272	1	0	1	0	1	2
58109	504282	1	1	1	0	0	2
58109	504286	1	0	2	0	0	2
58109	504294	1	0	1	0	1	2
58109	504299	1	0	1	0	1	2
58109	504314	1	0	1	0	0	1
58109	504319	1	1	1	0	0	2
1970	93264	30	2	2	3	1	8
1970	76333	24	1	3	1	2	7
1970	65770	22	2	2	3	0	7
1970	68956	18	3	0	0	1	4
1970	105672	15	1	1	0	0	2
1970	219229	15	1	1	0	0	2
1970	65336	15	1	2	0	0	3
1970	604846	14	0	1	0	0	1
1970	108438	13	2	3	0	0	5
1970	604898	11	1	3	0	0	4
1970	604838	10	0	2	0	1	3
1970	188588	9	0	8	0	1	9
1970	59709	9	0	8	0	1	9
1970	604843	8	2	3	0	1	6
1970	604844	8	1	2	0	0	3
1970	604856	8	0	2	3	0	5
1970	604861	8	1	1	0	0	2
1970	187972	7	0	2	0	0	2
1970	604914	7	0	1	0	0	1
1970	604916	7	1	2	1	0	4
1970	98091	7	0	3	1	0	4
1970	604840	6	5	1	0	0	6
1970	604842	6	2	2	0	0	4
1970	604857	6	0	1	2	0	3
1970	604874	6	0	0	0	0	0
1970	604883	6	1	1	0	0	2
1970	604893	6	2	2	0	0	4
1970	604909	6	0	3	0	1	4
1970	66591	6	1	0	0	0	1
1970	604819	5	1	0	0	0	1
1970	604820	5	1	2	2	0	5
1970	604852	5	0	3	0	0	3
1970	604866	5	1	3	0	0	4
1970	604889	5	1	1	0	0	2
1970	604896	5	0	1	1	0	2
1970	86309	5	0	0	0	0	0
1970	98323	5	1	2	1	0	4
1970	604809	4	0	2	0	2	4
1970	604812	4	0	1	0	0	1
1970	604835	4	1	3	0	0	4
1970	604839	4	1	1	0	0	2
1970	604865	4	0	0	0	0	0
1970	604880	4	1	0	0	0	1
1970	604887	4	0	1	0	0	1
1970	604895	4	1	2	0	0	3
1970	604899	4	1	4	0	0	5
1970	604902	4	2	1	1	0	4
1970	604903	4	2	0	0	0	2
1970	105231	3	0	3	0	0	3
1970	604815	3	0	0	0	1	1
1970	604818	3	0	1	0	0	1
1970	604828	3	0	2	0	0	2
1970	604829	3	0	1	0	0	1
1970	604830	3	1	0	0	0	1
1970	604832	3	1	0	0	0	1
1970	604848	3	0	4	0	4	8
1970	604849	3	3	0	0	0	3
1970	604850	3	0	1	0	0	1
1970	604853	3	1	0	0	0	1
1970	604858	3	0	0	0	0	0
1970	604859	3	0	2	0	0	2
1970	604860	3	1	1	1	0	3
1970	604871	3	0	3	0	0	3
1970	604876	3	0	2	0	0	2
1970	604881	3	2	1	0	0	3
1970	604888	3	1	1	0	0	2
1970	604892	3	1	0	0	0	1
1970	604894	3	0	1	0	0	1
1970	604906	3	0	3	0	0	3
1970	604912	3	0	1	0	0	1
1970	604817	2	0	0	0	0	0
1970	604822	2	1	1	0	0	2
1970	604827	2	0	1	0	0	1
1970	604833	2	0	1	0	0	1
1970	604834	2	0	0	0	0	0
1970	604847	2	0	0	0	0	0
1970	604851	2	1	0	0	0	1
1970	604854	2	0	1	0	0	1
1970	604863	2	1	1	0	0	2
1970	604867	2	1	1	0	0	2
1970	604868	2	0	1	0	0	1
1970	604870	2	1	1	0	0	2
1970	604872	2	1	1	0	0	2
1970	604873	2	0	0	0	0	0
1970	604875	2	0	3	0	0	3
1970	604877	2	0	0	0	0	0
1970	604879	2	0	1	0	0	1
1970	604882	2	1	1	0	0	2
1970	604885	2	1	0	0	0	1
1970	604886	2	0	1	0	0	1
1970	604891	2	0	0	0	0	0
1970	604897	2	2	2	0	0	4
1970	604900	2	1	0	0	0	1
1970	604904	2	1	0	0	0	1
1970	604907	2	0	1	0	1	2
1970	604908	2	1	0	0	0	1
1970	604910	2	0	1	0	0	1
1970	604911	2	0	1	1	0	2
1970	604913	2	1	1	0	0	2
1970	604915	2	1	1	0	0	2
1970	604917	2	2	1	0	0	3
1970	604918	2	0	0	0	0	0
1970	66932	2	0	1	0	0	1
1970	604805	1	0	0	0	0	0
1970	604806	1	0	0	0	0	0
1970	604807	1	0	0	0	0	0
1970	604808	1	0	0	0	0	0
1970	604810	1	0	2	0	0	2
1970	604811	1	1	1	0	0	2
1970	604813	1	0	1	0	0	1
1970	604814	1	0	2	0	0	2
1970	604816	1	0	1	0	0	1
1970	604821	1	1	0	0	0	1
1970	604823	1	0	1	0	0	1
1970	604824	1	0	1	1	0	2
1970	604825	1	1	1	0	0	2
1970	604826	1	0	2	0	0	2
1970	604831	1	0	1	0	0	1
1970	604836	1	0	1	0	0	1
1970	604837	1	0	0	0	0	0
1970	604841	1	0	2	0	0	2
1970	604845	1	0	1	0	0	1
1970	604855	1	1	0	0	0	1
1970	604862	1	0	0	0	0	0
1970	604864	1	0	1	0	0	1
1970	604869	1	0	0	0	1	1
1970	604878	1	1	0	0	0	1
1970	604884	1	0	0	0	0	0
1970	604890	1	0	2	0	0	2
1970	604901	1	0	4	0	0	4
1970	604905	1	0	2	0	0	2
21869	511641	27	0	0	5	1	6
21869	75246	19	1	1	0	1	3
21869	201083	14	2	0	2	4	8
21869	511652	14	1	1	2	0	4
21869	511656	13	0	1	0	3	4
21869	511664	12	1	3	3	0	7
21869	511669	12	0	0	0	1	1
21869	289111	11	0	1	0	1	2
21869	511666	11	0	1	1	2	4
21869	87938	11	0	1	0	1	2
21869	197210	10	2	5	3	0	10
21869	220842	10	1	0	0	3	4
21869	289112	10	3	0	1	0	4
21869	511631	10	1	0	0	1	2
21869	511632	10	0	0	0	0	0
21869	202987	9	2	1	0	1	4
21869	511659	9	1	0	2	1	4
21869	108578	8	0	0	1	0	1
21869	192125	8	1	1	1	0	3
21869	195356	8	0	3	0	2	5
21869	201422	8	2	0	0	0	2
21869	289092	8	0	1	0	0	1
21869	289099	8	0	0	2	2	4
21869	289100	8	1	0	2	1	4
21869	289108	8	0	0	1	0	1
21869	511633	8	1	1	0	0	2
21869	511648	8	1	3	0	0	4
21869	511668	8	0	1	0	1	2
21869	511674	8	2	2	0	2	6
21869	57478	8	1	0	2	1	4
21869	68304	8	0	1	0	0	1
21869	200494	7	2	3	0	0	5
21869	289101	7	1	1	2	1	5
21869	289103	7	0	1	0	1	2
21869	289106	7	0	0	1	0	1
21869	289107	7	0	0	0	1	1
21869	511634	7	2	1	0	1	4
21869	511646	7	1	3	0	1	5
21869	511649	7	1	2	0	3	6
21869	511657	7	0	0	1	0	1
21869	511660	7	2	3	0	0	5
21869	511662	7	1	2	0	2	5
21869	70917	7	0	0	0	1	1
21869	185355	6	2	0	0	3	5
21869	189950	6	0	0	0	1	1
21869	192746	6	2	0	1	3	6
21869	196489	6	1	2	0	1	4
21869	201485	6	1	0	0	1	2
21869	210732	6	2	0	0	4	6
21869	219732	6	0	2	1	2	5
21869	289109	6	3	2	1	3	9
21869	50856	6	3	2	1	3	9
21869	511640	6	3	2	0	0	5
21869	511642	6	2	0	0	3	5
21869	511647	6	0	1	1	0	2
21869	511650	6	2	0	3	0	5
21869	511655	6	1	0	0	4	5
21869	511661	6	1	1	0	0	2
21869	186088	5	0	0	0	0	0
21869	211607	5	3	1	2	0	6
21869	212724	5	1	0	0	0	1
21869	289093	5	0	1	0	0	1
21869	289094	5	0	0	1	0	1
21869	289110	5	0	0	1	2	3
21869	511626	5	0	0	0	1	1
21869	511627	5	0	0	0	0	0
21869	511630	5	0	1	1	1	3
21869	511635	5	0	3	0	0	3
21869	511637	5	1	0	0	1	2
21869	511638	5	0	3	0	2	5
21869	511645	5	0	0	0	1	1
21869	511653	5	2	2	1	1	6
21869	511658	5	2	1	0	1	4
21869	511672	5	1	0	0	2	3
21869	90212	5	0	0	1	2	3
21869	194845	4	2	0	0	0	2
21869	196371	4	0	0	1	2	3
21869	203203	4	0	0	0	1	1
21869	207566	4	0	0	1	1	2
21869	215852	4	2	0	0	0	2
21869	289097	4	0	0	0	0	0
21869	289104	4	1	0	0	8	9
21869	499759	4	1	2	0	0	3
21869	499761	4	0	0	1	1	2
21869	511624	4	1	0	0	3	4
21869	511629	4	2	0	0	0	2
21869	511643	4	2	1	1	1	5
21869	511670	4	1	2	1	1	5
21869	511675	4	1	1	1	0	3
21869	511676	4	1	3	1	0	5
21869	182966	3	1	3	0	2	6
21869	185677	3	1	0	0	0	1
21869	191822	3	0	1	0	0	1
21869	207462	3	0	1	1	0	2
21869	213525	3	0	0	0	0	0
21869	213998	3	0	0	0	0	0
21869	220219	3	0	0	0	0	0
21869	289089	3	0	0	1	1	2
21869	289090	3	0	1	0	0	1
21869	289091	3	0	0	2	0	2
21869	289098	3	1	0	0	0	1
21869	289102	3	1	3	0	2	6
21869	289105	3	0	0	0	1	1
21869	499760	3	0	0	1	0	1
21869	511628	3	0	0	0	0	0
21869	511636	3	2	1	0	0	3
21869	511639	3	0	2	2	0	4
21869	511644	3	2	0	0	0	2
21869	511654	3	0	0	0	0	0
21869	511663	3	0	0	1	0	1
21869	511673	3	0	1	0	1	2
21869	64351	3	0	1	0	0	1
21869	70225	3	0	0	2	0	2
21869	70985	3	0	0	0	1	1
21869	84674	3	0	0	1	1	2
21869	87715	3	1	1	0	0	2
21869	103140	2	0	0	0	0	0
21869	190598	2	0	0	0	2	2
21869	192770	2	0	1	0	0	1
21869	289095	2	1	0	0	0	1
21869	289096	2	0	0	0	0	0
21869	511625	2	0	1	1	0	2
21869	511651	2	0	1	0	1	2
21869	511671	2	1	0	0	0	1
21869	54918	2	0	0	0	0	0
21869	205333	1	0	0	0	1	1
21869	289088	1	0	1	0	0	1
21869	499758	1	0	0	0	0	0
21869	511665	1	0	0	0	0	0
21869	511667	1	0	0	0	5	5
21869	71486	1	0	1	0	0	1
22774	186105	34	5	4	1	4	14
22774	508390	11	3	2	0	3	8
22774	508411	10	0	1	0	1	2
22774	508480	10	1	2	1	1	5
22774	508471	9	1	2	0	0	3
22774	508454	8	1	0	0	1	2
22774	508399	7	1	2	0	0	3
22774	508419	7	0	0	0	1	1
22774	508448	7	1	4	0	1	6
22774	508482	7	2	0	2	0	4
22774	554098	7	3	1	0	1	5
22774	202842	6	0	0	0	4	4
22774	203976	6	0	0	0	3	3
22774	210333	6	2	0	0	2	4
22774	508386	6	3	3	1	1	8
22774	508392	6	0	1	2	1	4
22774	508393	6	3	0	0	0	3
22774	508395	6	2	4	0	1	7
22774	508396	6	0	1	0	2	3
22774	508400	6	3	1	0	0	4
22774	508424	6	3	1	0	2	6
22774	508428	6	3	0	0	3	6
22774	508429	6	1	1	0	3	5
22774	508431	6	1	0	0	4	5
22774	508436	6	2	3	0	0	5
22774	508437	6	1	2	0	1	4
22774	508461	6	0	1	0	0	1
22774	508478	6	1	0	2	2	5
22774	192804	5	1	1	0	2	4
22774	216031	5	0	0	0	3	3
22774	508388	5	1	0	0	0	1
22774	508397	5	2	1	0	3	6
22774	508402	5	3	2	0	2	7
22774	508405	5	2	4	0	1	7
22774	508407	5	2	1	0	1	4
22774	508415	5	1	0	0	0	1
22774	508421	5	0	1	0	1	2
22774	508426	5	0	3	0	1	4
22774	508452	5	1	2	0	2	5
22774	508470	5	0	0	0	4	4
22774	508474	5	2	1	1	1	5
22774	508477	5	1	0	1	2	4
22774	508483	5	1	0	0	0	1
22774	508486	5	0	3	0	2	5
22774	554097	5	2	1	0	0	3
22774	189626	4	0	1	0	0	1
22774	208850	4	1	0	0	4	5
22774	508387	4	0	2	0	1	3
22774	508398	4	0	1	0	1	2
22774	508401	4	1	0	0	1	2
22774	508404	4	2	0	0	0	2
22774	508406	4	0	1	0	0	1
22774	508408	4	0	0	0	1	1
22774	508413	4	0	0	0	3	3
22774	508416	4	0	0	0	4	4
22774	508422	4	0	0	0	1	1
22774	508423	4	2	0	0	1	3
22774	508432	4	1	1	0	2	4
22774	508434	4	0	0	0	3	3
22774	508438	4	0	0	0	0	0
22774	508439	4	2	0	1	1	4
22774	508445	4	2	0	0	0	2
22774	508451	4	2	0	1	1	4
22774	508453	4	1	1	1	0	3
22774	508455	4	0	2	0	1	3
22774	508457	4	2	0	1	1	4
22774	508462	4	1	1	1	0	3
22774	508468	4	2	1	0	0	3
22774	508475	4	1	2	0	1	4
22774	508476	4	2	0	1	2	5
22774	508484	4	0	1	1	2	4
22774	508485	4	0	0	0	0	0
22774	508488	4	1	2	0	3	6
22774	508497	4	1	0	0	1	2
22774	206286	3	0	0	0	2	2
22774	220063	3	1	1	0	0	2
22774	508389	3	0	1	1	0	2
22774	508391	3	1	2	1	1	5
22774	508394	3	0	1	0	2	3
22774	508403	3	0	0	0	0	0
22774	508414	3	0	0	0	2	2
22774	508417	3	0	0	0	1	1
22774	508418	3	1	0	1	0	2
22774	508425	3	1	0	0	0	1
22774	508427	3	1	1	0	1	3
22774	508430	3	1	0	0	1	2
22774	508433	3	1	2	0	2	5
22774	508435	3	1	0	0	2	3
22774	508441	3	0	0	1	1	2
22774	508444	3	0	1	1	1	3
22774	508449	3	0	2	0	0	2
22774	508450	3	2	2	0	0	4
22774	508456	3	0	0	0	1	1
22774	508458	3	0	0	0	0	0
22774	508459	3	3	0	1	0	4
22774	508460	3	0	0	1	1	2
22774	508464	3	1	0	0	0	1
22774	508465	3	1	0	0	1	2
22774	508466	3	1	1	0	1	3
22774	508467	3	0	1	0	0	1
22774	508469	3	0	0	1	1	2
22774	508472	3	0	0	0	4	4
22774	508487	3	0	2	0	2	4
22774	508490	3	0	1	0	2	3
22774	508493	3	1	1	0	0	2
22774	554096	3	0	0	0	1	1
22774	186288	2	0	0	0	0	0
22774	201996	2	0	0	0	1	1
22774	508409	2	0	0	0	1	1
22774	508410	2	0	1	1	1	3
22774	508412	2	0	1	0	4	5
22774	508420	2	1	2	1	0	4
22774	508440	2	0	0	0	0	0
22774	508443	2	3	0	0	1	4
22774	508446	2	0	0	1	0	1
22774	508463	2	1	0	0	0	1
22774	508473	2	1	1	0	1	3
22774	508479	2	1	0	0	1	2
22774	508481	2	2	0	0	0	2
22774	508489	2	2	0	0	1	3
22774	508491	2	1	1	0	1	3
22774	508492	2	2	0	0	0	2
22774	508494	2	0	0	0	4	4
22774	508495	2	1	2	0	0	3
22774	508496	2	0	0	0	0	0
22774	186603	1	0	0	0	0	0
22774	186973	1	0	0	0	3	3
22774	205920	1	1	0	0	0	1
22774	508385	1	1	0	0	0	1
22774	508442	1	0	0	0	0	0
22774	508447	1	0	0	0	0	0
56181	186216	80	10	14	2	12	38
56181	529899	47	9	11	2	8	30
56181	57094	35	3	5	3	2	13
56181	51286	30	1	1	0	3	5
56181	190290	29	3	4	2	4	13
56181	529892	29	3	4	2	4	13
56181	297931	28	1	4	0	2	7
56181	52332	28	2	2	1	6	11
56181	529903	27	1	4	0	2	7
56181	97781	27	1	4	0	2	7
56181	187633	25	3	10	1	8	22
56181	210256	25	1	7	0	1	9
56181	529888	25	3	6	1	5	15
56181	107687	23	2	6	1	5	14
56181	220457	23	2	6	1	5	14
56181	99640	23	4	6	3	4	17
56181	200658	22	0	3	5	4	12
56181	529891	22	0	3	5	4	12
56181	53446	22	2	5	0	1	8
56181	81103	21	3	1	1	4	9
56181	91566	20	2	6	0	3	11
56181	297920	19	2	6	0	3	11
56181	529895	19	3	5	0	0	8
56181	91827	19	3	5	0	0	8
56181	529897	18	1	2	0	1	4
56181	529898	18	1	2	0	1	4
56181	70471	17	1	2	0	1	4
56181	297912	16	1	2	0	1	4
56181	529905	16	2	1	0	2	5
56181	529906	16	2	1	0	2	5
56181	72529	14	1	3	0	1	5
56181	529881	13	1	0	0	0	1
56181	529904	13	0	3	0	1	4
56181	297922	12	0	5	2	2	9
56181	529887	12	2	4	0	2	8
56181	529890	12	2	3	0	0	5
56181	69231	12	1	3	0	5	9
56181	188360	11	1	3	0	0	4
56181	219534	11	0	1	1	0	2
56181	297926	11	2	2	1	1	6
56181	76267	11	2	2	1	1	6
56181	106203	10	0	1	1	0	2
56181	200226	10	1	1	0	1	3
56181	297928	10	2	0	1	0	3
56181	529900	10	2	0	1	0	3
56181	61085	10	0	2	0	0	2
56181	74651	10	2	0	1	0	3
56181	194640	9	2	0	0	0	2
56181	297918	9	0	1	0	1	2
56181	529885	9	2	3	0	0	5
56181	78107	9	0	0	0	1	1
56181	106581	8	0	0	0	2	2
56181	210008	8	2	2	0	2	6
56181	297916	8	0	0	0	2	2
56181	297927	8	2	2	0	2	6
56181	529882	8	0	1	1	1	3
56181	61870	8	0	0	0	3	3
56181	92988	8	2	2	0	2	6
56181	189045	7	0	2	0	0	2
56181	297910	7	0	0	0	0	0
56181	297924	7	1	1	0	2	4
56181	297925	7	0	2	0	0	2
56181	529886	7	1	2	0	0	3
56181	529893	7	1	1	0	2	4
56181	529894	7	0	2	0	0	2
56181	57200	7	2	2	0	3	7
56181	71322	7	0	0	0	0	0
56181	78804	7	2	3	3	4	12
56181	94041	7	1	1	0	2	4
56181	297919	6	0	1	0	0	1
56181	297929	6	2	2	0	0	4
56181	56183	6	0	1	0	0	1
56181	75685	6	3	2	0	1	6
56181	85050	6	3	1	0	1	5
56181	91034	6	2	2	0	0	4
56181	101835	5	1	0	0	0	1
56181	104245	5	0	4	0	3	7
56181	204183	5	1	1	0	2	4
56181	297917	5	0	1	0	0	1
56181	297930	5	1	0	0	0	1
56181	529878	5	1	2	0	1	4
56181	61345	5	0	1	0	0	1
56181	64189	5	2	0	0	0	2
56181	66836	5	0	2	0	2	4
56181	81788	5	1	0	0	0	1
56181	83842	5	1	1	0	0	2
56181	108431	4	1	2	0	2	5
56181	186646	4	1	2	0	0	3
56181	193354	4	0	2	0	0	2
56181	205370	4	1	2	0	2	5
56181	207158	4	0	2	1	1	4
56181	297921	4	2	3	0	1	6
56181	529880	4	2	1	0	0	3
56181	529884	4	1	2	0	0	3
56181	529889	4	0	1	0	1	2
56181	529902	4	0	2	0	0	2
56181	57635	4	0	0	0	0	0
56181	65874	4	0	2	0	2	4
56181	70580	4	0	1	0	0	1
56181	76042	4	1	2	0	2	5
56181	80603	4	0	3	0	2	5
56181	86195	4	0	0	0	1	1
56181	90495	4	1	2	0	2	5
56181	98860	4	1	2	1	0	4
56181	182099	3	0	0	0	0	0
56181	187213	3	1	0	0	1	2
56181	189403	3	1	2	0	1	4
56181	193658	3	0	2	0	1	3
56181	196547	3	0	2	0	0	2
56181	297908	3	0	1	0	0	1
56181	297909	3	0	2	0	0	2
56181	529879	3	0	1	0	0	1
56181	71500	3	0	2	0	0	2
56181	89571	3	1	3	0	2	6
56181	195838	2	1	1	0	0	2
56181	297913	2	2	1	0	0	3
56181	297914	2	1	0	0	0	1
56181	297915	2	1	0	0	0	1
56181	297932	2	0	0	0	0	0
56181	529877	2	0	1	0	0	1
56181	529883	2	2	1	0	1	4
56181	529896	2	2	3	0	0	5
56181	529901	2	0	1	0	0	1
56181	71041	2	2	1	0	0	3
56181	74268	2	1	1	1	3	6
56181	92559	2	2	1	0	0	3
56181	93004	2	0	0	0	0	0
56181	208515	1	0	0	0	0	0
56181	54492	1	1	0	0	0	1
56181	85407	1	0	0	0	0	0
24145	555514	43	1	6	0	8	15
24145	555561	42	1	0	0	7	8
24145	289700	40	2	5	2	10	19
24145	555513	40	2	1	1	7	11
24145	191474	21	3	1	0	2	6
24145	555512	20	0	1	1	4	6
24145	555499	16	2	4	1	7	14
24145	193817	14	1	1	0	3	5
24145	289701	13	1	1	0	3	5
24145	555511	13	2	0	1	0	3
24145	555528	13	2	0	1	0	3
24145	555531	13	0	0	0	3	3
24145	555569	10	3	1	2	1	7
24145	555523	9	2	1	0	4	7
24145	555563	9	1	3	0	1	5
24145	555571	9	0	2	0	0	2
24145	289703	8	0	2	0	2	4
24145	555517	8	1	1	0	3	5
24145	555519	8	1	1	0	3	5
24145	555520	8	1	1	0	3	5
24145	555526	8	0	0	0	1	1
24145	555532	8	2	2	0	2	6
24145	555541	8	0	0	0	0	0
24145	555547	8	3	0	1	2	6
24145	183350	7	1	1	0	3	5
24145	205450	7	2	0	1	1	4
24145	207700	7	1	2	0	2	5
24145	289698	7	3	2	2	4	11
24145	555525	7	1	1	0	3	5
24145	555527	7	2	0	0	3	5
24145	555530	7	1	2	0	5	8
24145	555537	7	0	1	0	2	3
24145	555556	7	2	0	0	3	5
24145	555581	7	2	0	0	2	4
24145	201236	6	1	4	0	0	5
24145	202723	6	2	1	0	0	3
24145	210000	6	0	0	1	2	3
24145	555503	6	4	0	0	0	4
24145	555521	6	0	1	1	1	3
24145	555533	6	2	1	0	3	6
24145	555538	6	0	3	1	3	7
24145	555558	6	0	1	0	2	3
24145	555560	6	1	1	0	1	3
24145	188194	5	1	3	0	8	12
24145	201252	5	0	2	0	1	3
24145	212808	5	1	0	0	0	1
24145	215005	5	0	3	0	2	5
24145	217457	5	0	0	0	3	3
24145	219052	5	2	1	0	1	4
24145	555506	5	4	2	2	4	12
24145	555515	5	3	0	0	6	9
24145	555522	5	0	0	0	2	2
24145	555536	5	0	0	0	1	1
24145	555540	5	1	1	0	1	3
24145	555545	5	1	1	0	6	8
24145	555549	5	1	0	0	0	1
24145	555554	5	1	0	1	1	3
24145	555574	5	0	0	0	0	0
24145	185461	4	1	0	0	0	1
24145	190597	4	2	1	0	0	3
24145	191844	4	0	3	0	0	3
24145	206190	4	0	1	0	0	1
24145	214689	4	0	0	0	1	1
24145	215864	4	0	0	0	0	0
24145	216791	4	1	1	0	2	4
24145	289695	4	0	3	0	0	3
24145	289697	4	1	1	0	2	4
24145	289702	4	1	0	0	5	6
24145	555501	4	0	0	0	2	2
24145	555510	4	1	0	1	2	4
24145	555524	4	1	2	1	2	6
24145	555529	4	0	0	0	3	3
24145	555543	4	0	0	0	4	4
24145	555559	4	0	1	0	3	4
24145	555565	4	0	0	0	2	2
24145	555568	4	1	3	0	0	4
24145	555575	4	1	0	0	4	5
24145	555577	4	1	0	1	1	3
24145	555579	4	1	0	0	2	3
24145	555580	4	2	4	1	0	7
24145	185520	3	1	0	0	0	1
24145	187136	3	1	0	0	2	3
24145	190317	3	1	0	1	2	4
24145	191713	3	1	0	0	0	1
24145	193588	3	1	2	0	1	4
24145	196041	3	1	1	0	1	3
24145	200008	3	0	1	0	1	2
24145	203442	3	0	0	0	2	2
24145	206815	3	1	0	0	0	1
24145	207208	3	2	0	1	0	3
24145	214084	3	0	0	0	5	5
24145	218091	3	0	1	0	0	1
24145	555504	3	0	0	1	2	3
24145	555505	3	0	1	0	1	2
24145	555535	3	1	0	0	1	2
24145	555539	3	2	0	0	0	2
24145	555542	3	0	2	1	2	5
24145	555544	3	1	1	0	5	7
24145	555555	3	1	0	0	0	1
24145	555562	3	0	1	0	1	2
24145	555564	3	2	0	0	3	5
24145	555576	3	0	0	0	3	3
24145	555578	3	1	0	0	1	2
24145	185155	2	1	0	0	0	1
24145	195679	2	1	2	0	1	4
24145	202071	2	0	0	0	1	1
24145	289696	2	2	0	0	2	4
24145	289699	2	0	1	0	2	3
24145	555502	2	1	1	0	1	3
24145	555507	2	2	1	0	0	3
24145	555508	2	1	1	0	0	2
24145	555509	2	0	0	0	0	0
24145	555516	2	1	1	0	0	2
24145	555546	2	1	0	0	1	2
24145	555548	2	0	0	0	2	2
24145	555550	2	0	1	0	0	1
24145	555552	2	0	0	0	0	0
24145	555557	2	1	0	0	0	1
24145	555566	2	0	1	1	1	3
24145	555567	2	1	0	0	1	2
24145	555570	2	1	0	0	0	1
24145	185881	1	0	0	0	0	0
24145	199247	1	0	0	0	0	0
24145	215355	1	0	0	0	0	0
24145	555500	1	0	0	0	0	0
24145	555534	1	1	1	0	0	2
24145	555551	1	0	0	0	0	0
24145	555553	1	0	0	0	0	0
24145	555572	1	0	0	0	1	1
24145	555573	1	0	2	0	0	2
57183	213739	33	3	11	1	6	21
57183	75562	26	1	4	1	0	6
57183	281398	24	2	4	2	2	10
57183	505243	24	2	4	2	2	10
57183	76955	24	2	4	2	2	10
57183	505239	23	0	3	1	0	4
57183	86853	23	0	3	1	0	4
57183	96634	20	1	2	0	0	3
57183	58431	18	1	3	0	2	6
57183	61595	18	2	0	0	0	2
57183	281396	16	2	1	0	3	6
57183	51995	16	1	2	0	3	6
57183	80288	16	2	1	0	3	6
57183	188717	15	1	8	0	0	9
57183	281417	15	1	8	0	0	9
57183	59926	15	1	8	0	0	9
57183	80343	15	0	2	0	1	3
57183	187361	14	0	7	0	1	8
57183	69164	14	0	7	0	1	8
57183	281397	13	0	1	0	0	1
57183	195462	12	3	0	0	0	3
57183	53452	11	0	4	0	1	5
57183	55356	11	1	2	0	1	4
57183	85859	11	4	2	0	0	6
57183	281413	10	2	1	0	0	3
57183	281415	10	1	0	0	0	1
57183	505237	10	1	1	0	2	4
57183	53900	10	2	1	0	0	3
57183	97784	10	1	0	0	0	1
57183	281407	9	0	1	0	0	1
57183	80838	9	0	1	0	0	1
57183	103005	8	1	0	0	0	1
57183	184055	8	1	1	0	0	2
57183	209913	8	2	1	0	0	3
57183	281401	8	1	0	0	0	1
57183	281414	8	1	1	0	0	2
57183	505242	8	2	3	0	3	8
57183	505250	8	1	1	0	0	2
57183	505251	8	0	1	0	0	1
57183	52284	8	1	1	0	0	2
57183	55098	8	0	1	0	2	3
57183	84877	8	1	3	0	0	4
57183	104299	7	2	1	1	2	6
57183	106214	7	0	1	0	0	1
57183	219659	7	0	1	0	0	1
57183	505238	7	3	5	0	0	8
57183	505247	7	0	3	0	0	3
57183	505252	7	5	1	0	0	6
57183	86577	7	1	0	1	0	2
57183	281395	6	0	2	0	0	2
57183	505244	6	2	2	0	0	4
57183	623996	6	0	3	0	1	4
57183	73748	6	1	2	0	0	3
57183	81834	6	0	2	0	1	3
57183	86414	6	1	1	0	0	2
57183	91832	6	2	2	0	0	4
57183	97991	6	0	2	0	0	2
57183	102429	5	1	0	0	0	1
57183	104116	5	0	0	0	1	1
57183	184711	5	1	1	0	0	2
57183	192754	5	1	0	0	0	1
57183	201942	5	1	3	0	0	4
57183	204262	5	1	2	0	0	3
57183	281400	5	1	2	0	0	3
57183	281402	5	1	0	0	0	1
57183	281404	5	0	1	0	0	1
57183	281408	5	1	1	0	0	2
57183	281409	5	1	1	0	1	3
57183	281412	5	1	1	0	0	2
57183	505236	5	0	0	0	0	0
57183	505245	5	1	2	0	0	3
57183	505248	5	0	1	0	0	1
57183	505249	5	1	1	0	0	2
57183	53753	5	1	1	0	0	2
57183	54293	5	1	1	0	0	2
57183	57266	5	0	1	0	1	2
57183	70291	5	0	1	0	0	1
57183	81815	5	0	4	0	2	6
57183	84482	5	1	2	0	0	3
57183	106769	4	0	6	0	0	6
57183	186845	4	0	0	0	0	0
57183	200446	4	1	0	0	0	1
57183	205703	4	0	3	0	0	3
57183	220654	4	2	1	0	0	3
57183	221251	4	0	1	0	0	1
57183	221762	4	0	0	0	1	1
57183	505240	4	1	0	0	0	1
57183	505246	4	0	1	0	0	1
57183	52346	4	1	0	0	0	1
57183	62365	4	2	5	0	0	7
57183	72328	4	1	0	0	0	1
57183	77504	4	1	4	0	0	5
57183	92392	4	1	0	0	0	1
57183	184414	3	2	1	0	0	3
57183	187216	3	1	0	0	0	1
57183	193441	3	0	0	0	0	0
57183	194724	3	0	1	0	0	1
57183	198867	3	0	3	0	0	3
57183	210024	3	1	1	0	0	2
57183	281399	3	0	0	0	0	0
57183	281403	3	1	2	0	0	3
57183	281411	3	0	0	0	0	0
57183	505234	3	1	1	0	0	2
57183	64597	3	0	0	0	0	0
57183	74494	3	0	3	0	0	3
57183	74723	3	1	2	0	0	3
57183	79372	3	1	1	0	0	2
57183	80583	3	0	0	0	0	0
57183	85586	3	0	0	0	0	0
57183	87273	3	1	2	0	0	3
57183	104580	2	1	2	0	1	4
57183	183664	2	0	1	0	0	1
57183	212805	2	1	1	0	0	2
57183	213400	2	0	1	0	0	1
57183	217817	2	0	0	0	0	0
57183	281410	2	1	1	0	0	2
57183	505235	2	2	2	0	0	4
57183	57034	2	1	0	0	0	1
57183	623995	2	0	3	0	0	3
57183	104998	1	1	0	0	0	1
57183	185313	1	0	0	0	0	0
57183	281405	1	0	0	0	0	0
57183	281406	1	1	0	0	0	1
57183	505241	1	1	2	0	0	3
57183	54494	1	0	0	0	0	0
57183	54626	1	0	1	0	1	2
57183	623997	1	1	0	0	0	1
57183	79736	1	0	0	0	0	0
57183	85260	1	0	0	0	0	0
39191	535064	14	5	5	2	2	14
39191	534997	11	4	0	0	0	4
39191	534983	9	0	0	0	0	0
39191	535044	9	0	1	0	3	4
39191	535090	9	1	0	1	2	4
39191	535055	8	3	0	0	0	3
39191	535008	7	2	0	3	0	5
39191	535025	7	0	0	0	0	0
39191	535040	7	0	0	0	0	0
39191	535072	7	0	0	0	0	0
39191	535018	6	1	0	0	2	3
39191	535058	6	1	1	0	0	2
39191	535074	6	5	0	0	0	5
39191	534993	5	1	0	0	2	3
39191	535017	5	1	0	0	0	1
39191	535027	5	0	0	0	1	1
39191	535038	5	0	1	0	0	1
39191	535043	5	2	0	0	0	2
39191	535051	5	0	1	0	2	3
39191	535053	5	0	0	0	2	2
39191	535061	5	2	0	0	0	2
39191	535067	5	0	0	0	0	0
39191	535081	5	0	0	0	0	0
39191	459614	4	0	0	0	1	1
39191	534984	4	2	0	0	1	3
39191	535003	4	1	1	0	0	2
39191	535031	4	4	1	0	0	5
39191	535036	4	0	0	0	0	0
39191	535045	4	0	1	0	0	1
39191	535056	4	0	0	0	0	0
39191	535059	4	0	0	0	0	0
39191	535060	4	0	0	0	0	0
39191	535066	4	1	1	0	0	2
39191	535070	4	1	1	0	0	2
39191	535082	4	2	0	0	0	2
39191	535085	4	0	1	0	0	1
39191	535091	4	0	0	0	1	1
39191	535094	4	2	1	0	0	3
39191	535095	4	1	0	0	0	1
39191	535099	4	1	0	0	0	1
39191	534985	3	1	0	0	0	1
39191	534992	3	1	1	0	0	2
39191	534996	3	1	0	0	0	1
39191	534998	3	2	2	0	0	4
39191	534999	3	1	1	0	0	2
39191	535000	3	1	0	1	1	3
39191	535007	3	1	0	0	2	3
39191	535009	3	2	0	0	0	2
39191	535010	3	2	0	0	0	2
39191	535011	3	0	0	0	1	1
39191	535014	3	3	0	0	0	3
39191	535015	3	2	0	0	0	2
39191	535016	3	2	2	0	0	4
39191	535019	3	0	0	0	0	0
39191	535026	3	2	0	0	0	2
39191	535028	3	1	0	0	0	1
39191	535030	3	1	3	0	0	4
39191	535032	3	1	0	0	0	1
39191	535035	3	1	1	0	0	2
39191	535037	3	0	0	0	1	1
39191	535041	3	2	0	0	0	2
39191	535042	3	2	1	0	1	4
39191	535046	3	1	0	0	0	1
39191	535063	3	1	0	0	0	1
39191	535068	3	0	0	1	0	1
39191	535071	3	4	0	1	0	5
39191	535075	3	0	0	0	0	0
39191	535077	3	0	0	0	0	0
39191	535079	3	1	0	0	0	1
39191	535084	3	0	0	1	0	1
39191	535086	3	0	0	1	0	1
39191	535088	3	1	0	0	0	1
39191	535092	3	1	0	0	0	1
39191	535096	3	1	0	0	0	1
39191	535100	3	0	0	0	0	0
39191	519321	2	1	0	0	0	1
39191	534978	2	0	0	0	2	2
39191	534979	2	1	0	0	0	1
39191	534981	2	0	0	0	1	1
39191	534982	2	1	0	0	0	1
39191	534987	2	1	1	0	0	2
39191	534990	2	0	0	0	0	0
39191	534991	2	0	0	0	0	0
39191	534994	2	0	0	0	0	0
39191	534995	2	0	0	0	1	1
39191	535001	2	0	0	0	0	0
39191	535002	2	0	0	0	1	1
39191	535005	2	0	0	0	0	0
39191	535012	2	0	0	0	1	1
39191	535013	2	0	0	0	1	1
39191	535020	2	0	0	0	0	0
39191	535022	2	1	1	0	0	2
39191	535023	2	2	1	0	0	3
39191	535029	2	4	1	0	0	5
39191	535033	2	0	0	0	0	0
39191	535034	2	0	0	0	0	0
39191	535039	2	2	2	0	0	4
39191	535048	2	0	0	0	0	0
39191	535049	2	2	1	0	0	3
39191	535050	2	3	0	0	1	4
39191	535052	2	0	0	0	1	1
39191	535054	2	1	0	0	0	1
39191	535057	2	0	0	0	2	2
39191	535062	2	0	1	0	1	2
39191	535069	2	3	0	0	0	3
39191	535073	2	2	0	1	0	3
39191	535078	2	3	0	0	0	3
39191	535080	2	2	0	0	0	2
39191	535089	2	1	0	0	0	1
39191	535093	2	1	0	0	0	1
39191	535097	2	1	0	0	0	1
39191	535098	2	0	1	0	0	1
39191	459613	1	0	0	0	0	0
39191	534977	1	0	0	0	0	0
39191	534980	1	0	0	0	0	0
39191	534986	1	0	0	0	0	0
39191	534988	1	1	0	0	0	1
39191	534989	1	0	0	0	0	0
39191	535004	1	1	0	0	1	2
39191	535006	1	0	0	0	0	0
39191	535021	1	0	0	0	0	0
39191	535024	1	0	0	0	0	0
39191	535047	1	0	0	0	0	0
39191	535065	1	0	0	0	0	0
39191	535076	1	1	0	0	0	1
39191	535083	1	0	0	0	0	0
39191	535087	1	1	0	0	0	1
39191	535101	1	0	0	0	0	0
39191	535102	1	0	0	0	0	0
39191	535103	1	0	0	0	0	0
56657	198208	26	3	4	0	3	10
56657	554655	17	2	0	0	2	4
56657	554651	10	1	0	0	0	1
56657	554658	10	2	1	0	1	4
56657	188610	9	0	1	1	0	2
56657	554628	9	3	0	0	0	3
56657	188027	8	0	0	0	2	2
56657	298034	8	0	1	1	0	2
56657	554623	8	1	1	0	4	6
56657	554633	8	3	0	0	3	6
56657	554669	8	1	0	1	1	3
56657	59924	8	0	1	1	0	2
56657	554635	7	1	0	0	1	2
56657	554642	7	3	0	0	1	4
56657	554622	6	0	1	0	1	2
56657	554645	6	3	0	0	0	3
56657	554648	6	1	0	0	1	2
56657	554670	6	1	1	0	0	2
56657	554673	6	2	0	0	1	3
56657	218991	5	1	0	0	0	1
56657	220866	5	3	0	0	0	3
56657	554595	5	2	0	0	1	3
56657	554604	5	1	0	0	1	2
56657	554605	5	2	1	1	1	5
56657	554612	5	1	0	0	1	2
56657	554617	5	0	0	0	1	1
56657	554636	5	3	0	0	0	3
56657	554637	5	2	1	0	2	5
56657	554638	5	2	1	0	4	7
56657	554643	5	1	1	1	0	3
56657	554652	5	0	0	0	1	1
56657	554660	5	1	0	0	0	1
56657	554662	5	4	1	0	0	5
56657	554671	5	1	0	0	1	2
56657	554678	5	1	0	0	0	1
56657	554684	5	3	0	0	0	3
56657	554687	5	1	0	0	1	2
56657	183230	4	2	0	0	1	3
56657	186344	4	0	0	0	3	3
56657	201370	4	0	0	0	1	1
56657	203809	4	2	0	0	1	3
56657	554576	4	1	0	0	1	2
56657	554580	4	1	0	0	2	3
56657	554583	4	1	0	0	0	1
56657	554587	4	1	0	0	1	2
56657	554597	4	1	1	0	0	2
56657	554602	4	3	0	0	0	3
56657	554609	4	1	0	0	1	2
56657	554613	4	1	0	0	1	2
56657	554614	4	1	0	1	2	4
56657	554619	4	1	0	0	0	1
56657	554629	4	1	0	0	0	1
56657	554639	4	1	0	0	1	2
56657	554640	4	0	0	0	2	2
56657	554647	4	2	0	0	1	3
56657	554649	4	1	0	0	1	2
56657	554650	4	0	0	0	0	0
56657	554661	4	1	0	0	3	4
56657	554664	4	2	0	0	0	2
56657	554674	4	2	0	0	0	2
56657	554676	4	1	0	0	0	1
56657	554677	4	2	0	0	0	2
56657	554679	4	1	1	0	1	3
56657	554681	4	0	0	0	0	0
56657	554683	4	0	0	1	1	2
56657	203328	3	0	0	0	1	1
56657	207787	3	0	0	0	1	1
56657	298035	3	0	0	0	1	1
56657	298036	3	1	0	2	0	3
56657	554577	3	1	0	0	0	1
56657	554579	3	0	0	0	0	0
56657	554585	3	1	0	0	1	2
56657	554586	3	0	0	0	1	1
56657	554589	3	1	0	0	0	1
56657	554596	3	1	0	0	1	2
56657	554606	3	1	0	0	1	2
56657	554610	3	0	0	0	1	1
56657	554611	3	3	0	1	0	4
56657	554615	3	1	0	0	0	1
56657	554620	3	2	0	0	4	6
56657	554625	3	1	1	0	0	2
56657	554627	3	2	0	0	0	2
56657	554630	3	1	0	0	0	1
56657	554631	3	1	0	0	0	1
56657	554634	3	1	0	0	1	2
56657	554646	3	0	0	0	1	1
56657	554653	3	0	0	0	1	1
56657	554656	3	0	0	0	0	0
56657	554657	3	3	0	0	0	3
56657	554659	3	0	0	1	0	1
56657	554663	3	1	0	0	0	1
56657	554665	3	2	0	0	1	3
56657	554668	3	0	0	0	0	0
56657	554672	3	1	1	3	0	5
56657	554685	3	3	0	0	0	3
56657	554686	3	1	0	0	1	2
56657	84735	3	0	0	0	1	1
56657	196214	2	0	0	0	2	2
56657	554578	2	1	0	0	1	2
56657	554581	2	0	0	0	1	1
56657	554582	2	0	0	0	1	1
56657	554584	2	1	0	0	1	2
56657	554588	2	0	0	0	1	1
56657	554591	2	0	0	0	2	2
56657	554594	2	0	0	0	0	0
56657	554598	2	1	0	0	0	1
56657	554601	2	1	0	0	2	3
56657	554603	2	0	0	0	0	0
56657	554607	2	0	0	0	0	0
56657	554608	2	1	0	0	0	1
56657	554618	2	0	0	0	0	0
56657	554621	2	1	0	0	0	1
56657	554624	2	2	0	0	0	2
56657	554632	2	1	0	0	1	2
56657	554641	2	0	1	0	1	2
56657	554644	2	0	0	0	0	0
56657	554654	2	0	0	0	0	0
56657	554667	2	1	0	0	1	2
56657	554675	2	0	0	0	1	1
56657	554680	2	1	1	0	0	2
56657	554682	2	0	0	0	1	1
56657	554590	1	1	0	0	1	2
56657	554592	1	0	0	0	0	0
56657	554593	1	0	0	0	1	1
56657	554599	1	1	0	0	1	2
56657	554600	1	2	0	0	1	3
56657	554616	1	1	0	0	0	1
56657	554626	1	1	0	0	1	2
56657	554666	1	0	0	0	1	1
65961	198904	30	2	3	1	0	6
65961	300776	29	2	3	1	0	6
65961	74532	29	2	3	1	0	6
65961	93326	27	2	3	1	5	11
65961	80060	22	0	4	0	2	6
65961	474151	20	0	1	0	2	3
65961	197904	19	0	0	0	0	0
65961	103013	16	1	0	1	0	2
65961	300775	16	1	0	1	0	2
65961	300783	16	2	2	0	1	5
65961	474160	15	0	2	0	3	5
65961	210843	11	0	2	0	0	2
65961	474178	11	0	2	0	0	2
65961	87207	11	1	3	0	0	4
65961	106764	10	3	0	1	1	5
65961	474174	10	5	1	0	0	6
65961	55527	10	0	2	0	0	2
65961	188162	9	0	2	0	0	2
65961	203246	9	0	1	0	0	1
65961	300782	9	1	4	0	0	5
65961	474156	9	3	3	0	0	6
65961	474176	9	1	4	0	0	5
65961	474179	9	1	6	0	2	9
65961	474186	9	3	2	0	0	5
65961	474137	8	2	1	0	0	3
65961	474169	8	0	4	0	0	4
65961	474181	8	0	1	0	1	2
65961	100224	7	0	2	1	0	3
65961	101202	7	2	0	0	0	2
65961	187431	7	1	2	0	0	3
65961	194784	7	0	1	0	0	1
65961	300784	7	2	0	0	0	2
65961	474180	7	0	2	1	0	3
65961	474183	7	0	2	0	1	3
65961	474184	7	2	3	0	0	5
65961	57045	7	1	7	0	1	9
65961	86586	7	1	2	0	0	3
65961	107790	6	0	2	0	1	3
65961	210513	6	1	1	0	0	2
65961	474159	6	1	3	0	0	4
65961	474167	6	1	1	0	1	3
65961	98168	6	2	1	0	0	3
65961	184961	5	0	2	0	0	2
65961	190421	5	0	1	0	1	2
65961	195502	5	0	0	0	1	1
65961	217349	5	0	0	0	0	0
65961	218726	5	1	0	0	1	2
65961	221586	5	1	1	1	0	3
65961	300785	5	0	0	0	0	0
65961	300789	5	0	1	0	2	3
65961	300790	5	2	2	0	0	4
65961	474140	5	0	2	0	1	3
65961	474148	5	0	0	0	1	1
65961	474155	5	1	1	0	0	2
65961	474170	5	0	3	0	0	3
65961	474175	5	0	3	0	0	3
65961	474177	5	0	2	0	0	2
65961	54634	5	2	3	0	0	5
65961	55974	5	0	1	0	2	3
65961	66697	5	2	2	0	0	4
65961	106741	4	1	2	0	0	3
65961	195505	4	0	1	0	0	1
65961	204408	4	0	1	0	0	1
65961	212663	4	1	2	0	0	3
65961	218739	4	3	0	0	0	3
65961	300774	4	1	2	0	0	3
65961	300777	4	0	1	0	0	1
65961	300780	4	0	2	0	0	2
65961	300791	4	0	0	0	0	0
65961	474138	4	0	1	0	0	1
65961	474139	4	1	0	0	0	1
65961	474145	4	0	0	0	3	3
65961	474150	4	1	1	0	0	2
65961	474154	4	0	0	0	0	0
65961	474157	4	1	2	0	0	3
65961	474158	4	0	1	0	0	1
65961	474164	4	1	0	0	0	1
65961	474166	4	0	0	0	0	0
65961	474171	4	1	0	0	1	2
65961	474172	4	0	0	0	0	0
65961	474182	4	2	1	0	1	4
65961	474188	4	0	0	0	0	0
65961	53000	4	1	0	0	0	1
65961	84512	4	0	1	0	0	1
65961	98518	4	0	2	0	0	2
65961	100120	3	1	0	0	0	1
65961	103605	3	0	0	0	0	0
65961	184401	3	1	0	0	0	1
65961	196117	3	0	0	0	0	0
65961	213405	3	0	0	0	0	0
65961	214207	3	0	1	0	0	1
65961	220649	3	0	0	0	0	0
65961	300787	3	1	0	0	0	1
65961	300788	3	0	2	0	0	2
65961	474136	3	1	1	0	0	2
65961	474143	3	1	1	0	0	2
65961	474146	3	0	1	0	0	1
65961	474147	3	0	3	0	0	3
65961	474152	3	0	2	0	3	5
65961	474162	3	1	1	0	0	2
65961	474163	3	1	1	0	0	2
65961	474165	3	0	0	0	2	2
65961	474168	3	0	1	0	0	1
65961	474173	3	0	0	0	0	0
65961	474185	3	0	3	0	2	5
65961	474189	3	0	2	0	0	2
65961	182691	2	0	0	0	0	0
65961	184745	2	0	2	0	0	2
65961	200307	2	1	0	0	0	1
65961	203817	2	0	4	0	0	4
65961	218806	2	0	0	0	0	0
65961	219935	2	0	0	0	0	0
65961	300778	2	0	0	0	0	0
65961	300779	2	0	0	0	0	0
65961	300781	2	0	1	0	0	1
65961	300786	2	0	2	0	0	2
65961	474141	2	0	0	0	0	0
65961	474142	2	2	1	0	1	4
65961	474144	2	2	2	0	0	4
65961	474149	2	0	1	0	0	1
65961	474153	2	0	1	0	1	2
65961	474187	2	0	1	0	0	1
65961	53789	2	0	1	0	0	1
65961	54332	2	0	2	0	0	2
65961	70856	2	0	0	0	0	0
65961	72012	2	0	0	0	0	0
65961	185792	1	0	0	0	0	0
65961	199872	1	0	1	0	0	1
65961	210036	1	0	0	0	0	0
20869	66883	56	4	4	0	0	8
20869	482464	44	7	8	1	7	23
20869	78660	36	3	6	2	3	14
20869	87408	36	5	1	1	1	8
20869	69075	35	4	3	0	0	7
20869	99150	35	2	3	2	3	10
20869	482450	32	1	1	4	5	11
20869	74799	30	3	6	1	2	12
20869	482375	28	3	4	0	4	11
20869	66905	28	2	1	0	0	3
20869	101268	27	2	0	0	0	2
20869	482455	27	2	5	1	2	10
20869	93157	24	1	5	0	2	8
20869	188352	20	1	0	0	0	1
20869	482465	19	0	1	0	3	4
20869	482442	17	1	1	1	0	3
20869	482439	16	5	2	0	2	9
20869	74733	15	3	2	0	0	5
20869	85488	15	2	1	0	0	3
20869	482413	14	2	1	0	2	5
20869	482410	13	1	1	0	0	2
20869	482430	13	7	3	1	1	12
20869	482443	13	1	5	1	0	7
20869	482458	13	6	2	0	0	8
20869	482461	13	0	4	1	1	6
20869	482377	12	1	0	0	0	1
20869	482378	12	5	3	0	1	9
20869	482414	12	4	0	0	1	5
20869	74876	12	1	0	0	0	1
20869	288801	11	1	1	0	1	3
20869	482411	11	1	6	4	1	12
20869	482448	11	0	0	0	0	0
20869	97894	11	1	1	0	1	3
20869	482386	10	4	2	3	0	9
20869	482427	9	3	5	1	1	10
20869	482432	9	2	4	0	0	6
20869	482438	9	2	4	1	0	7
20869	482449	9	1	2	0	1	4
20869	482452	9	1	1	0	0	2
20869	482462	9	1	2	0	0	3
20869	482392	8	1	2	1	0	4
20869	482400	8	5	3	0	0	8
20869	482401	8	4	4	0	1	9
20869	482433	8	0	4	0	1	5
20869	482467	8	1	1	0	3	5
20869	102030	7	0	2	0	0	2
20869	482383	7	2	2	1	0	5
20869	482446	7	1	0	0	0	1
20869	482451	7	1	1	0	0	2
20869	482459	7	1	3	0	0	4
20869	50169	7	2	2	1	0	5
20869	90169	7	0	0	0	0	0
20869	482381	6	0	0	0	1	1
20869	482395	6	0	0	0	1	1
20869	482396	6	4	1	0	0	5
20869	482407	6	1	0	0	0	1
20869	482421	6	0	0	1	0	1
20869	482440	6	3	0	0	1	4
20869	482441	6	1	2	0	0	3
20869	482444	6	0	1	0	0	1
20869	83288	6	3	1	3	0	7
20869	288802	5	0	1	0	0	1
20869	482394	5	1	1	0	0	2
20869	482408	5	1	1	0	0	2
20869	482415	5	2	1	0	0	3
20869	482417	5	0	2	0	0	2
20869	482425	5	0	0	0	0	0
20869	482428	5	0	1	1	0	2
20869	482435	5	2	3	0	1	6
20869	482447	5	1	2	0	1	4
20869	482453	5	0	1	0	0	1
20869	482463	5	0	1	0	0	1
20869	78898	5	2	0	0	0	2
20869	84395	5	0	1	0	0	1
20869	85655	5	0	1	1	0	2
20869	89989	5	2	1	0	0	3
20869	288803	4	1	0	0	0	1
20869	482384	4	4	2	0	0	6
20869	482390	4	1	0	0	2	3
20869	482398	4	4	0	0	0	4
20869	482399	4	0	2	0	1	3
20869	482403	4	1	2	0	0	3
20869	482406	4	4	0	0	1	5
20869	482409	4	2	1	0	0	3
20869	482412	4	2	0	0	0	2
20869	482419	4	0	0	0	0	0
20869	482420	4	2	0	0	0	2
20869	482422	4	2	1	0	0	3
20869	482436	4	1	1	0	0	2
20869	482437	4	0	1	1	0	2
20869	482445	4	0	0	0	0	0
20869	482456	4	0	1	0	0	1
20869	482460	4	1	0	0	0	1
20869	482466	4	1	2	0	0	3
20869	54913	4	0	1	0	0	1
20869	83956	4	1	0	0	0	1
20869	482373	3	2	0	0	0	2
20869	482374	3	1	3	0	0	4
20869	482387	3	0	0	0	0	0
20869	482391	3	2	1	0	0	3
20869	482393	3	0	2	0	1	3
20869	482402	3	0	0	0	0	0
20869	482405	3	3	0	0	0	3
20869	482423	3	0	2	0	2	4
20869	482429	3	0	0	0	0	0
20869	482431	3	1	1	0	0	2
20869	482434	3	0	0	0	0	0
20869	74749	3	1	1	0	0	2
20869	75026	3	1	0	0	1	2
20869	81023	3	2	0	0	0	2
20869	93161	3	2	2	0	0	4
20869	482372	2	1	1	0	0	2
20869	482380	2	0	0	0	0	0
20869	482382	2	0	0	0	0	0
20869	482385	2	0	1	0	0	1
20869	482388	2	2	0	0	0	2
20869	482389	2	1	3	0	0	4
20869	482397	2	1	1	0	1	3
20869	482404	2	0	1	0	0	1
20869	482416	2	2	2	0	0	4
20869	482418	2	3	1	0	0	4
20869	482424	2	0	0	0	0	0
20869	482426	2	0	1	0	0	1
20869	482457	2	0	1	0	0	1
20869	482376	1	1	0	0	0	1
20869	482379	1	0	0	0	0	0
20869	482454	1	1	1	0	0	2
56506	415729	14	2	2	0	1	5
56506	415695	13	3	1	0	0	4
56506	415753	10	1	3	0	0	4
56506	622046	10	1	0	0	0	1
56506	78533	10	1	0	0	0	1
56506	415734	8	0	1	0	2	3
56506	622051	8	1	0	0	1	2
56506	622052	8	2	0	0	1	3
56506	415669	7	2	2	0	0	4
56506	415749	7	3	3	0	1	7
56506	415757	7	3	0	0	0	3
56506	415758	7	5	1	1	0	7
56506	415665	6	1	0	2	0	3
56506	415675	6	1	0	0	0	1
56506	415690	6	5	1	0	0	6
56506	415699	6	3	0	0	0	3
56506	415707	6	1	1	0	0	2
56506	415763	6	1	0	0	0	1
56506	200618	5	2	0	0	0	2
56506	209292	5	1	2	0	1	4
56506	415686	5	1	0	0	0	1
56506	415691	5	1	0	0	1	2
56506	415694	5	2	1	0	0	3
56506	415698	5	0	0	0	0	0
56506	415700	5	1	0	1	1	3
56506	415704	5	0	0	0	0	0
56506	415706	5	0	1	0	1	2
56506	415711	5	1	1	0	1	3
56506	415715	5	1	2	0	0	3
56506	415721	5	2	0	0	0	2
56506	415738	5	3	0	0	0	3
56506	415740	5	2	0	0	0	2
56506	415760	5	3	0	0	1	4
56506	415761	5	1	0	0	0	1
56506	415673	4	3	1	0	0	4
56506	415674	4	1	1	0	0	2
56506	415677	4	1	1	0	0	2
56506	415679	4	1	6	0	0	7
56506	415683	4	0	0	0	0	0
56506	415689	4	4	0	0	0	4
56506	415702	4	3	2	0	0	5
56506	415705	4	3	1	0	0	4
56506	415712	4	1	1	0	1	3
56506	415717	4	1	0	0	0	1
56506	415722	4	2	0	0	1	3
56506	415725	4	1	0	0	0	1
56506	415727	4	2	0	0	0	2
56506	415730	4	2	1	0	0	3
56506	415737	4	0	2	0	0	2
56506	415741	4	1	0	1	1	3
56506	415746	4	1	0	0	0	1
56506	415751	4	1	1	0	0	2
56506	622048	4	0	0	0	0	0
56506	622049	4	5	1	0	0	6
56506	622055	4	3	0	0	0	3
56506	196892	3	0	0	0	1	1
56506	204333	3	1	0	0	0	1
56506	281309	3	2	0	0	0	2
56506	415668	3	2	0	0	1	3
56506	415670	3	0	1	0	0	1
56506	415672	3	0	0	0	0	0
56506	415684	3	2	0	0	0	2
56506	415688	3	0	0	0	1	1
56506	415696	3	0	0	0	0	0
56506	415697	3	1	0	0	0	1
56506	415701	3	0	3	0	1	4
56506	415703	3	0	0	0	0	0
56506	415714	3	0	0	0	0	0
56506	415716	3	2	0	0	1	3
56506	415718	3	1	0	0	0	1
56506	415719	3	2	1	0	0	3
56506	415720	3	0	0	0	1	1
56506	415723	3	1	0	0	0	1
56506	415724	3	2	0	0	0	2
56506	415726	3	1	0	0	0	1
56506	415728	3	2	0	0	0	2
56506	415732	3	1	1	0	1	3
56506	415735	3	0	0	0	0	0
56506	415739	3	1	0	0	0	1
56506	415742	3	1	0	0	0	1
56506	415743	3	1	1	0	1	3
56506	415744	3	0	0	0	0	0
56506	415748	3	0	0	0	0	0
56506	415750	3	3	0	0	0	3
56506	415754	3	2	0	0	0	2
56506	415755	3	2	1	0	0	3
56506	415759	3	1	0	0	0	1
56506	622047	3	0	2	0	0	2
56506	622050	3	2	0	0	0	2
56506	622054	3	4	0	0	0	4
56506	201963	2	1	0	0	0	1
56506	415671	2	2	0	0	0	2
56506	415676	2	2	0	0	0	2
56506	415678	2	3	0	0	0	3
56506	415680	2	1	1	0	0	2
56506	415681	2	4	0	0	0	4
56506	415685	2	3	0	0	0	3
56506	415687	2	1	1	0	0	2
56506	415692	2	2	1	0	0	3
56506	415693	2	3	0	0	0	3
56506	415708	2	0	0	0	0	0
56506	415709	2	0	0	0	0	0
56506	415710	2	0	1	0	0	1
56506	415731	2	0	0	0	0	0
56506	415736	2	0	0	0	0	0
56506	415747	2	0	1	0	1	2
56506	415752	2	3	1	0	0	4
56506	415756	2	1	0	0	0	1
56506	415762	2	1	0	0	0	1
56506	415765	2	0	0	0	0	0
56506	415766	2	0	0	0	0	0
56506	183809	1	0	1	0	0	1
56506	186607	1	1	1	0	0	2
56506	186612	1	1	0	0	0	1
56506	189678	1	0	0	0	0	0
56506	191190	1	0	0	0	0	0
56506	281310	1	2	0	0	0	2
56506	281311	1	1	0	0	0	1
56506	415664	1	0	0	0	1	1
56506	415682	1	3	1	0	0	4
56506	415713	1	2	0	0	0	2
56506	415733	1	1	0	0	1	2
56506	415745	1	1	1	0	1	3
56506	415764	1	1	0	0	0	1
56506	622053	1	0	0	0	0	0
56506	622056	1	2	0	0	0	2
17252	89412	60	2	10	3	4	19
17252	579618	58	2	10	3	4	19
17252	56758	49	4	7	1	4	16
17252	287685	48	4	7	1	4	16
17252	59477	46	1	4	1	4	10
17252	287683	44	0	3	0	0	3
17252	287687	44	3	2	1	1	7
17252	93376	44	3	2	1	1	7
17252	545404	43	0	3	0	0	3
17252	579621	42	3	2	1	1	7
17252	545412	38	1	6	0	1	8
17252	49549	29	6	4	2	2	14
17252	107635	26	4	4	1	2	11
17252	220398	26	4	4	1	2	11
17252	545425	26	4	4	0	1	9
17252	545430	26	2	9	0	0	11
17252	107502	25	0	5	0	0	5
17252	101264	23	4	1	1	0	6
17252	287686	23	4	1	1	0	6
17252	545418	22	0	5	0	0	5
17252	545431	22	0	7	0	0	7
17252	579624	22	3	2	0	1	6
17252	104806	21	3	3	0	0	6
17252	579650	20	0	9	0	0	9
17252	545408	19	5	4	0	0	9
17252	579637	19	4	2	0	0	6
17252	579646	18	3	8	0	0	11
17252	107012	17	0	5	0	0	5
17252	220936	17	0	5	0	0	5
17252	545407	17	2	0	0	3	5
17252	545415	17	2	1	0	0	3
17252	545427	17	0	3	0	0	3
17252	579628	17	2	4	1	0	7
17252	579632	17	6	6	0	0	12
17252	579633	17	0	5	0	0	5
17252	579648	17	1	3	0	1	5
17252	545420	16	0	2	0	1	3
17252	579639	15	3	5	0	0	8
17252	79529	15	1	3	0	1	5
17252	189040	14	3	4	0	2	9
17252	287689	14	3	4	0	2	9
17252	545416	14	1	4	0	0	5
17252	545422	14	2	3	0	3	8
17252	579643	14	3	3	0	0	6
17252	61004	14	4	5	0	2	11
17252	222202	13	1	4	0	1	6
17252	545411	13	0	2	0	0	2
17252	545417	13	2	2	0	0	4
17252	545424	13	1	3	0	0	4
17252	545426	13	2	4	0	0	6
17252	91347	13	1	3	0	3	7
17252	545414	12	3	3	0	0	6
17252	545428	12	2	3	0	2	7
17252	545429	12	2	1	0	0	3
17252	579623	12	1	4	0	1	6
17252	579627	12	3	4	0	2	9
17252	579629	12	3	6	0	2	11
17252	579636	12	1	1	0	2	4
17252	64726	12	1	5	0	0	6
17252	222160	11	2	7	0	0	9
17252	545405	11	2	7	0	0	9
17252	545409	11	1	2	0	0	3
17252	579635	11	2	1	0	0	3
17252	545410	10	1	1	0	2	4
17252	579634	10	1	3	0	1	5
17252	579638	10	1	5	1	1	8
17252	73120	10	0	0	0	0	0
17252	198699	9	0	1	0	0	1
17252	287684	9	1	2	0	0	3
17252	287690	9	0	1	0	0	1
17252	545395	9	1	2	0	0	3
17252	545421	9	1	2	1	1	5
17252	579617	9	2	4	0	0	6
17252	579630	9	0	1	0	0	1
17252	579645	9	0	3	0	0	3
17252	74584	9	0	1	0	0	1
17252	182278	8	0	1	0	0	1
17252	190887	8	2	3	0	0	5
17252	287688	8	0	0	0	0	0
17252	545413	8	0	1	0	0	1
17252	545419	8	2	0	0	0	2
17252	579609	8	0	4	0	0	4
17252	579611	8	5	0	1	1	7
17252	579640	8	3	3	0	0	6
17252	579641	8	1	2	0	0	3
17252	579642	8	2	3	0	0	5
17252	99315	8	0	0	0	1	1
17252	49618	7	1	1	0	0	2
17252	545396	7	1	1	0	0	2
17252	579649	7	0	0	0	0	0
17252	579651	7	0	1	0	0	1
17252	54367	6	1	3	0	0	4
17252	545423	6	0	1	0	0	1
17252	579612	6	3	2	0	0	5
17252	61696	6	2	2	0	0	4
17252	83284	6	2	0	0	1	3
17252	90154	6	1	0	0	0	1
17252	102014	5	2	2	0	0	4
17252	579626	5	2	1	0	0	3
17252	579631	5	0	2	0	0	2
17252	579647	5	1	4	0	1	6
17252	104054	4	2	2	0	2	6
17252	545397	4	2	0	0	0	2
17252	545402	4	3	2	1	0	6
17252	579613	4	0	1	0	2	3
17252	579620	4	0	3	0	0	3
17252	579644	4	1	3	0	1	5
17252	50150	3	1	5	0	0	6
17252	545393	3	0	1	0	0	1
17252	545394	3	1	0	0	0	1
17252	545398	3	1	2	0	0	3
17252	545400	3	0	0	0	0	0
17252	545406	3	0	1	0	0	1
17252	579607	3	0	0	0	0	0
17252	579610	3	2	0	0	0	2
17252	579614	3	4	1	0	0	5
17252	579616	3	0	3	0	0	3
17252	579619	3	0	1	0	0	1
17252	579625	3	1	0	0	0	1
17252	74748	3	0	2	0	0	2
17252	545401	2	1	2	0	0	3
17252	545403	2	1	0	0	0	1
17252	579608	2	0	0	0	0	0
17252	579615	2	0	2	0	0	2
17252	545399	1	1	1	0	0	2
17252	579622	1	1	2	0	0	3
33847	621448	16	0	2	2	0	4
33847	621435	14	6	3	0	2	11
33847	278894	13	2	2	0	3	7
33847	278902	13	0	3	0	1	4
33847	621481	13	1	3	1	0	5
33847	193809	12	3	0	0	0	3
33847	278893	12	3	0	0	1	4
33847	621454	12	2	3	0	2	7
33847	199824	11	1	2	0	1	4
33847	278898	11	3	0	0	0	3
33847	216238	10	0	0	1	0	1
33847	621467	10	3	1	0	2	6
33847	621488	10	1	1	0	1	3
33847	210431	9	4	0	0	2	6
33847	278896	9	3	0	2	1	6
33847	621432	9	2	1	0	0	3
33847	621438	9	1	1	0	0	2
33847	621457	9	0	0	0	2	2
33847	621485	9	0	2	0	4	6
33847	621446	8	0	0	0	2	2
33847	621458	8	1	1	2	0	4
33847	621489	8	1	1	0	2	4
33847	185204	6	3	1	1	1	6
33847	185819	6	0	1	0	3	4
33847	186957	6	0	0	0	2	2
33847	196034	6	1	1	0	1	3
33847	198410	6	1	0	0	0	1
33847	206380	6	1	1	0	1	3
33847	206659	6	0	0	1	2	3
33847	216002	6	1	1	0	1	3
33847	278900	6	3	0	0	1	4
33847	278901	6	1	1	0	1	3
33847	621450	6	1	0	0	1	2
33847	621480	6	0	1	0	1	2
33847	621486	6	1	1	1	1	4
33847	186817	5	1	2	0	0	3
33847	191979	5	1	0	1	1	3
33847	192225	5	0	2	0	0	2
33847	196074	5	0	0	0	1	1
33847	201258	5	1	1	0	0	2
33847	204973	5	1	0	1	3	5
33847	207073	5	0	0	0	2	2
33847	216890	5	0	0	0	1	1
33847	278892	5	1	0	1	1	3
33847	278899	5	0	1	2	0	3
33847	278904	5	0	2	0	0	2
33847	621433	5	0	0	0	1	1
33847	621442	5	1	0	1	0	2
33847	621445	5	3	3	3	4	13
33847	621449	5	2	0	0	1	3
33847	621456	5	1	0	0	0	1
33847	621462	5	1	0	0	1	2
33847	621464	5	1	2	3	0	6
33847	621472	5	0	0	2	2	4
33847	621473	5	0	0	1	0	1
33847	621476	5	1	3	0	0	4
33847	621484	5	0	1	0	0	1
33847	184634	4	4	1	0	0	5
33847	191554	4	0	0	0	1	1
33847	199500	4	0	0	0	0	0
33847	200424	4	0	2	0	0	2
33847	206177	4	0	0	0	0	0
33847	208335	4	2	0	0	0	2
33847	212798	4	0	1	0	0	1
33847	217148	4	1	1	0	2	4
33847	217476	4	2	1	0	1	4
33847	621431	4	1	1	1	0	3
33847	621434	4	3	1	1	1	6
33847	621436	4	0	1	3	2	6
33847	621437	4	1	1	0	0	2
33847	621440	4	0	0	0	2	2
33847	621441	4	0	2	0	1	3
33847	621444	4	1	0	0	2	3
33847	621447	4	0	0	0	0	0
33847	621455	4	1	0	0	1	2
33847	621465	4	0	0	0	0	0
33847	621475	4	0	2	0	1	3
33847	621477	4	0	0	0	3	3
33847	621482	4	3	2	0	0	5
33847	621494	4	0	1	1	0	2
33847	187080	3	1	0	0	1	2
33847	187088	3	0	0	0	0	0
33847	190138	3	0	1	0	0	1
33847	192891	3	0	0	0	0	0
33847	197215	3	0	0	0	1	1
33847	199328	3	0	2	0	1	3
33847	202108	3	0	0	0	1	1
33847	209528	3	0	0	0	0	0
33847	210313	3	1	0	0	1	2
33847	219711	3	0	1	0	1	2
33847	278897	3	0	1	1	0	2
33847	278903	3	0	0	1	1	2
33847	621439	3	0	0	0	0	0
33847	621452	3	1	0	0	0	1
33847	621453	3	0	0	0	0	0
33847	621460	3	1	0	1	0	2
33847	621461	3	1	2	0	0	3
33847	621463	3	1	0	0	1	2
33847	621469	3	0	1	0	0	1
33847	621471	3	2	1	0	0	3
33847	621478	3	1	1	1	5	8
33847	621479	3	1	1	0	0	2
33847	621487	3	1	3	0	0	4
33847	621491	3	2	0	0	2	4
33847	621495	3	3	1	0	2	6
33847	199175	2	1	0	0	0	1
33847	211107	2	0	0	1	0	1
33847	212456	2	0	1	0	0	1
33847	221909	2	3	1	0	2	6
33847	621443	2	0	1	0	0	1
33847	621451	2	0	0	0	0	0
33847	621466	2	0	0	0	0	0
33847	621468	2	0	2	2	0	4
33847	621470	2	0	0	0	0	0
33847	621474	2	0	0	0	1	1
33847	621483	2	0	1	0	0	1
33847	621490	2	0	0	0	1	1
33847	621492	2	0	1	0	0	1
33847	186282	1	1	0	0	0	1
33847	191014	1	2	0	0	3	5
33847	192469	1	0	0	0	2	2
33847	216583	1	0	0	0	0	0
33847	220886	1	0	1	0	0	1
33847	278891	1	0	0	0	1	1
33847	278895	1	0	0	0	0	0
33847	621459	1	0	2	0	1	3
33847	621493	1	0	0	0	2	2
56755	75482	61	2	20	2	3	27
56755	414316	30	1	5	1	0	7
56755	58424	27	1	2	2	0	5
56755	181965	25	4	7	2	0	13
56755	414282	25	4	7	2	0	13
56755	91828	22	0	2	0	0	2
56755	414325	21	0	2	0	0	2
56755	414283	18	2	4	0	1	7
56755	414320	16	1	15	0	1	17
56755	73710	16	1	2	0	1	4
56755	80014	16	1	15	0	1	17
56755	187731	15	4	5	0	0	9
56755	298079	15	3	2	0	0	5
56755	49978	15	3	2	0	0	5
56755	85841	14	1	2	0	1	4
56755	95723	14	0	2	0	1	3
56755	414319	13	0	2	0	1	3
56755	78806	13	0	3	0	0	3
56755	99107	12	0	1	0	4	5
56755	414292	11	0	2	0	1	3
56755	414298	11	0	1	0	4	5
56755	50416	11	4	8	1	2	15
56755	414258	10	0	3	1	1	5
56755	414277	10	2	2	1	1	6
56755	97168	10	0	3	1	1	5
56755	221490	9	0	1	0	0	1
56755	414328	9	0	1	0	1	2
56755	106205	8	0	0	0	0	0
56755	414290	8	0	1	0	0	1
56755	414293	8	0	2	1	0	3
56755	414321	8	0	3	0	0	3
56755	65646	8	2	0	0	4	6
56755	84876	8	1	4	0	0	5
56755	414275	7	2	1	0	0	3
56755	414317	7	2	3	0	0	5
56755	414327	7	3	3	0	0	6
56755	72212	7	0	2	0	0	2
56755	196568	6	1	2	0	0	3
56755	414261	6	2	0	0	0	2
56755	414278	6	0	0	0	1	1
56755	414280	6	1	1	0	1	3
56755	414284	6	0	1	0	2	3
56755	414296	6	1	1	0	0	2
56755	414297	6	1	3	0	1	5
56755	414309	6	2	0	0	0	2
56755	414310	6	1	2	0	1	4
56755	414323	6	1	0	0	0	1
56755	82024	6	1	2	1	1	5
56755	86245	6	1	1	0	0	2
56755	106931	5	1	4	0	0	5
56755	195331	5	1	1	0	0	2
56755	211257	5	1	1	0	0	2
56755	298080	5	0	2	0	0	2
56755	414274	5	0	0	0	0	0
56755	414289	5	0	0	0	1	1
56755	414291	5	2	4	0	1	7
56755	414303	5	0	3	0	1	4
56755	414304	5	2	2	0	0	4
56755	414326	5	1	1	0	0	2
56755	49963	5	0	3	0	0	3
56755	91046	5	0	2	0	0	2
56755	104115	4	0	0	0	0	0
56755	184316	4	1	2	0	0	3
56755	193347	4	1	2	0	0	3
56755	414253	4	1	0	0	0	1
56755	414260	4	1	1	0	0	2
56755	414267	4	1	2	0	1	4
56755	414268	4	2	1	0	1	4
56755	414269	4	0	2	0	0	2
56755	414273	4	0	1	0	0	1
56755	414281	4	2	1	0	1	4
56755	414305	4	1	2	0	2	5
56755	414311	4	2	1	0	0	3
56755	414314	4	0	1	0	0	1
56755	414318	4	2	1	0	3	6
56755	414322	4	1	1	0	0	2
56755	53448	4	0	1	0	0	1
56755	298077	3	1	2	0	1	4
56755	414255	3	0	1	0	0	1
56755	414257	3	0	0	0	0	0
56755	414262	3	0	0	0	0	0
56755	414263	3	0	1	0	0	1
56755	414264	3	0	1	0	0	1
56755	414271	3	2	1	0	1	4
56755	414276	3	0	2	0	1	3
56755	414279	3	0	0	0	0	0
56755	414285	3	1	1	0	1	3
56755	414286	3	2	4	0	0	6
56755	414287	3	2	1	0	1	4
56755	414294	3	0	1	0	0	1
56755	414301	3	0	2	0	0	2
56755	414302	3	0	0	0	0	0
56755	414307	3	1	3	0	1	5
56755	414308	3	0	2	0	0	2
56755	414312	3	1	0	0	0	1
56755	414313	3	0	3	0	0	3
56755	414315	3	2	1	0	0	3
56755	72698	3	1	2	0	0	3
56755	74029	3	1	2	0	1	4
56755	79604	3	0	0	0	0	0
56755	92391	3	0	1	0	0	1
56755	186227	2	1	1	0	0	2
56755	198463	2	0	1	0	0	1
56755	207187	2	0	0	0	0	0
56755	298078	2	0	1	0	0	1
56755	414248	2	0	1	0	0	1
56755	414249	2	1	0	0	0	1
56755	414250	2	1	2	0	0	3
56755	414251	2	2	1	0	0	3
56755	414252	2	1	0	0	0	1
56755	414256	2	1	0	0	0	1
56755	414259	2	0	2	0	0	2
56755	414265	2	1	2	0	1	4
56755	414266	2	0	0	0	0	0
56755	414270	2	1	3	0	0	4
56755	414272	2	0	1	0	0	1
56755	414288	2	0	1	0	0	1
56755	414295	2	2	1	0	0	3
56755	414299	2	0	1	0	0	1
56755	414300	2	3	1	0	0	4
56755	414306	2	0	5	0	0	5
56755	414324	2	0	1	0	0	1
56755	67552	2	0	1	0	0	1
56755	196095	1	0	0	0	0	0
56755	414254	1	1	0	0	0	1
17268	210633	33	3	6	1	0	10
17268	500622	31	3	6	1	0	10
17268	184086	30	2	3	2	1	8
17268	500625	23	2	2	1	1	6
17268	500629	23	2	2	1	1	6
17268	200847	22	0	2	0	0	2
17268	500603	18	0	4	2	0	6
17268	276880	17	0	4	2	0	6
17268	276885	16	0	2	0	0	2
17268	500650	13	2	1	0	0	3
17268	500619	11	1	0	0	1	2
17268	200586	10	3	1	0	1	5
17268	276882	10	3	1	0	1	5
17268	276896	10	1	3	0	0	4
17268	500631	10	1	6	1	0	8
17268	500634	10	1	3	0	0	4
17268	500648	10	3	2	2	1	8
17268	211394	9	1	1	0	0	2
17268	216996	8	3	2	0	0	5
17268	276883	8	1	2	0	0	3
17268	276884	8	0	0	2	0	2
17268	276898	8	0	2	0	0	2
17268	500618	8	3	3	0	0	6
17268	500635	8	1	1	0	1	3
17268	194088	7	0	0	0	0	0
17268	201705	7	0	3	1	0	4
17268	276893	7	3	2	0	0	5
17268	500623	7	1	2	0	0	3
17268	500624	7	0	1	0	0	1
17268	500632	7	2	0	0	0	2
17268	500633	7	3	2	0	0	5
17268	500649	7	1	1	0	0	2
17268	276881	6	0	2	1	1	4
17268	276899	6	2	0	0	0	2
17268	276902	6	0	2	0	0	2
17268	276907	6	1	2	1	0	4
17268	276908	6	2	4	0	0	6
17268	277307	6	0	1	1	0	2
17268	500600	6	0	1	0	3	4
17268	500621	6	1	3	0	1	5
17268	500653	6	1	3	0	0	4
17268	500656	6	1	2	0	0	3
17268	500657	6	0	0	0	0	0
17268	500659	6	0	1	0	0	1
17268	203412	5	1	2	0	0	3
17268	209922	5	0	5	0	0	5
17268	212918	5	0	0	0	0	0
17268	276888	5	0	0	0	0	0
17268	276890	5	0	5	0	0	5
17268	276894	5	1	2	0	1	4
17268	276901	5	1	0	0	0	1
17268	276904	5	2	1	0	1	4
17268	500599	5	2	0	0	0	2
17268	500606	5	0	1	0	1	2
17268	500609	5	0	2	1	1	4
17268	500630	5	0	1	0	0	1
17268	500638	5	2	2	0	0	4
17268	500646	5	0	2	0	0	2
17268	500647	5	1	2	0	0	3
17268	500651	5	0	4	0	0	4
17268	500662	5	0	5	0	0	5
17268	194769	4	0	3	0	0	3
17268	276886	4	3	1	0	0	4
17268	276887	4	0	1	0	0	1
17268	276892	4	1	1	0	0	2
17268	276897	4	0	2	0	0	2
17268	276900	4	2	1	0	0	3
17268	276903	4	0	0	0	0	0
17268	276905	4	1	0	0	4	5
17268	276906	4	0	0	0	0	0
17268	500607	4	0	1	0	0	1
17268	500617	4	2	1	0	1	4
17268	500620	4	0	2	0	0	2
17268	500627	4	1	2	0	0	3
17268	500639	4	1	2	0	0	3
17268	500640	4	1	2	0	0	3
17268	500642	4	3	1	0	0	4
17268	500643	4	1	0	0	0	1
17268	500654	4	1	1	0	0	2
17268	203085	3	0	1	0	0	1
17268	205716	3	1	2	0	0	3
17268	214229	3	0	0	0	0	0
17268	221826	3	1	2	0	0	3
17268	276889	3	0	0	0	0	0
17268	500601	3	1	2	0	0	3
17268	500613	3	1	2	0	0	3
17268	500616	3	2	3	0	0	5
17268	500628	3	1	1	1	0	3
17268	500637	3	0	1	0	0	1
17268	500644	3	1	2	0	0	3
17268	500645	3	1	1	0	0	2
17268	500652	3	0	0	0	0	0
17268	500655	3	0	1	0	0	1
17268	500660	3	1	1	0	0	2
17268	183706	2	0	2	0	0	2
17268	184911	2	0	0	0	0	0
17268	200093	2	0	0	2	0	2
17268	210046	2	1	1	0	0	2
17268	276895	2	1	1	0	2	4
17268	276909	2	0	0	0	0	0
17268	276911	2	0	0	0	0	0
17268	276912	2	0	1	0	0	1
17268	500602	2	1	1	0	0	2
17268	500604	2	1	1	0	0	2
17268	500605	2	0	1	1	1	3
17268	500608	2	0	1	0	0	1
17268	500611	2	1	2	0	0	3
17268	500612	2	1	1	0	1	3
17268	500614	2	2	0	0	0	2
17268	500615	2	1	3	0	0	4
17268	500626	2	1	0	0	1	2
17268	500636	2	1	3	0	0	4
17268	500641	2	1	1	0	0	2
17268	500658	2	1	2	0	0	3
17268	500661	2	1	0	0	0	1
17268	500663	2	0	1	0	0	1
17268	500664	2	1	2	0	0	3
17268	198027	1	0	0	0	0	0
17268	219922	1	0	0	0	0	0
17268	276891	1	0	1	0	0	1
17268	276910	1	0	0	0	0	0
17268	277308	1	0	0	0	0	0
17268	500596	1	0	0	0	0	0
17268	500597	1	0	1	0	0	1
17268	500598	1	0	0	0	0	0
17268	500610	1	0	3	0	0	3
113588	370290	44	3	4	0	0	7
113588	370307	36	1	7	0	0	8
113588	370249	28	0	0	3	0	3
113588	370278	26	1	2	0	0	3
113588	370256	23	2	6	0	2	10
113588	370261	22	3	0	0	0	3
113588	370283	22	1	2	0	1	4
113588	370258	20	0	3	0	0	3
113588	370260	20	0	2	0	0	2
113588	370238	19	3	7	1	0	11
113588	370257	18	1	2	0	0	3
113588	370251	17	1	4	3	1	9
113588	370264	17	0	4	1	0	5
113588	370247	16	1	2	0	0	3
113588	370245	15	2	2	0	0	4
113588	370250	15	0	8	3	0	11
113588	370275	15	1	7	0	0	8
113588	370252	14	3	1	0	0	4
113588	370266	14	3	3	0	0	6
113588	370292	14	1	1	1	2	5
113588	370300	14	1	4	0	0	5
113588	370313	14	1	1	0	0	2
113588	370248	13	1	2	0	1	4
113588	370255	13	0	0	0	0	0
113588	370262	13	3	0	2	3	8
113588	370276	13	2	2	0	0	4
113588	370298	11	3	0	1	0	4
113588	370335	11	0	0	0	0	0
113588	370291	10	1	4	0	2	7
113588	370304	10	0	3	0	0	3
113588	370240	9	1	1	0	0	2
113588	370244	9	0	1	0	0	1
113588	370259	9	3	2	2	0	7
113588	370272	9	1	1	0	0	2
113588	370293	9	4	0	2	1	7
113588	370303	9	1	1	0	0	2
113588	370310	9	1	2	0	0	3
113588	370232	8	0	0	0	0	0
113588	370265	8	1	2	0	0	3
113588	370268	8	1	2	0	0	3
113588	370279	8	1	1	0	0	2
113588	370287	8	1	0	0	1	2
113588	370294	8	1	1	0	0	2
113588	370328	8	0	0	0	0	0
113588	370338	8	0	0	0	0	0
113588	370239	7	1	0	0	0	1
113588	370253	7	1	2	0	0	3
113588	370269	7	0	1	0	0	1
113588	370308	7	2	3	1	0	6
113588	370330	7	1	2	1	0	4
113588	370343	7	0	0	0	0	0
113588	370234	6	1	0	0	1	2
113588	370243	6	0	1	0	0	1
113588	370246	6	1	1	1	1	4
113588	370263	6	0	1	1	0	2
113588	370271	6	2	0	0	0	2
113588	370289	6	1	0	0	0	1
113588	370296	6	0	0	0	0	0
113588	370320	6	1	1	0	0	2
113588	370321	6	1	1	0	0	2
113588	370323	6	1	0	0	0	1
113588	370325	6	0	0	0	0	0
113588	370327	6	1	2	0	0	3
113588	370341	6	0	0	0	0	0
113588	370347	6	0	2	0	0	2
113588	370227	5	0	2	0	1	3
113588	370270	5	0	0	0	0	0
113588	370277	5	0	1	0	1	2
113588	370281	5	0	2	0	0	2
113588	370282	5	1	0	0	0	1
113588	370284	5	0	1	0	0	1
113588	370285	5	0	1	0	0	1
113588	370288	5	0	0	1	0	1
113588	370295	5	3	0	0	0	3
113588	370297	5	2	0	3	1	6
113588	370299	5	3	0	1	0	4
113588	370301	5	0	0	0	0	0
113588	370302	5	0	2	0	0	2
113588	370305	5	2	5	0	0	7
113588	370306	5	0	3	0	0	3
113588	370311	5	2	1	0	1	4
113588	370316	5	1	2	0	0	3
113588	370332	5	3	0	1	0	4
113588	370345	5	1	0	0	0	1
113588	370228	4	1	0	1	0	2
113588	370233	4	1	0	0	0	1
113588	370236	4	2	0	0	0	2
113588	370242	4	0	1	0	0	1
113588	370267	4	0	0	0	0	0
113588	370274	4	0	0	0	0	0
113588	370280	4	1	1	0	0	2
113588	370286	4	1	1	0	0	2
113588	370309	4	0	0	0	0	0
113588	370315	4	0	1	0	0	1
113588	370317	4	1	0	0	1	2
113588	370318	4	0	0	0	0	0
113588	370319	4	0	0	0	0	0
113588	370329	4	0	0	0	0	0
113588	370333	4	0	0	0	0	0
113588	370342	4	0	0	0	1	1
113588	370346	4	3	0	1	0	4
113588	370348	4	1	1	0	0	2
113588	370226	3	0	0	0	0	0
113588	370231	3	0	1	0	0	1
113588	370312	3	1	1	0	0	2
113588	370322	3	0	0	0	0	0
113588	370336	3	0	0	0	0	0
113588	370339	3	0	0	0	1	1
113588	370340	3	1	0	0	0	1
113588	370344	3	1	0	0	0	1
113588	370350	3	0	1	0	0	1
113588	370351	3	1	0	0	0	1
113588	370352	3	0	0	0	0	0
113588	370229	2	0	0	0	1	1
113588	370235	2	0	0	0	0	0
113588	370237	2	0	0	1	0	1
113588	370273	2	0	0	0	0	0
113588	370314	2	1	0	0	0	1
113588	370334	2	1	0	0	0	1
113588	370337	2	0	0	0	0	0
113588	370230	1	0	0	0	0	0
113588	370241	1	1	1	0	0	2
113588	370254	1	3	1	0	0	4
113588	370324	1	1	1	0	0	2
113588	370326	1	0	0	0	0	0
113588	370349	1	1	0	0	0	1
14880	198941	28	2	6	3	3	14
14880	287034	28	2	6	3	3	14
14880	74347	28	2	6	3	3	14
14880	50391	26	0	1	2	1	4
14880	67851	22	1	2	2	2	7
14880	78731	20	0	3	1	0	4
14880	407508	18	1	1	1	0	3
14880	91730	18	1	1	1	0	3
14880	221856	17	2	4	0	0	6
14880	79811	17	2	4	2	2	10
14880	407502	14	0	1	0	2	3
14880	287035	11	4	1	0	1	6
14880	287037	11	4	1	0	0	5
14880	407501	11	1	0	0	0	1
14880	53842	11	4	1	0	1	6
14880	85950	11	2	2	1	1	6
14880	407506	10	3	1	0	0	4
14880	53315	10	2	4	1	2	9
14880	57901	10	0	0	1	0	1
14880	85986	10	0	3	1	1	5
14880	106872	9	1	2	0	3	6
14880	221339	9	1	2	0	2	5
14880	287026	9	1	4	0	3	8
14880	549874	9	0	2	0	2	4
14880	62349	9	0	2	1	2	5
14880	80685	9	1	4	0	3	8
14880	94276	9	1	0	1	0	2
14880	195376	8	1	6	0	2	9
14880	287024	8	1	6	0	2	9
14880	407491	8	0	0	0	1	1
14880	68332	8	1	6	0	2	9
14880	106621	7	0	3	1	1	5
14880	187827	7	0	1	0	0	1
14880	205442	7	2	2	0	1	5
14880	287029	7	3	1	0	0	4
14880	407500	7	2	2	0	0	4
14880	407503	7	1	2	1	3	7
14880	50803	7	3	1	0	0	4
14880	57008	7	0	3	0	0	3
14880	82010	7	1	3	0	0	4
14880	104100	6	2	1	0	2	5
14880	191341	6	1	0	0	0	1
14880	194746	6	0	2	0	1	3
14880	200716	6	1	1	0	0	2
14880	215815	6	1	2	0	1	4
14880	287025	6	2	5	0	1	8
14880	287028	6	0	3	0	1	4
14880	287030	6	1	1	0	0	2
14880	287036	6	0	1	0	1	2
14880	407476	6	2	1	0	2	5
14880	407484	6	2	1	0	1	4
14880	407499	6	1	2	1	0	4
14880	407505	6	0	2	0	0	2
14880	407507	6	0	1	1	0	2
14880	50491	6	3	3	1	0	7
14880	549872	6	1	1	1	1	4
14880	55136	6	0	1	0	0	1
14880	66601	6	3	1	0	3	7
14880	76486	6	1	1	0	0	2
14880	79544	6	1	2	0	1	4
14880	105803	5	0	0	0	1	1
14880	191047	5	0	2	0	0	2
14880	217121	5	1	2	0	0	3
14880	219657	5	0	0	0	1	1
14880	287031	5	2	2	0	3	7
14880	407474	5	0	4	0	0	4
14880	407480	5	1	1	0	0	2
14880	407485	5	0	1	0	0	1
14880	407489	5	0	0	0	3	3
14880	407494	5	0	0	0	0	0
14880	88799	5	1	2	0	1	4
14880	100994	4	1	3	0	0	4
14880	184284	4	0	2	0	1	3
14880	194068	4	0	0	0	0	0
14880	211290	4	0	3	0	2	5
14880	220331	4	0	0	0	0	0
14880	221578	4	0	1	0	0	1
14880	287032	4	1	3	0	0	4
14880	407482	4	2	1	0	0	3
14880	407493	4	0	1	0	0	1
14880	407504	4	0	1	0	1	2
14880	49369	4	1	1	0	1	3
14880	549869	4	1	1	0	0	2
14880	549875	4	0	1	0	0	1
14880	549876	4	0	3	0	0	3
14880	549877	4	0	1	0	1	2
14880	108014	3	0	0	0	1	1
14880	182125	3	0	1	0	1	2
14880	183682	3	1	1	0	0	2
14880	189359	3	2	2	0	0	4
14880	190531	3	2	1	0	0	3
14880	193499	3	0	0	0	0	0
14880	219932	3	1	2	0	0	3
14880	220690	3	1	0	0	0	1
14880	287023	3	0	0	0	1	1
14880	287027	3	1	0	0	0	1
14880	407475	3	1	1	0	0	2
14880	407478	3	4	0	0	0	4
14880	407479	3	1	1	0	1	3
14880	407481	3	1	1	0	0	2
14880	407488	3	1	2	0	1	4
14880	407495	3	1	2	0	0	3
14880	549871	3	1	1	0	0	2
14880	88586	3	0	1	0	0	1
14880	92998	3	1	0	0	0	1
14880	184385	2	0	2	0	0	2
14880	186572	2	0	1	0	0	1
14880	193759	2	1	1	0	0	2
14880	201935	2	0	1	0	1	2
14880	203319	2	0	0	0	1	1
14880	204385	2	0	0	0	0	0
14880	207165	2	0	0	0	0	0
14880	407477	2	0	0	0	1	1
14880	407486	2	1	0	0	0	1
14880	407490	2	1	0	0	1	2
14880	407492	2	1	0	1	0	2
14880	407497	2	0	0	0	0	0
14880	549870	2	0	1	0	0	1
14880	549873	2	0	1	0	0	1
14880	287022	1	1	1	0	0	2
14880	287033	1	0	0	0	0	0
14880	407483	1	1	1	0	2	4
14880	407487	1	1	2	0	0	3
14880	407496	1	1	0	0	0	1
14880	407498	1	1	1	0	0	2
69839	107935	51	6	9	1	4	20
69839	53252	51	3	7	1	9	20
69839	102396	40	5	7	1	7	20
69839	62741	38	5	3	0	6	14
69839	198199	23	0	3	3	6	12
69839	202377	22	0	2	0	1	3
69839	282873	22	0	3	3	6	12
69839	51403	22	0	3	3	6	12
69839	587934	22	0	3	3	6	12
69839	185411	21	1	5	0	6	12
69839	282872	21	0	2	0	1	3
69839	587925	21	0	2	0	1	3
69839	82926	21	0	2	0	1	3
69839	54823	20	1	4	0	6	11
69839	221689	19	3	3	2	4	12
69839	587946	17	1	5	1	5	12
69839	587944	16	1	4	0	0	5
69839	282866	11	2	0	0	2	4
69839	282867	11	0	3	1	1	5
69839	55219	11	3	3	0	0	6
69839	587900	11	2	0	0	2	4
69839	587905	11	0	3	1	1	5
69839	587953	11	2	1	0	0	3
69839	59977	11	1	2	0	2	5
69839	83385	11	2	0	0	2	4
69839	86505	11	0	3	1	1	5
69839	103339	10	2	2	0	0	4
69839	188854	10	1	3	0	2	6
69839	587898	10	0	1	0	0	1
69839	587920	10	1	2	1	0	4
69839	68795	10	0	1	0	0	1
69839	282870	9	0	0	0	0	0
69839	282879	9	1	3	0	2	6
69839	587930	9	5	3	0	2	10
69839	71330	9	0	0	0	0	0
69839	107111	8	1	2	0	0	3
69839	184807	8	1	2	0	1	4
69839	87798	8	2	2	0	2	6
69839	98174	8	2	1	0	0	3
69839	186018	7	1	1	0	0	2
69839	200489	7	1	2	0	0	3
69839	219580	7	0	0	0	0	0
69839	282877	7	1	2	0	1	4
69839	54355	7	1	2	0	1	4
69839	587954	7	1	2	0	1	4
69839	587955	7	1	2	0	0	3
69839	72345	7	1	2	0	0	3
69839	103295	6	0	0	0	6	6
69839	106339	6	0	0	0	0	0
69839	188004	6	0	4	0	0	4
69839	189445	6	1	0	0	3	4
69839	282878	6	0	0	0	6	6
69839	587915	6	0	2	0	0	2
69839	587942	6	2	2	0	0	4
69839	587950	6	0	2	0	0	2
69839	84278	6	0	1	0	0	1
69839	90303	6	1	3	0	3	7
69839	55009	5	2	1	0	0	3
69839	587919	5	0	2	0	0	2
69839	587928	5	1	2	1	0	4
69839	587933	5	3	0	0	5	8
69839	587943	5	3	0	0	0	3
69839	86436	5	0	1	0	2	3
69839	98865	5	0	2	0	0	2
69839	193429	4	0	2	0	4	6
69839	204171	4	2	0	1	0	3
69839	587896	4	0	0	0	1	1
69839	587897	4	1	1	0	0	2
69839	587904	4	1	0	0	0	1
69839	587906	4	1	2	0	2	5
69839	587907	4	0	3	0	0	3
69839	587908	4	0	1	0	1	2
69839	587909	4	1	2	0	0	3
69839	587914	4	0	0	0	0	0
69839	587916	4	2	5	0	1	8
69839	587918	4	1	2	0	1	4
69839	587921	4	1	2	0	0	3
69839	587923	4	4	0	1	2	7
69839	587927	4	1	2	0	1	4
69839	587935	4	1	2	0	2	5
69839	587940	4	0	0	0	2	2
69839	587947	4	2	2	0	0	4
69839	587949	4	1	0	0	1	2
69839	64994	4	0	1	0	0	1
69839	73270	4	0	0	0	0	0
69839	105259	3	2	1	0	2	5
69839	282868	3	0	2	0	0	2
69839	56019	3	1	0	0	0	1
69839	587899	3	0	1	0	1	2
69839	587917	3	0	0	0	2	2
69839	587926	3	0	2	0	0	2
69839	587929	3	3	5	0	0	8
69839	587939	3	0	2	0	1	3
69839	587941	3	0	2	0	0	2
69839	587945	3	1	0	0	0	1
69839	587948	3	1	3	0	0	4
69839	182138	2	0	1	0	0	1
69839	184352	2	2	2	0	0	4
69839	282869	2	0	1	0	1	2
69839	282871	2	1	0	0	1	2
69839	282874	2	1	1	0	2	4
69839	282875	2	0	1	0	1	2
69839	282876	2	1	0	0	0	1
69839	53802	2	1	0	0	0	1
69839	587901	2	0	1	0	0	1
69839	587910	2	0	0	0	0	0
69839	587913	2	0	0	0	0	0
69839	587922	2	0	3	0	0	3
69839	587924	2	0	0	0	1	1
69839	587936	2	0	0	0	0	0
69839	587937	2	2	2	0	2	6
69839	587938	2	0	2	1	2	5
69839	587951	2	1	1	0	0	2
69839	61369	2	0	1	0	1	2
69839	70688	2	1	0	0	1	2
69839	71505	2	0	1	0	1	2
69839	587902	1	0	0	0	1	1
69839	587903	1	2	0	0	1	3
69839	587911	1	0	2	0	0	2
69839	587912	1	1	2	0	0	3
69839	587931	1	0	0	0	0	0
69839	587932	1	0	4	0	0	4
69839	587952	1	0	3	0	0	3
69839	89975	1	1	1	0	0	2
140818	580326	12	1	0	2	1	4
140818	580287	10	0	0	0	0	0
140818	580300	9	1	0	0	0	1
140818	580316	9	2	0	0	1	3
140818	580331	9	1	0	1	1	3
140818	580292	8	1	0	0	0	1
140818	580341	8	0	0	0	1	1
140818	580310	7	3	0	0	1	4
140818	580318	7	1	2	0	0	3
140818	580235	6	1	0	0	0	1
140818	580297	6	1	0	2	0	3
140818	580301	6	0	0	0	0	0
140818	580308	6	0	1	0	0	1
140818	580329	6	1	0	0	0	1
140818	580333	6	0	0	0	0	0
140818	580337	6	3	0	0	2	5
140818	580234	5	0	0	0	0	0
140818	580286	5	0	0	0	3	3
140818	580288	5	2	0	1	1	4
140818	580299	5	0	0	0	0	0
140818	580302	5	2	0	0	0	2
140818	580322	5	3	0	0	0	3
140818	580323	5	0	0	1	0	1
140818	580218	4	0	0	0	0	0
140818	580245	4	3	0	0	2	5
140818	580255	4	3	0	0	1	4
140818	580258	4	0	0	1	1	2
140818	580281	4	0	0	0	1	1
140818	580285	4	1	0	0	0	1
140818	580289	4	3	0	0	0	3
140818	580293	4	1	0	1	2	4
140818	580295	4	1	0	0	1	2
140818	580298	4	2	0	0	0	2
140818	580305	4	0	0	0	0	0
140818	580307	4	1	0	0	4	5
140818	580315	4	1	0	0	0	1
140818	580320	4	0	0	0	0	0
140818	580330	4	0	1	0	1	2
140818	580332	4	1	0	0	0	1
140818	580336	4	3	0	0	0	3
140818	580216	3	3	0	0	1	4
140818	580219	3	2	0	0	1	3
140818	580224	3	1	0	1	2	4
140818	580237	3	0	0	0	1	1
140818	580238	3	1	0	0	1	2
140818	580244	3	2	1	0	0	3
140818	580248	3	1	1	0	0	2
140818	580250	3	2	0	0	1	3
140818	580251	3	1	0	0	1	2
140818	580261	3	1	0	0	0	1
140818	580262	3	1	0	0	0	1
140818	580263	3	0	0	0	0	0
140818	580267	3	0	2	0	0	2
140818	580268	3	2	0	0	2	4
140818	580269	3	4	0	0	1	5
140818	580270	3	1	0	1	0	2
140818	580275	3	1	0	0	4	5
140818	580276	3	0	0	0	0	0
140818	580278	3	1	0	0	1	2
140818	580279	3	1	0	0	0	1
140818	580283	3	1	0	0	2	3
140818	580284	3	2	0	1	0	3
140818	580291	3	4	0	0	0	4
140818	580294	3	3	0	1	1	5
140818	580296	3	0	0	0	0	0
140818	580303	3	1	1	0	0	2
140818	580304	3	3	0	0	0	3
140818	580309	3	0	0	0	0	0
140818	580311	3	1	0	0	0	1
140818	580312	3	3	0	0	0	3
140818	580313	3	2	0	0	0	2
140818	580314	3	0	0	0	0	0
140818	580317	3	0	0	0	0	0
140818	580319	3	0	0	0	0	0
140818	580328	3	1	4	1	0	6
140818	580335	3	0	1	0	0	1
140818	580339	3	2	1	0	0	3
140818	580340	3	2	0	0	0	2
140818	580220	2	0	0	0	0	0
140818	580221	2	0	1	0	0	1
140818	580226	2	0	0	0	0	0
140818	580228	2	1	0	0	0	1
140818	580231	2	0	0	0	0	0
140818	580236	2	0	0	0	0	0
140818	580239	2	0	0	0	0	0
140818	580241	2	0	0	0	1	1
140818	580242	2	1	0	0	0	1
140818	580243	2	2	0	0	0	2
140818	580249	2	1	0	0	0	1
140818	580252	2	1	0	1	0	2
140818	580253	2	3	0	0	0	3
140818	580254	2	0	0	0	0	0
140818	580256	2	0	0	0	1	1
140818	580259	2	2	0	0	0	2
140818	580265	2	0	0	1	0	1
140818	580271	2	1	0	0	1	2
140818	580272	2	0	1	0	0	1
140818	580273	2	1	0	1	1	3
140818	580274	2	0	0	0	0	0
140818	580277	2	1	0	0	0	1
140818	580280	2	0	0	0	0	0
140818	580282	2	1	0	0	1	2
140818	580290	2	0	0	0	0	0
140818	580321	2	2	0	0	0	2
140818	580324	2	2	0	0	1	3
140818	580325	2	0	0	0	0	0
140818	580334	2	3	0	0	0	3
140818	580217	1	1	0	0	1	2
140818	580222	1	0	0	0	1	1
140818	580223	1	1	0	0	1	2
140818	580225	1	1	0	0	1	2
140818	580227	1	1	0	0	0	1
140818	580229	1	2	0	1	0	3
140818	580230	1	1	0	0	0	1
140818	580232	1	2	0	0	0	2
140818	580233	1	0	0	0	0	0
140818	580240	1	2	0	0	0	2
140818	580246	1	1	0	0	0	1
140818	580247	1	0	0	0	0	0
140818	580257	1	2	0	0	0	2
140818	580260	1	0	0	1	0	1
140818	580264	1	1	0	1	1	3
140818	580266	1	1	0	1	1	3
140818	580306	1	0	0	0	0	0
140818	580327	1	1	0	0	2	3
140818	580338	1	0	0	0	0	0
35659	472992	11	2	5	0	4	11
35659	472983	10	5	0	1	0	6
35659	472989	10	3	1	0	1	5
35659	472993	9	1	0	0	0	1
35659	473043	8	4	2	0	0	6
35659	472998	7	1	1	0	0	2
35659	473006	7	3	2	0	1	6
35659	473019	7	1	0	0	0	1
35659	472994	6	3	0	0	0	3
35659	473002	6	3	0	0	0	3
35659	473023	6	1	0	0	0	1
35659	473055	6	1	0	0	0	1
35659	202959	5	0	0	0	0	0
35659	472977	5	5	2	0	0	7
35659	472995	5	2	0	0	0	2
35659	472996	5	1	0	0	0	1
35659	473001	5	2	1	0	1	4
35659	473004	5	2	2	0	0	4
35659	473042	5	1	0	0	0	1
35659	473062	5	3	0	0	0	3
35659	473073	5	1	0	0	0	1
35659	207575	4	1	1	0	0	2
35659	472961	4	0	0	0	0	0
35659	472965	4	1	0	0	0	1
35659	472970	4	2	0	0	0	2
35659	472974	4	1	0	2	0	3
35659	472979	4	0	1	1	2	4
35659	472981	4	0	0	0	1	1
35659	472984	4	0	0	0	0	0
35659	472987	4	0	0	0	0	0
35659	473010	4	2	0	0	0	2
35659	473021	4	2	0	0	0	2
35659	473036	4	1	0	0	0	1
35659	473038	4	2	0	0	0	2
35659	473049	4	2	0	0	0	2
35659	473050	4	1	0	0	0	1
35659	473052	4	3	0	0	0	3
35659	473075	4	1	0	0	0	1
35659	473079	4	0	0	0	0	0
35659	472963	3	0	0	0	0	0
35659	472964	3	1	0	0	0	1
35659	472969	3	0	0	0	0	0
35659	472972	3	1	0	0	0	1
35659	472975	3	0	0	0	0	0
35659	472976	3	1	0	0	0	1
35659	472985	3	1	0	0	0	1
35659	473007	3	0	0	0	3	3
35659	473009	3	0	0	0	0	0
35659	473011	3	1	1	0	1	3
35659	473012	3	2	0	0	0	2
35659	473014	3	2	0	0	2	4
35659	473020	3	2	0	0	0	2
35659	473029	3	0	0	0	0	0
35659	473032	3	2	2	0	0	4
35659	473045	3	2	0	0	1	3
35659	473054	3	4	0	0	0	4
35659	473063	3	0	0	0	0	0
35659	473065	3	1	0	0	0	1
35659	473066	3	0	1	0	0	1
35659	473074	3	1	0	0	0	1
35659	472966	2	3	0	0	0	3
35659	472967	2	4	0	0	0	4
35659	472968	2	3	0	0	0	3
35659	472973	2	0	0	0	0	0
35659	472980	2	1	0	0	0	1
35659	472982	2	1	2	0	0	3
35659	472986	2	1	0	0	0	1
35659	473000	2	1	1	0	0	2
35659	473003	2	1	0	0	0	1
35659	473005	2	2	0	0	0	2
35659	473008	2	1	0	0	0	1
35659	473024	2	2	0	0	0	2
35659	473025	2	1	0	0	0	1
35659	473034	2	1	0	0	1	2
35659	473035	2	4	0	0	0	4
35659	473041	2	1	0	0	0	1
35659	473048	2	2	0	0	0	2
35659	473051	2	2	0	0	0	2
35659	473058	2	3	1	1	0	5
35659	473059	2	2	0	0	0	2
35659	473071	2	0	0	0	0	0
35659	473077	2	3	0	0	0	3
35659	473078	2	2	0	0	0	2
35659	473086	2	0	0	0	0	0
35659	473087	2	0	0	0	0	0
35659	472962	1	2	0	0	1	3
35659	472971	1	2	2	0	0	4
35659	472988	1	2	1	0	0	3
35659	472990	1	3	0	0	0	3
35659	472991	1	0	0	0	0	0
35659	472997	1	1	1	0	0	2
35659	472999	1	2	1	0	0	3
35659	473013	1	1	0	0	0	1
35659	473015	1	1	1	1	0	3
35659	473016	1	0	0	0	0	0
35659	473017	1	1	0	0	0	1
35659	473018	1	0	0	0	0	0
35659	473022	1	0	0	0	0	0
35659	473026	1	1	0	0	0	1
35659	473027	1	0	0	0	0	0
35659	473028	1	0	0	0	0	0
35659	473030	1	0	1	0	0	1
35659	473031	1	0	0	0	0	0
35659	473033	1	0	0	0	0	0
35659	473039	1	1	0	0	0	1
35659	473040	1	2	0	1	0	3
35659	473044	1	0	0	0	0	0
35659	473046	1	1	0	0	0	1
35659	473047	1	2	1	0	1	4
35659	473053	1	1	0	0	0	1
35659	473056	1	0	0	0	0	0
35659	473057	1	1	0	0	0	1
35659	473060	1	2	0	0	0	2
35659	473061	1	2	0	0	0	2
35659	473064	1	0	0	0	0	0
35659	473067	1	1	0	0	0	1
35659	473068	1	2	0	0	0	2
35659	473069	1	4	0	0	0	4
35659	473070	1	1	0	0	0	1
35659	473072	1	1	0	0	0	1
35659	473076	1	0	0	0	0	0
35659	473081	1	0	0	0	0	0
35659	473082	1	1	0	0	0	1
35659	473083	1	1	0	0	0	1
35659	473084	1	0	0	0	0	0
35659	473085	1	0	0	0	0	0
57171	527931	33	3	4	0	0	7
57171	527967	28	5	4	0	3	12
57171	200562	14	2	4	0	0	6
57171	527955	14	2	4	0	0	6
57171	527986	14	3	0	0	1	4
57171	527943	13	1	2	0	0	3
57171	527984	12	0	0	0	1	1
57171	527961	10	1	2	1	0	4
57171	211322	9	1	3	0	1	5
57171	216420	9	0	0	0	0	0
57171	216973	9	0	5	0	2	7
57171	219477	9	0	2	0	0	2
57171	298167	9	0	5	0	2	7
57171	527953	9	1	1	0	0	2
57171	527983	9	0	5	0	2	7
57171	527987	9	0	1	0	0	1
57171	527962	8	0	0	0	1	1
57171	527974	8	0	2	0	0	2
57171	187959	7	2	1	0	1	4
57171	527980	7	4	8	2	0	14
57171	194802	6	1	1	0	0	2
57171	210877	6	2	7	1	0	10
57171	527924	6	2	1	0	0	3
57171	527935	6	2	2	0	0	4
57171	527942	6	0	1	1	0	2
57171	527948	6	0	4	0	0	4
57171	527957	6	1	3	1	0	5
57171	527965	6	0	1	0	0	1
57171	527972	6	0	1	0	0	1
57171	527981	6	1	4	0	2	7
57171	215806	5	0	1	0	0	1
57171	216697	5	1	1	0	0	2
57171	220994	5	2	2	0	1	5
57171	298164	5	0	1	0	0	1
57171	527917	5	2	1	0	0	3
57171	527920	5	1	2	0	1	4
57171	527973	5	0	2	0	0	2
57171	527975	5	0	1	0	1	2
57171	527985	5	1	0	0	1	2
57171	195738	4	1	1	0	0	2
57171	298159	4	0	2	0	0	2
57171	527918	4	0	1	0	0	1
57171	527919	4	2	1	0	0	3
57171	527925	4	0	1	0	1	2
57171	527934	4	1	2	0	1	4
57171	527936	4	3	3	0	0	6
57171	527937	4	1	1	0	0	2
57171	527940	4	0	2	0	1	3
57171	527951	4	1	1	0	0	2
57171	527954	4	0	1	0	0	1
57171	527959	4	0	2	0	0	2
57171	527963	4	0	2	0	0	2
57171	527968	4	1	1	0	0	2
57171	527969	4	0	2	0	0	2
57171	527976	4	1	1	0	0	2
57171	527979	4	2	0	0	0	2
57171	184444	3	1	1	0	0	2
57171	189430	3	1	1	0	0	2
57171	190413	3	1	3	0	0	4
57171	193537	3	0	0	0	0	0
57171	194492	3	2	0	0	0	2
57171	197183	3	0	2	0	0	2
57171	201796	3	0	1	0	0	1
57171	202269	3	1	0	0	1	2
57171	204449	3	0	4	0	0	4
57171	207044	3	0	1	0	0	1
57171	211710	3	0	1	0	0	1
57171	212669	3	1	4	0	0	5
57171	218728	3	1	0	0	1	2
57171	298158	3	1	1	0	0	2
57171	298160	3	2	0	0	0	2
57171	298163	3	0	1	0	0	1
57171	298165	3	0	1	0	0	1
57171	527916	3	1	0	0	0	1
57171	527927	3	0	1	0	0	1
57171	527929	3	0	1	0	0	1
57171	527932	3	0	2	0	0	2
57171	527933	3	1	3	0	0	4
57171	527941	3	0	1	0	0	1
57171	527947	3	1	1	0	0	2
57171	527949	3	1	1	0	0	2
57171	527952	3	2	2	0	0	4
57171	527956	3	1	1	0	0	2
57171	527958	3	1	1	0	0	2
57171	527960	3	0	3	0	0	3
57171	527964	3	3	0	0	0	3
57171	527966	3	0	1	0	0	1
57171	527970	3	0	2	0	1	3
57171	527971	3	1	0	0	0	1
57171	527977	3	1	1	0	0	2
57171	527978	3	1	2	0	0	3
57171	527982	3	1	0	0	0	1
57171	182173	2	0	1	0	0	1
57171	182678	2	1	0	0	0	1
57171	185691	2	0	2	0	0	2
57171	190688	2	0	2	0	0	2
57171	192041	2	0	0	0	0	0
57171	206935	2	0	1	0	0	1
57171	210038	2	1	1	0	0	2
57171	298161	2	0	1	0	0	1
57171	298162	2	0	2	0	0	2
57171	298166	2	0	0	0	0	0
57171	527915	2	1	1	0	0	2
57171	527921	2	1	1	0	0	2
57171	527922	2	0	2	0	1	3
57171	527926	2	0	1	0	0	1
57171	527938	2	2	1	0	0	3
57171	527944	2	0	2	0	0	2
57171	527945	2	1	1	0	0	2
57171	527950	2	1	1	0	1	3
57171	527988	2	0	0	0	1	1
57171	190946	1	0	0	0	0	0
57171	191229	1	1	2	0	0	3
57171	203724	1	1	1	0	0	2
57171	208685	1	0	2	0	0	2
57171	209245	1	0	1	0	0	1
57171	216870	1	0	0	0	0	0
57171	527913	1	0	1	0	0	1
57171	527914	1	0	0	0	0	0
57171	527923	1	1	0	0	1	2
57171	527928	1	0	1	0	1	2
57171	527930	1	0	1	0	0	1
57171	527939	1	0	1	0	0	1
57171	527946	1	0	1	0	0	1
60706	85722	89	5	11	1	4	21
60706	57275	57	4	9	7	4	24
60706	85917	44	4	3	3	2	12
60706	78900	35	2	6	4	5	17
60706	86450	32	4	5	0	1	10
60706	102749	19	1	3	0	1	5
60706	521075	11	2	2	0	1	5
60706	521004	9	5	3	0	0	8
60706	521039	9	0	0	0	0	0
60706	521053	9	0	1	1	0	2
60706	521058	9	0	0	0	2	2
60706	521082	9	1	1	0	0	2
60706	53572	9	0	0	0	0	0
60706	521074	8	0	2	1	2	5
60706	96522	8	0	2	0	0	2
60706	190424	7	1	2	0	0	3
60706	216856	7	1	4	0	0	5
60706	521022	7	3	3	0	1	7
60706	521048	7	0	1	0	0	1
60706	521050	7	2	0	0	0	2
60706	521056	7	2	1	0	0	3
60706	521062	7	2	1	0	1	4
60706	521067	7	2	0	0	0	2
60706	521071	7	2	3	0	0	5
60706	557959	7	3	3	1	0	7
60706	216362	6	1	2	1	0	4
60706	217263	6	0	1	0	1	2
60706	521005	6	1	3	0	0	4
60706	521008	6	2	1	0	0	3
60706	521009	6	2	1	0	1	4
60706	521021	6	0	1	0	1	2
60706	521081	6	1	3	0	0	4
60706	67036	6	1	0	2	0	3
60706	67906	6	1	3	0	1	5
60706	68731	6	2	1	0	0	3
60706	80172	6	0	3	1	0	4
60706	101331	5	0	3	1	0	4
60706	206535	5	2	1	0	0	3
60706	220722	5	3	1	0	0	4
60706	299128	5	0	1	0	1	2
60706	521006	5	2	1	0	0	3
60706	521016	5	0	1	0	0	1
60706	521023	5	2	1	0	0	3
60706	521030	5	2	2	0	0	4
60706	521035	5	1	2	0	1	4
60706	521041	5	0	1	3	0	4
60706	521052	5	2	1	0	2	5
60706	521063	5	3	0	0	0	3
60706	521073	5	2	2	0	0	4
60706	521080	5	1	0	0	1	2
60706	198686	4	0	2	0	1	3
60706	299126	4	2	1	0	0	3
60706	521010	4	1	0	1	0	2
60706	521014	4	0	0	0	0	0
60706	521017	4	1	0	0	0	1
60706	521024	4	2	1	0	1	4
60706	521028	4	1	0	0	0	1
60706	521032	4	1	2	0	1	4
60706	521034	4	1	0	0	0	1
60706	521036	4	1	0	0	0	1
60706	521040	4	1	1	0	0	2
60706	521044	4	2	1	0	0	3
60706	521057	4	1	0	0	0	1
60706	521059	4	0	0	0	0	0
60706	521061	4	0	3	0	1	4
60706	521064	4	1	1	0	0	2
60706	521076	4	1	0	0	1	2
60706	521085	4	0	2	0	1	3
60706	557960	4	0	1	0	0	1
60706	218472	3	0	0	0	1	1
60706	299125	3	1	0	0	0	1
60706	299127	3	0	0	0	1	1
60706	521002	3	0	1	0	0	1
60706	521011	3	1	2	1	2	6
60706	521012	3	0	0	0	0	0
60706	521015	3	0	0	0	1	1
60706	521018	3	0	1	0	0	1
60706	521019	3	1	0	0	0	1
60706	521025	3	0	1	0	0	1
60706	521026	3	1	2	0	0	3
60706	521027	3	1	1	0	0	2
60706	521031	3	1	1	0	0	2
60706	521033	3	1	1	0	0	2
60706	521037	3	1	1	0	0	2
60706	521042	3	3	0	0	0	3
60706	521043	3	1	1	0	0	2
60706	521045	3	0	1	0	0	1
60706	521046	3	0	0	0	0	0
60706	521054	3	2	0	0	0	2
60706	521055	3	1	0	0	0	1
60706	521066	3	2	0	0	0	2
60706	521070	3	0	2	0	0	2
60706	521079	3	0	1	0	0	1
60706	521083	3	1	2	0	0	3
60706	52343	3	1	1	0	0	2
60706	76094	3	1	0	0	0	1
60706	89054	3	1	0	0	0	1
60706	94070	3	0	0	0	1	1
60706	200128	2	0	0	0	0	0
60706	203091	2	0	1	0	0	1
60706	299123	2	0	1	0	0	1
60706	521003	2	2	2	0	2	6
60706	521007	2	1	1	0	0	2
60706	521029	2	0	0	0	0	0
60706	521047	2	1	1	0	0	2
60706	521051	2	0	2	0	0	2
60706	521068	2	2	2	0	0	4
60706	521069	2	0	2	0	1	3
60706	521072	2	0	1	0	0	1
60706	521077	2	1	0	0	0	1
60706	521078	2	1	0	0	0	1
60706	557958	2	0	0	0	0	0
60706	193915	1	1	0	0	0	1
60706	199086	1	0	1	0	0	1
60706	216769	1	0	0	0	0	0
60706	299124	1	0	0	0	0	0
60706	521013	1	0	0	0	0	0
60706	521020	1	0	1	0	0	1
60706	521038	1	1	2	0	0	3
60706	521049	1	0	0	0	0	0
60706	521060	1	2	0	0	0	2
60706	521065	1	0	1	0	0	1
60706	521084	1	0	1	0	0	1
60706	557957	1	0	0	0	0	0
60706	70296	1	0	0	0	0	0
60950	219743	19	0	5	0	3	8
60950	219143	14	0	2	0	0	2
60950	602956	14	1	2	0	0	3
60950	602980	14	1	7	1	1	10
60950	211507	11	1	0	0	0	1
60950	602938	11	3	0	1	0	4
60950	603012	11	2	1	1	1	5
60950	602967	10	1	3	1	1	6
60950	299206	9	2	1	0	0	3
60950	299202	8	0	2	0	0	2
60950	602936	8	2	2	0	1	5
60950	602940	8	1	3	0	0	4
60950	602971	8	0	3	0	0	3
60950	602978	8	6	3	0	0	9
60950	602997	8	1	2	0	1	4
60950	299205	7	1	0	0	0	1
60950	602939	7	2	2	0	2	6
60950	602958	7	1	2	0	0	3
60950	602959	7	0	1	0	0	1
60950	602962	7	0	3	0	0	3
60950	602963	7	2	4	1	0	7
60950	602990	7	3	3	0	0	6
60950	603024	7	2	1	0	3	6
60950	189779	6	1	0	0	1	2
60950	602927	6	1	2	0	3	6
60950	602928	6	3	1	0	0	4
60950	602935	6	1	1	0	0	2
60950	602949	6	1	0	0	0	1
60950	602961	6	1	1	0	0	2
60950	602976	6	1	1	0	0	2
60950	603020	6	4	0	0	0	4
60950	603023	6	0	3	0	1	4
60950	151341	5	0	1	1	1	3
60950	187939	5	2	0	0	0	2
60950	299201	5	0	1	0	0	1
60950	299203	5	1	0	0	0	1
60950	602951	5	2	1	0	0	3
60950	602952	5	0	3	0	0	3
60950	602968	5	0	2	0	0	2
60950	602970	5	4	1	0	0	5
60950	602972	5	0	2	0	0	2
60950	602974	5	2	1	0	0	3
60950	602975	5	0	0	0	0	0
60950	602986	5	0	1	0	0	1
60950	602992	5	1	1	0	0	2
60950	602999	5	3	1	0	1	5
60950	603002	5	0	1	0	0	1
60950	603003	5	0	2	0	0	2
60950	603013	5	1	0	0	0	1
60950	603022	5	1	0	0	0	1
60950	201974	4	0	0	0	0	0
60950	210076	4	0	2	0	0	2
60950	215943	4	0	2	0	0	2
60950	299204	4	0	1	0	0	1
60950	602941	4	0	1	0	1	2
60950	602953	4	1	1	0	0	2
60950	602954	4	1	1	0	0	2
60950	602955	4	1	0	0	0	1
60950	602957	4	0	0	0	0	0
60950	602960	4	2	0	0	0	2
60950	602973	4	0	4	0	0	4
60950	602981	4	1	2	0	0	3
60950	602987	4	1	4	0	0	5
60950	602991	4	2	1	0	0	3
60950	602998	4	0	0	0	0	0
60950	603006	4	1	1	0	0	2
60950	603008	4	1	2	0	0	3
60950	603009	4	0	3	0	0	3
60950	603018	4	0	0	0	0	0
60950	603025	4	2	2	1	0	5
60950	193396	3	1	0	0	1	2
60950	193900	3	0	1	0	0	1
60950	197881	3	0	0	0	0	0
60950	198671	3	0	0	0	0	0
60950	206912	3	0	1	0	0	1
60950	214144	3	0	1	0	0	1
60950	602929	3	1	2	0	0	3
60950	602937	3	0	1	0	0	1
60950	602942	3	1	0	0	0	1
60950	602944	3	0	0	0	0	0
60950	602946	3	1	0	0	1	2
60950	602947	3	0	0	0	0	0
60950	602948	3	1	3	0	0	4
60950	602964	3	0	0	0	0	0
60950	602966	3	0	1	0	1	2
60950	602969	3	0	1	0	0	1
60950	602977	3	0	1	0	0	1
60950	602979	3	0	1	0	1	2
60950	602985	3	1	2	0	0	3
60950	602988	3	1	2	0	0	3
60950	602989	3	1	2	0	0	3
60950	602993	3	0	0	0	0	0
60950	602994	3	1	1	0	0	2
60950	602995	3	0	1	0	0	1
60950	603001	3	1	1	0	0	2
60950	603004	3	0	0	0	0	0
60950	603005	3	2	2	0	0	4
60950	603011	3	0	0	0	0	0
60950	603015	3	1	2	0	0	3
60950	603016	3	0	1	0	0	1
60950	603017	3	0	1	0	0	1
60950	603021	3	0	2	0	0	2
60950	151347	2	0	1	0	1	2
60950	186679	2	0	0	0	0	0
60950	204545	2	1	1	0	0	2
60950	209596	2	1	4	0	0	5
60950	215693	2	0	1	0	0	1
60950	602943	2	0	0	0	0	0
60950	602965	2	0	1	1	0	2
60950	602982	2	0	0	0	0	0
60950	602983	2	0	0	0	0	0
60950	603000	2	1	1	0	0	2
60950	603007	2	1	0	0	0	1
60950	603010	2	0	2	0	0	2
60950	603014	2	0	0	0	0	0
60950	151348	1	0	0	0	0	0
60950	299200	1	1	1	0	0	2
60950	299207	1	0	0	0	0	0
60950	602926	1	0	0	0	1	1
60950	602945	1	0	0	0	1	1
60950	602950	1	0	0	0	0	0
60950	602984	1	0	0	0	0	0
60950	602996	1	1	1	0	0	2
60950	603019	1	2	3	0	0	5
68632	213786	36	3	7	0	4	14
68632	210643	31	2	7	1	2	12
68632	439670	29	2	7	1	2	12
68632	103847	28	1	5	0	2	8
68632	210222	25	1	4	0	0	5
68632	80078	21	2	7	0	1	10
68632	198918	19	1	0	0	0	1
68632	282722	19	1	0	0	0	1
68632	74540	18	1	0	0	0	1
68632	439671	16	3	2	1	0	6
68632	221369	15	1	2	1	0	4
68632	439679	14	4	5	0	0	9
68632	193941	13	3	2	0	0	5
68632	282734	13	4	5	0	0	9
68632	439653	13	0	5	0	0	5
68632	97817	13	4	5	0	0	9
68632	439654	12	0	1	0	0	1
68632	439678	12	2	4	0	1	7
68632	50517	12	1	5	0	0	6
68632	91866	12	2	4	0	1	7
68632	282713	11	0	2	1	0	3
68632	439667	11	0	1	0	0	1
68632	439673	11	0	0	0	0	0
68632	186198	10	1	0	0	1	2
68632	439659	10	1	2	0	0	3
68632	439672	10	4	3	0	1	8
68632	83238	10	1	2	0	0	3
68632	200801	9	3	2	0	0	5
68632	282718	9	1	0	0	1	2
68632	282730	9	3	2	0	0	5
68632	282739	9	0	1	0	3	4
68632	439664	9	1	5	0	1	7
68632	439676	9	2	3	0	2	7
68632	439683	9	3	3	0	2	8
68632	439687	9	1	2	0	0	3
68632	53915	9	0	1	0	3	4
68632	89936	9	0	2	0	0	2
68632	101220	8	1	0	0	0	1
68632	188234	8	0	0	0	0	0
68632	194808	8	2	2	0	2	6
68632	282732	8	1	0	0	0	1
68632	282729	7	2	2	0	0	4
68632	439662	7	3	3	0	0	6
68632	439682	7	1	2	0	2	5
68632	439685	7	1	0	0	1	2
68632	54637	7	0	1	0	0	1
68632	85276	7	2	2	0	0	4
68632	210904	6	1	2	0	0	3
68632	214465	6	0	0	0	1	1
68632	221588	6	0	3	0	0	3
68632	439675	6	1	1	0	0	2
68632	439688	6	3	2	0	0	5
68632	100125	5	0	1	0	0	1
68632	184831	5	0	2	0	0	2
68632	199192	5	2	0	0	0	2
68632	204466	5	0	1	0	0	1
68632	209398	5	0	1	0	0	1
68632	220698	5	2	1	1	0	4
68632	282737	5	0	2	0	0	2
68632	282743	5	0	1	0	0	1
68632	439655	5	0	0	0	1	1
68632	439663	5	1	2	0	0	3
68632	439686	5	1	3	1	1	6
68632	54347	5	0	2	0	0	2
68632	98171	5	1	1	0	2	4
68632	191086	4	1	1	0	0	2
68632	191347	4	1	1	0	0	2
68632	192779	4	0	0	0	0	0
68632	211638	4	0	4	0	0	4
68632	214213	4	1	1	0	0	2
68632	216065	4	0	2	0	0	2
68632	282719	4	0	2	0	0	2
68632	282735	4	0	1	0	0	1
68632	282740	4	0	0	0	0	0
68632	439656	4	3	3	0	0	6
68632	439660	4	3	2	0	0	5
68632	439674	4	1	1	0	0	2
68632	439680	4	0	1	0	0	1
68632	439681	4	0	1	0	0	1
68632	79019	4	0	0	0	0	0
68632	79573	4	0	2	0	0	2
68632	182704	3	2	0	0	0	2
68632	183811	3	2	1	0	0	3
68632	190453	3	0	2	0	0	2
68632	197948	3	0	0	0	0	0
68632	199869	3	0	0	0	0	0
68632	207435	3	0	0	0	0	0
68632	210520	3	0	0	0	0	0
68632	212665	3	0	2	0	0	2
68632	220334	3	0	0	0	0	0
68632	282725	3	0	0	0	1	1
68632	282726	3	2	0	0	0	2
68632	282731	3	0	0	0	0	0
68632	282736	3	0	2	0	0	2
68632	282741	3	1	2	0	0	3
68632	439661	3	0	3	0	0	3
68632	439666	3	0	4	0	0	4
68632	439668	3	0	1	0	0	1
68632	439677	3	1	0	0	0	1
68632	439689	3	1	0	0	0	1
68632	72013	3	0	0	0	1	1
68632	77084	3	0	0	0	0	0
68632	90280	3	0	2	0	0	2
68632	184406	2	0	1	0	0	1
68632	196454	2	0	0	0	0	0
68632	210401	2	0	0	0	0	0
68632	214110	2	0	0	0	0	0
68632	282715	2	0	0	0	0	0
68632	282733	2	0	0	0	0	0
68632	282738	2	0	0	0	0	0
68632	282742	2	0	0	0	0	0
68632	282746	2	0	1	0	0	1
68632	439652	2	0	2	0	1	3
68632	439657	2	1	1	0	0	2
68632	439665	2	2	1	0	0	3
68632	439669	2	0	2	0	0	2
68632	439684	2	0	2	1	0	3
68632	70857	2	0	0	0	0	0
68632	98519	2	0	0	0	0	0
68632	282744	1	0	0	0	0	0
68632	282745	1	0	0	0	0	0
68632	439658	1	2	1	0	0	3
48076	541197	19	0	2	3	1	6
48076	541184	18	1	2	3	1	7
48076	219303	17	0	0	0	1	1
48076	541178	17	1	2	2	0	5
48076	106139	16	0	0	0	1	1
48076	192900	16	0	0	2	0	2
48076	541148	16	2	2	2	0	6
48076	141338	15	0	1	2	0	3
48076	541171	14	0	0	1	3	4
48076	73015	14	1	2	3	3	9
48076	541162	13	0	1	4	0	5
48076	200385	12	0	0	1	2	3
48076	541142	12	1	1	4	1	7
48076	541164	12	0	0	2	0	2
48076	541136	11	2	1	0	3	6
48076	541192	11	1	0	2	2	5
48076	141328	10	1	1	0	1	3
48076	295950	10	1	1	1	5	8
48076	541169	10	1	0	0	1	2
48076	541198	10	0	0	0	1	1
48076	541174	9	0	1	2	1	4
48076	541180	9	1	0	0	2	3
48076	541193	9	0	0	2	0	2
48076	295954	8	0	0	1	1	2
48076	541130	8	0	1	2	6	9
48076	541134	8	2	0	3	2	7
48076	541138	8	1	1	1	1	4
48076	541146	8	1	0	0	0	1
48076	541151	8	0	0	0	4	4
48076	541159	8	1	1	0	2	4
48076	541190	8	1	0	3	0	4
48076	56369	8	0	0	1	1	2
48076	295955	7	0	1	1	1	3
48076	541127	7	1	1	1	0	3
48076	541131	7	1	1	2	1	5
48076	541135	7	1	1	1	0	3
48076	541163	7	2	2	0	2	6
48076	541185	7	2	0	1	3	6
48076	66680	7	0	1	1	1	3
48076	81497	7	0	1	0	0	1
48076	141335	6	0	2	2	0	4
48076	189830	6	0	0	1	1	2
48076	295949	6	2	0	0	0	2
48076	541120	6	0	0	1	0	1
48076	541139	6	5	0	0	1	6
48076	541157	6	0	1	1	0	2
48076	541166	6	0	0	0	1	1
48076	541182	6	1	0	0	0	1
48076	67672	6	0	0	2	2	4
48076	218874	5	0	0	1	0	1
48076	541126	5	2	1	1	2	6
48076	541129	5	0	0	1	3	4
48076	541140	5	1	1	0	3	5
48076	541141	5	0	1	0	1	2
48076	541144	5	3	0	0	0	3
48076	541149	5	0	0	1	1	2
48076	541150	5	0	0	1	1	2
48076	541155	5	1	0	0	2	3
48076	541158	5	1	0	0	1	2
48076	541160	5	1	0	0	2	3
48076	541165	5	1	1	0	0	2
48076	541168	5	0	0	1	0	1
48076	541175	5	1	0	3	2	6
48076	541177	5	2	0	1	1	4
48076	541183	5	0	1	0	0	1
48076	541188	5	2	0	1	0	3
48076	191954	4	0	0	0	2	2
48076	202090	4	0	1	0	0	1
48076	295948	4	0	1	0	4	5
48076	295952	4	0	0	1	3	4
48076	295953	4	1	0	0	0	1
48076	541114	4	1	1	0	0	2
48076	541125	4	0	1	0	0	1
48076	541133	4	0	0	1	1	2
48076	541137	4	0	0	0	0	0
48076	541143	4	0	0	1	1	2
48076	541152	4	1	0	0	0	1
48076	541179	4	2	0	1	0	3
48076	541181	4	0	0	0	2	2
48076	541186	4	0	0	1	0	1
48076	541195	4	1	0	0	1	2
48076	64545	4	0	1	0	4	5
48076	83828	4	1	0	0	0	1
48076	93257	4	0	0	1	3	4
48076	108711	3	0	0	0	1	1
48076	141336	3	1	0	0	0	1
48076	141340	3	1	0	1	0	2
48076	185803	3	1	0	0	1	2
48076	187157	3	1	0	0	0	1
48076	199968	3	1	0	0	1	2
48076	295956	3	0	0	0	1	1
48076	295957	3	0	1	0	3	4
48076	541117	3	1	1	0	0	2
48076	541122	3	0	0	1	2	3
48076	541123	3	0	1	1	1	3
48076	541132	3	0	1	1	1	3
48076	541153	3	0	0	0	2	2
48076	541161	3	1	0	0	1	2
48076	541167	3	1	3	0	0	4
48076	541170	3	0	0	0	3	3
48076	541172	3	1	0	0	2	3
48076	541176	3	0	1	1	0	2
48076	541189	3	1	0	0	0	1
48076	541196	3	1	1	0	3	5
48076	65218	3	0	1	0	3	4
48076	295951	2	0	1	0	0	1
48076	541116	2	0	1	0	0	1
48076	541118	2	0	0	0	0	0
48076	541124	2	0	0	0	0	0
48076	541128	2	1	0	0	3	4
48076	541145	2	1	0	0	0	1
48076	541147	2	0	1	0	0	1
48076	541154	2	0	0	0	0	0
48076	541187	2	0	0	0	0	0
48076	541191	2	1	0	0	0	1
48076	541194	2	0	0	0	1	1
48076	193681	1	0	1	1	0	2
48076	541115	1	0	1	0	0	1
48076	541119	1	0	0	0	1	1
48076	541121	1	0	2	0	1	3
48076	541156	1	2	0	0	1	3
48076	541173	1	0	0	0	1	1
29408	506245	47	4	4	2	0	10
29408	105068	18	3	1	0	3	7
29408	506259	16	4	1	1	0	6
29408	55166	14	2	0	0	1	3
29408	182828	13	1	0	0	1	2
29408	290924	13	1	0	0	1	2
29408	506255	13	5	0	1	1	7
29408	506310	13	4	0	1	0	5
29408	506242	12	4	3	0	1	8
29408	506284	12	2	4	0	1	7
29408	506285	11	6	2	0	0	8
29408	195066	9	2	0	2	0	4
29408	204043	9	0	1	0	0	1
29408	215409	9	0	0	0	1	1
29408	506260	9	2	0	0	2	4
29408	506262	9	3	1	2	2	8
29408	84017	9	2	2	1	0	5
29408	506264	8	3	1	0	1	5
29408	506266	8	3	0	0	0	3
29408	506302	8	3	2	0	0	5
29408	101050	7	1	0	0	0	1
29408	192134	7	3	1	0	0	4
29408	200204	7	4	1	0	1	6
29408	290925	7	1	0	0	0	1
29408	506249	7	3	2	2	0	7
29408	506263	7	0	0	0	0	0
29408	506300	7	0	0	2	1	3
29408	210716	6	1	0	0	0	1
29408	214205	6	0	0	0	0	0
29408	506228	6	2	0	1	1	4
29408	506247	6	0	1	0	0	1
29408	506280	6	0	1	0	2	3
29408	506294	6	1	0	0	0	1
29408	506298	6	1	0	0	1	2
29408	506301	6	0	0	0	0	0
29408	196948	5	0	0	0	1	1
29408	207504	5	1	0	0	0	1
29408	290928	5	1	1	1	0	3
29408	506230	5	1	0	0	1	2
29408	506244	5	2	0	0	0	2
29408	506256	5	0	0	1	0	1
29408	506274	5	1	1	0	1	3
29408	506275	5	1	0	0	0	1
29408	506292	5	4	0	1	0	5
29408	506293	5	1	0	1	0	2
29408	506295	5	1	0	0	0	1
29408	506303	5	0	0	1	1	2
29408	506311	5	1	0	0	1	2
29408	195536	4	1	0	0	0	1
29408	211087	4	0	0	0	0	0
29408	290923	4	2	0	1	0	3
29408	290927	4	5	1	0	0	6
29408	290931	4	1	1	1	1	4
29408	506229	4	2	2	0	1	5
29408	506235	4	2	1	0	0	3
29408	506239	4	3	0	0	1	4
29408	506240	4	0	1	0	1	2
29408	506257	4	3	0	0	0	3
29408	506261	4	2	0	0	0	2
29408	506265	4	0	0	1	0	1
29408	506268	4	0	1	0	0	1
29408	506272	4	1	0	0	0	1
29408	506276	4	1	0	1	0	2
29408	506277	4	1	0	0	0	1
29408	506286	4	1	0	0	1	2
29408	506297	4	0	0	0	0	0
29408	506299	4	1	2	0	0	3
29408	506305	4	1	2	0	0	3
29408	506306	4	1	0	0	0	1
29408	506307	4	2	0	1	1	4
29408	506309	4	2	0	0	0	2
29408	100050	3	0	0	0	0	0
29408	193679	3	0	1	1	0	2
29408	201607	3	0	0	0	0	0
29408	218011	3	1	0	0	0	1
29408	290929	3	1	0	0	0	1
29408	290930	3	0	0	0	0	0
29408	506232	3	0	0	1	1	2
29408	506234	3	0	0	0	2	2
29408	506236	3	1	0	0	0	1
29408	506238	3	0	0	0	0	0
29408	506246	3	1	0	0	2	3
29408	506248	3	0	0	1	0	1
29408	506250	3	1	0	1	0	2
29408	506253	3	0	2	0	1	3
29408	506258	3	1	0	0	1	2
29408	506271	3	0	0	0	0	0
29408	506273	3	0	1	0	0	1
29408	506281	3	2	0	0	0	2
29408	506282	3	2	0	0	0	2
29408	506283	3	0	0	0	0	0
29408	506287	3	0	0	0	2	2
29408	506296	3	1	0	0	0	1
29408	506304	3	0	1	0	1	2
29408	506308	3	1	2	0	0	3
29408	185937	2	1	0	0	0	1
29408	209111	2	1	0	0	0	1
29408	220540	2	1	0	0	0	1
29408	290932	2	1	0	0	0	1
29408	506226	2	1	0	0	0	1
29408	506227	2	1	1	0	1	3
29408	506231	2	0	0	0	1	1
29408	506233	2	0	0	2	0	2
29408	506237	2	2	0	0	0	2
29408	506241	2	0	0	0	0	0
29408	506243	2	0	0	0	0	0
29408	506251	2	1	3	0	0	4
29408	506254	2	0	0	0	0	0
29408	506270	2	3	1	0	2	6
29408	506279	2	3	0	0	0	3
29408	506288	2	1	0	0	1	2
29408	506289	2	0	0	0	0	0
29408	506290	2	1	0	0	1	2
29408	506291	2	0	0	0	0	0
29408	214706	1	0	0	2	1	3
29408	215812	1	1	0	0	1	2
29408	290926	1	1	0	0	1	2
29408	506252	1	0	2	0	0	2
29408	506267	1	0	0	0	0	0
29408	506269	1	0	1	0	1	2
29408	506278	1	1	1	1	0	3
51320	57657	45	3	0	0	0	3
51320	86102	31	2	1	1	0	4
51320	49746	29	3	0	0	2	5
51320	393043	24	3	0	0	0	3
51320	99978	21	2	0	0	0	2
51320	393119	20	3	1	1	1	6
51320	105519	15	0	0	1	0	1
51320	296797	15	0	0	1	0	1
51320	393116	14	4	0	1	0	5
51320	393110	12	2	2	0	1	5
51320	296796	11	1	0	0	0	1
51320	393075	11	3	0	0	2	5
51320	393080	9	0	0	0	1	1
51320	393085	9	2	0	2	0	4
51320	393101	9	1	0	0	0	1
51320	393130	9	1	0	0	1	2
51320	393053	8	1	0	0	0	1
51320	393027	7	1	0	0	0	1
51320	393042	7	2	0	0	0	2
51320	393047	7	1	0	0	0	1
51320	393051	7	0	1	0	0	1
51320	393071	7	0	1	0	0	1
51320	393091	7	0	0	1	1	2
51320	393093	7	1	0	0	0	1
51320	393128	7	2	0	0	0	2
51320	393132	7	0	0	0	0	0
51320	83770	7	1	0	0	0	1
51320	393078	6	1	0	0	0	1
51320	393084	6	1	0	0	0	1
51320	393102	6	3	0	1	0	4
51320	393106	6	2	0	0	0	2
51320	393107	6	3	0	1	1	5
51320	393129	6	1	0	0	0	1
51320	393133	6	1	1	0	0	2
51320	296798	5	0	0	0	0	0
51320	393025	5	0	0	0	1	1
51320	393039	5	0	1	0	0	1
51320	393044	5	0	0	1	0	1
51320	393048	5	2	0	0	1	3
51320	393050	5	3	0	0	0	3
51320	393065	5	0	0	0	0	0
51320	393067	5	2	0	0	0	2
51320	393082	5	0	0	0	2	2
51320	393092	5	0	0	0	0	0
51320	393104	5	0	0	0	0	0
51320	393111	5	2	0	0	1	3
51320	393115	5	1	0	0	0	1
51320	393117	5	2	0	0	1	3
51320	393125	5	0	2	0	0	2
51320	393126	5	0	2	0	0	2
51320	71640	5	0	0	0	0	0
51320	393022	4	0	0	0	0	0
51320	393024	4	1	1	0	0	2
51320	393046	4	2	0	0	0	2
51320	393052	4	2	0	2	0	4
51320	393058	4	0	1	0	0	1
51320	393061	4	0	0	0	0	0
51320	393070	4	0	0	0	0	0
51320	393074	4	0	0	0	0	0
51320	393105	4	1	0	1	1	3
51320	393108	4	0	1	0	0	1
51320	393112	4	5	0	0	1	6
51320	393114	4	1	0	0	0	1
51320	393120	4	5	0	0	0	5
51320	393123	4	0	0	1	0	1
51320	393131	4	0	0	0	2	2
51320	393021	3	0	0	0	0	0
51320	393028	3	1	0	1	0	2
51320	393030	3	2	0	0	0	2
51320	393033	3	2	0	0	0	2
51320	393034	3	0	0	0	0	0
51320	393035	3	1	0	0	0	1
51320	393036	3	1	0	0	0	1
51320	393040	3	0	0	0	0	0
51320	393045	3	1	0	0	0	1
51320	393049	3	1	0	0	0	1
51320	393054	3	1	0	0	0	1
51320	393056	3	0	0	0	0	0
51320	393059	3	2	0	0	0	2
51320	393062	3	0	0	0	0	0
51320	393064	3	0	0	0	0	0
51320	393068	3	1	0	1	0	2
51320	393077	3	0	0	0	0	0
51320	393081	3	0	0	1	0	1
51320	393088	3	1	0	1	1	3
51320	393096	3	2	0	0	0	2
51320	393097	3	0	1	0	0	1
51320	393098	3	1	0	0	0	1
51320	393100	3	0	0	0	0	0
51320	393103	3	0	0	0	0	0
51320	393118	3	2	0	0	2	4
51320	393122	3	0	0	0	0	0
51320	393127	3	0	2	0	0	2
51320	393023	2	0	0	0	1	1
51320	393029	2	1	0	0	0	1
51320	393032	2	1	0	0	0	1
51320	393037	2	0	0	0	0	0
51320	393041	2	0	0	0	0	0
51320	393055	2	1	0	0	0	1
51320	393063	2	1	0	0	0	1
51320	393066	2	1	0	0	0	1
51320	393073	2	2	0	0	0	2
51320	393079	2	1	0	0	0	1
51320	393083	2	0	0	1	0	1
51320	393086	2	0	0	0	0	0
51320	393090	2	1	0	0	0	1
51320	393094	2	0	0	0	0	0
51320	393109	2	1	0	0	0	1
51320	393113	2	2	0	0	1	3
51320	393121	2	0	0	0	1	1
51320	393124	2	1	0	0	0	1
51320	393026	1	0	0	0	0	0
51320	393031	1	0	0	0	0	0
51320	393038	1	0	0	0	0	0
51320	393057	1	2	0	0	0	2
51320	393060	1	1	0	0	0	1
51320	393069	1	0	0	0	0	0
51320	393072	1	0	1	0	0	1
51320	393076	1	0	0	0	0	0
51320	393087	1	0	1	0	0	1
51320	393089	1	0	0	0	0	0
51320	393095	1	0	0	0	0	0
51320	393099	1	2	1	0	0	3
69885	107478	35	2	2	0	2	6
69885	75342	20	2	7	0	1	10
69885	83174	20	1	2	0	0	3
69885	106572	18	1	4	0	2	7
69885	59020	12	0	4	0	2	6
69885	86710	12	0	5	0	0	5
69885	274628	11	1	3	0	0	4
69885	77104	11	1	3	0	0	4
69885	274625	10	0	2	1	0	3
69885	413647	10	0	4	1	0	5
69885	58581	10	2	3	0	0	5
69885	88481	10	2	6	0	2	10
69885	100295	9	1	2	0	0	3
69885	200551	9	0	2	0	0	2
69885	203073	9	1	1	0	2	4
69885	413615	9	0	1	0	0	1
69885	413625	9	0	2	0	0	2
69885	413631	9	1	1	0	2	4
69885	72346	9	0	2	0	0	2
69885	195303	8	0	1	0	1	2
69885	201663	8	0	2	0	0	2
69885	413632	8	0	0	0	1	1
69885	413636	8	1	3	0	0	4
69885	413639	8	3	0	1	0	4
69885	413649	8	1	0	0	1	2
69885	81198	8	1	1	0	0	2
69885	98836	8	1	0	0	1	2
69885	413624	7	1	2	0	0	3
69885	413648	7	1	1	0	0	2
69885	53495	7	0	1	1	0	2
69885	106341	6	0	1	0	0	1
69885	184256	6	0	0	0	0	0
69885	219597	6	0	1	0	0	1
69885	413627	6	1	3	0	0	4
69885	413629	6	0	2	0	0	2
69885	413653	6	0	6	0	0	6
69885	413657	6	2	2	0	0	4
69885	61116	6	0	0	0	0	0
69885	63010	6	1	3	1	0	5
69885	87231	6	0	2	0	0	2
69885	182646	5	1	0	0	0	1
69885	185689	5	1	5	0	0	6
69885	206743	5	0	4	0	0	4
69885	216639	5	0	3	0	0	3
69885	274623	5	1	3	0	0	4
69885	274624	5	0	4	0	0	4
69885	274626	5	0	2	0	0	2
69885	274629	5	0	2	0	0	2
69885	413622	5	0	0	0	2	2
69885	413633	5	2	2	0	0	4
69885	413650	5	1	0	0	0	1
69885	413661	5	1	1	0	0	2
69885	413664	5	2	1	0	0	3
69885	56424	5	1	3	0	1	5
69885	66590	5	1	2	0	0	3
69885	71268	5	0	2	0	0	2
69885	208344	4	0	1	0	0	1
69885	211356	4	0	2	0	0	2
69885	211797	4	0	2	0	0	2
69885	214538	4	0	2	0	3	5
69885	215907	4	1	1	0	0	2
69885	216619	4	0	4	1	1	6
69885	413613	4	3	0	0	0	3
69885	413616	4	0	0	0	0	0
69885	413617	4	1	1	0	0	2
69885	413638	4	0	3	0	0	3
69885	413641	4	0	1	0	0	1
69885	413655	4	0	1	0	0	1
69885	413660	4	1	3	0	0	4
69885	413662	4	0	2	0	0	2
69885	413666	4	2	2	0	0	4
69885	413667	4	1	1	0	0	2
69885	56625	4	1	2	0	0	3
69885	57271	4	1	1	0	0	2
69885	104079	3	2	4	0	0	6
69885	189488	3	1	1	0	0	2
69885	190443	3	0	1	0	1	2
69885	192067	3	0	1	0	0	1
69885	205516	3	2	0	0	0	2
69885	209274	3	0	2	0	0	2
69885	274627	3	1	1	0	0	2
69885	274630	3	1	3	0	0	4
69885	413611	3	0	2	0	3	5
69885	413614	3	0	1	0	1	2
69885	413618	3	0	4	0	0	4
69885	413621	3	0	1	0	0	1
69885	413634	3	1	2	0	1	4
69885	413640	3	0	1	0	0	1
69885	413642	3	1	2	0	0	3
69885	413652	3	2	2	0	1	5
69885	413654	3	0	1	0	0	1
69885	413656	3	0	2	0	0	2
69885	413658	3	2	2	0	0	4
69885	413665	3	0	0	0	0	0
69885	57157	3	0	2	0	1	3
69885	75597	3	1	0	0	0	1
69885	88545	3	1	2	0	0	3
69885	91244	3	1	1	0	0	2
69885	182698	2	3	0	0	1	4
69885	190636	2	0	0	0	0	0
69885	190943	2	0	0	0	2	2
69885	203846	2	1	0	0	0	1
69885	204510	2	0	1	0	0	1
69885	214051	2	0	1	0	1	2
69885	413619	2	0	0	0	0	0
69885	413626	2	1	3	0	1	5
69885	413628	2	0	1	0	0	1
69885	413630	2	1	2	0	0	3
69885	413635	2	1	3	0	0	4
69885	413644	2	0	1	0	0	1
69885	413645	2	0	1	0	0	1
69885	413646	2	0	0	0	0	0
69885	413659	2	1	1	0	0	2
69885	97258	2	0	1	0	0	1
69885	413612	1	0	1	0	0	1
69885	413620	1	1	0	0	0	1
69885	413623	1	2	1	0	0	3
69885	413637	1	0	0	0	0	0
69885	413643	1	1	2	0	0	3
69885	413651	1	0	0	0	0	0
69885	413663	1	0	1	0	0	1
68497	50623	22	3	6	1	1	11
68497	274125	11	3	4	0	1	8
68497	406761	11	3	4	0	1	8
68497	197062	10	3	1	0	0	4
68497	406766	9	1	1	0	0	2
68497	274145	8	2	2	0	3	7
68497	55532	8	0	2	0	0	2
68497	101218	7	1	3	2	2	8
68497	188824	7	0	0	0	0	0
68497	198740	7	0	1	0	0	1
68497	274119	7	0	1	0	0	1
68497	274128	7	4	2	0	1	7
68497	274134	7	1	3	2	2	8
68497	274142	7	3	2	0	0	5
68497	274144	7	1	3	0	0	4
68497	406756	7	2	3	0	0	5
68497	406767	7	1	1	1	0	3
68497	69227	7	3	2	0	0	5
68497	74539	7	0	1	0	0	1
68497	101924	6	0	3	0	0	3
68497	274126	6	0	3	0	0	3
68497	274127	6	0	2	1	0	3
68497	274137	6	1	2	0	0	3
68497	274146	6	0	0	0	0	0
68497	406754	6	1	1	0	1	3
68497	406769	6	2	2	1	0	5
68497	406773	6	0	2	1	0	3
68497	52583	6	0	2	1	0	3
68497	68744	6	1	2	0	0	3
68497	102227	5	1	3	0	1	5
68497	214815	5	1	3	0	1	5
68497	216714	5	2	2	2	2	8
68497	274124	5	2	3	0	0	5
68497	274136	5	2	2	1	0	5
68497	274139	5	0	5	0	0	5
68497	274143	5	1	1	0	0	2
68497	406748	5	1	0	0	0	1
68497	406760	5	1	2	0	1	4
68497	406768	5	1	1	0	0	2
68497	406771	5	3	3	0	0	6
68497	406772	5	0	1	0	0	1
68497	406775	5	4	1	2	2	9
68497	406794	5	1	1	0	1	3
68497	56414	5	1	1	0	0	2
68497	59966	5	0	0	0	0	0
68497	91220	5	2	3	0	0	5
68497	97816	5	1	1	0	0	2
68497	184797	4	1	2	0	0	3
68497	199911	4	1	2	0	0	3
68497	204066	4	1	3	0	0	4
68497	211371	4	0	2	0	0	2
68497	274129	4	1	1	0	0	2
68497	274140	4	1	3	0	0	4
68497	274141	4	1	2	0	0	3
68497	406749	4	2	2	0	1	5
68497	406753	4	2	2	2	2	8
68497	406757	4	2	1	0	1	4
68497	406758	4	0	1	0	0	1
68497	406762	4	2	1	0	0	3
68497	406774	4	1	1	1	0	3
68497	406777	4	4	2	0	1	7
68497	406779	4	2	2	0	2	6
68497	406786	4	1	2	0	3	6
68497	406789	4	2	3	0	1	6
68497	406802	4	1	1	0	0	2
68497	54345	4	1	2	0	0	3
68497	70845	4	1	1	0	0	2
68497	189755	3	2	1	0	0	3
68497	195678	3	1	2	0	0	3
68497	274120	3	2	1	0	0	3
68497	274122	3	1	1	0	0	2
68497	274123	3	0	1	0	0	1
68497	274131	3	1	1	2	0	4
68497	274132	3	1	1	0	1	3
68497	406750	3	0	3	0	0	3
68497	406751	3	0	3	0	0	3
68497	406752	3	2	1	0	0	3
68497	406755	3	3	2	0	0	5
68497	406763	3	0	0	0	2	2
68497	406764	3	1	1	0	0	2
68497	406765	3	1	2	0	1	4
68497	406770	3	1	1	0	1	3
68497	406776	3	1	1	0	0	2
68497	406778	3	0	2	0	2	4
68497	406781	3	0	1	0	1	2
68497	406783	3	1	3	0	1	5
68497	406784	3	0	0	1	0	1
68497	406785	3	0	0	0	1	1
68497	406788	3	1	0	0	0	1
68497	406791	3	1	3	0	1	5
68497	406792	3	0	1	0	0	1
68497	406793	3	0	3	0	0	3
68497	406795	3	1	1	0	0	2
68497	406797	3	0	4	0	0	4
68497	406798	3	0	2	0	2	4
68497	406799	3	0	1	0	0	1
68497	51146	3	1	1	2	0	4
68497	88086	3	1	1	0	0	2
68497	100124	2	1	0	0	0	1
68497	186525	2	1	1	0	0	2
68497	205499	2	0	1	0	0	1
68497	208727	2	1	2	0	2	5
68497	274121	2	0	0	0	0	0
68497	274130	2	0	1	0	0	1
68497	274133	2	1	0	0	0	1
68497	274135	2	0	2	0	0	2
68497	274138	2	0	3	0	0	3
68497	406759	2	1	0	0	1	2
68497	406782	2	1	3	1	1	6
68497	406787	2	0	1	0	0	1
68497	406790	2	0	2	0	0	2
68497	406796	2	0	1	2	1	4
68497	72483	2	0	1	0	0	1
68497	85275	2	0	3	0	0	3
68497	94165	2	0	2	0	0	2
68497	95850	2	0	0	0	0	0
68497	216841	1	0	1	0	0	1
68497	218522	1	0	2	0	0	2
68497	406780	1	0	2	0	0	2
68497	406800	1	0	0	0	1	1
68497	406801	1	0	1	0	0	1
41954	101365	35	1	6	0	0	7
41954	199000	33	1	1	2	3	7
41954	294445	33	1	1	2	3	7
41954	491710	17	0	2	0	2	4
41954	192153	15	2	1	0	1	4
41954	491729	15	6	3	2	4	15
41954	220544	13	4	0	1	2	7
41954	491726	11	2	4	0	0	6
41954	294449	10	0	3	0	3	6
41954	491708	10	1	1	0	0	2
41954	57450	10	0	3	0	3	6
41954	221162	9	3	1	1	1	6
41954	294441	9	1	1	0	2	4
41954	294442	9	0	1	0	0	1
41954	491703	9	1	3	0	1	5
41954	491716	9	0	3	0	3	6
41954	491745	9	2	1	0	1	4
41954	71545	9	1	1	0	2	4
41954	193503	8	0	2	0	1	3
41954	294450	8	0	0	0	1	1
41954	79166	8	0	0	0	1	1
41954	184968	7	1	6	0	2	9
41954	294446	7	1	0	1	0	2
41954	491717	7	0	1	0	0	1
41954	491736	7	0	3	0	0	3
41954	491750	7	2	0	0	0	2
41954	491752	7	2	1	2	1	6
41954	80796	7	1	3	0	2	6
41954	197108	6	1	0	0	0	1
41954	198640	6	1	1	0	0	2
41954	491700	6	1	1	0	1	3
41954	491704	6	1	0	0	1	2
41954	491712	6	1	2	0	0	3
41954	491724	6	2	3	0	2	7
41954	491737	6	3	1	0	0	4
41954	491741	6	1	0	0	0	1
41954	491742	6	2	2	0	0	4
41954	491744	6	1	3	0	1	5
41954	182963	5	1	0	0	1	2
41954	201710	5	0	0	0	0	0
41954	201755	5	1	0	0	1	2
41954	208299	5	1	0	0	2	3
41954	217360	5	0	0	0	2	2
41954	221887	5	2	4	3	0	9
41954	294447	5	1	0	0	1	2
41954	294452	5	0	3	0	2	5
41954	491701	5	0	3	1	0	4
41954	491702	5	0	3	1	1	5
41954	491706	5	0	0	0	0	0
41954	491711	5	1	2	0	0	3
41954	491713	5	1	0	0	0	1
41954	491714	5	2	0	0	1	3
41954	491715	5	0	1	0	0	1
41954	491720	5	3	2	0	1	6
41954	491725	5	2	0	0	1	3
41954	491727	5	2	0	0	0	2
41954	491734	5	1	0	0	0	1
41954	491738	5	2	1	0	0	3
41954	491740	5	2	0	0	5	7
41954	491743	5	1	0	0	0	1
41954	491747	5	0	2	0	1	3
41954	491751	5	1	1	0	3	5
41954	50975	5	0	3	0	2	5
41954	188469	4	1	2	0	2	5
41954	205919	4	1	0	0	1	2
41954	205970	4	1	0	0	3	4
41954	208100	4	1	1	0	0	2
41954	212680	4	0	0	0	2	2
41954	220695	4	0	1	1	0	2
41954	294451	4	0	2	0	1	3
41954	294454	4	0	1	0	0	1
41954	491721	4	2	1	0	1	4
41954	491728	4	1	0	0	0	1
41954	491735	4	1	2	0	2	5
41954	491739	4	1	1	1	0	3
41954	71025	4	0	1	0	0	1
41954	190477	3	0	1	0	0	1
41954	192179	3	2	1	0	2	5
41954	192757	3	0	2	0	0	2
41954	194763	3	1	1	0	1	3
41954	196420	3	1	0	0	2	3
41954	199900	3	1	2	0	2	5
41954	203104	3	1	2	0	0	3
41954	206235	3	0	0	0	3	3
41954	206994	3	0	0	0	0	0
41954	207572	3	0	1	0	1	2
41954	207914	3	0	1	2	1	4
41954	218599	3	0	0	2	0	2
41954	218643	3	1	0	0	0	1
41954	294440	3	0	1	0	3	4
41954	294448	3	0	0	0	2	2
41954	491699	3	2	0	0	0	2
41954	491705	3	1	1	0	1	3
41954	491709	3	2	0	2	3	7
41954	491722	3	2	0	0	0	2
41954	491723	3	0	0	0	0	0
41954	491731	3	0	0	0	0	0
41954	491732	3	0	1	0	0	1
41954	491733	3	0	0	0	0	0
41954	491746	3	1	2	1	2	6
41954	491748	3	0	0	0	1	1
41954	491749	3	1	2	0	2	5
41954	51307	3	0	1	0	3	4
41954	53714	3	0	0	0	2	2
41954	103193	2	0	0	0	1	1
41954	184566	2	0	1	0	2	3
41954	185481	2	0	1	0	1	2
41954	193688	2	2	0	0	0	2
41954	201285	2	1	1	0	0	2
41954	294443	2	0	2	0	0	2
41954	294444	2	0	0	0	0	0
41954	294453	2	0	0	0	1	1
41954	491707	2	0	0	0	0	0
41954	491718	2	0	0	0	1	1
41954	491730	2	0	0	0	0	0
41954	200045	1	0	0	0	0	0
41954	205338	1	0	0	0	1	1
41954	208710	1	0	0	0	1	1
41954	221886	1	0	0	0	0	0
41954	294455	1	0	0	0	0	0
41954	491719	1	1	0	1	1	3
41954	491753	1	2	1	0	1	4
33139	534875	48	3	3	2	5	13
33139	534865	44	2	6	4	4	16
33139	534874	44	6	6	2	6	20
33139	519660	38	2	8	4	1	15
33139	534860	33	3	2	2	0	7
33139	534864	33	2	5	3	1	11
33139	519656	30	1	0	2	0	3
33139	519658	30	5	3	6	0	14
33139	534862	28	1	3	3	1	8
33139	519657	25	7	2	0	0	9
33139	519655	24	5	3	0	2	10
33139	519693	22	2	2	1	2	7
33139	202512	21	1	1	1	0	3
33139	278811	21	1	1	1	0	3
33139	534859	21	1	1	2	5	9
33139	534863	20	2	2	0	5	9
33139	519659	19	1	0	0	3	4
33139	519676	19	4	0	2	0	6
33139	212089	17	2	1	2	3	8
33139	534872	17	2	1	2	3	8
33139	534858	16	5	3	1	1	10
33139	534880	14	2	0	0	1	3
33139	278819	12	1	1	1	4	7
33139	278813	11	2	2	0	2	6
33139	519673	11	2	2	0	2	6
33139	278818	10	1	4	3	0	8
33139	519681	10	1	1	2	2	6
33139	278816	9	4	3	2	2	11
33139	211525	8	2	1	1	2	6
33139	278814	8	1	5	0	2	8
33139	519666	8	0	2	0	1	3
33139	519684	8	3	2	1	1	7
33139	534866	8	4	0	0	0	4
33139	534878	8	1	1	0	1	3
33139	534881	8	0	2	0	1	3
33139	185370	7	1	1	0	0	2
33139	192328	7	2	1	0	4	7
33139	519686	7	0	1	0	0	1
33139	519687	7	0	2	0	1	3
33139	519690	7	1	2	2	2	7
33139	519696	7	3	0	0	0	3
33139	519705	7	1	2	1	0	4
33139	519707	7	2	3	0	0	5
33139	519712	7	0	1	0	1	2
33139	207859	6	0	0	0	0	0
33139	278815	6	0	0	1	0	1
33139	519662	6	1	2	0	1	4
33139	519672	6	1	0	0	0	1
33139	519678	6	0	2	0	1	3
33139	519680	6	1	1	1	0	3
33139	519683	6	3	1	0	1	5
33139	519689	6	0	1	1	0	2
33139	184639	5	0	1	0	1	2
33139	190767	5	0	0	0	0	0
33139	214945	5	2	1	0	0	3
33139	278817	5	0	0	1	2	3
33139	519665	5	1	2	0	0	3
33139	519671	5	2	1	0	0	3
33139	519701	5	0	1	2	0	3
33139	519702	5	2	1	2	0	5
33139	534871	5	1	3	1	0	5
33139	534877	5	1	0	0	1	2
33139	534883	5	0	2	0	2	4
33139	185212	4	0	0	0	1	1
33139	201388	4	0	0	0	2	2
33139	204816	4	0	0	0	4	4
33139	206392	4	0	0	0	2	2
33139	215006	4	0	0	0	0	0
33139	217798	4	2	1	0	2	5
33139	218024	4	2	1	1	0	4
33139	218034	4	2	1	0	0	3
33139	519664	4	0	1	0	2	3
33139	519670	4	1	1	0	1	3
33139	519677	4	2	0	0	1	3
33139	519703	4	1	1	0	0	2
33139	519710	4	1	0	0	1	2
33139	519711	4	2	1	1	2	6
33139	534855	4	1	1	0	1	3
33139	534876	4	0	1	0	1	2
33139	534884	4	0	3	1	1	5
33139	193079	3	0	0	0	0	0
33139	198426	3	1	3	1	2	7
33139	278810	3	0	0	0	0	0
33139	278812	3	0	1	0	2	3
33139	519661	3	1	3	1	0	5
33139	519663	3	0	4	0	0	4
33139	519667	3	0	1	0	0	1
33139	519674	3	0	1	0	3	4
33139	519675	3	0	1	0	1	2
33139	519682	3	1	1	0	2	4
33139	519692	3	1	1	0	0	2
33139	519698	3	2	0	0	0	2
33139	519700	3	0	0	0	0	0
33139	519704	3	0	0	0	1	1
33139	519709	3	1	1	0	1	3
33139	534867	3	0	1	0	0	1
33139	534882	3	0	1	0	0	1
33139	183517	2	1	1	1	2	5
33139	196003	2	0	0	0	0	0
33139	201986	2	0	0	0	1	1
33139	210044	2	1	0	0	0	1
33139	210604	2	0	0	0	2	2
33139	519668	2	0	1	0	0	1
33139	519685	2	0	0	0	0	0
33139	519688	2	0	0	0	0	0
33139	519694	2	1	1	0	2	4
33139	519695	2	0	0	0	0	0
33139	519699	2	1	1	1	1	4
33139	519706	2	0	2	2	1	5
33139	519708	2	0	0	0	1	1
33139	534861	2	0	0	0	0	0
33139	534868	2	1	0	0	0	1
33139	534869	2	2	0	0	0	2
33139	534873	2	2	0	0	1	3
33139	534879	2	0	0	0	0	0
33139	205750	1	0	1	0	1	2
33139	519669	1	0	0	0	0	0
33139	519691	1	0	0	0	0	0
33139	519697	1	0	0	1	1	2
33139	534856	1	0	0	0	1	1
33139	534857	1	0	0	0	0	0
33139	534870	1	2	0	0	1	3
15456	373016	43	1	6	1	0	8
15456	373017	43	1	6	1	0	8
15456	217028	36	3	0	3	1	7
15456	287255	36	3	0	3	1	7
15456	104147	35	3	0	3	1	7
15456	287239	35	1	4	1	0	6
15456	80220	35	1	4	1	0	6
15456	87009	31	1	8	1	0	10
15456	210953	26	1	4	2	1	8
15456	373050	25	1	4	2	0	7
15456	220564	24	1	2	1	1	5
15456	373049	23	2	5	0	1	8
15456	373022	22	1	2	0	0	3
15456	200880	21	0	3	0	0	3
15456	373034	21	0	3	0	0	3
15456	373044	21	0	2	0	0	2
15456	373046	20	3	0	1	1	5
15456	189826	18	2	6	0	2	10
15456	55453	18	0	5	3	0	8
15456	373030	17	4	3	0	0	7
15456	81220	17	1	2	1	1	5
15456	373025	16	0	0	0	0	0
15456	373048	15	3	1	0	0	4
15456	212219	14	3	1	2	4	10
15456	373018	14	3	1	2	4	10
15456	373019	14	3	1	2	4	10
15456	62605	14	2	5	1	2	10
15456	373002	13	4	3	0	3	10
15456	373029	13	3	2	0	0	5
15456	54144	13	1	2	0	0	3
15456	184495	12	3	0	0	1	4
15456	201514	11	1	1	0	0	2
15456	287245	11	0	4	0	0	4
15456	287250	11	1	1	0	2	4
15456	373038	11	2	0	0	1	3
15456	373047	11	1	3	0	4	8
15456	91667	11	1	1	0	2	4
15456	100998	10	1	1	0	1	3
15456	287246	10	1	1	0	1	3
15456	373024	10	2	1	1	0	4
15456	192161	9	3	3	0	4	10
15456	211996	9	1	2	0	0	3
15456	213843	9	0	1	0	1	2
15456	287249	9	0	1	0	1	2
15456	287257	9	0	2	0	2	4
15456	373008	9	2	4	0	1	7
15456	373027	9	0	0	0	0	0
15456	373028	9	0	2	0	0	2
15456	373036	9	0	2	1	1	4
15456	373043	9	3	2	0	1	6
15456	99164	9	0	1	0	1	2
15456	104074	8	2	1	0	0	3
15456	184804	8	1	2	0	0	3
15456	190533	8	0	0	1	1	2
15456	287247	8	0	0	0	1	1
15456	287253	8	1	2	0	0	3
15456	287256	8	0	1	1	0	2
15456	373023	8	1	3	0	0	4
15456	373032	8	0	1	0	0	1
15456	373033	8	1	4	1	2	8
15456	373041	8	3	2	0	0	5
15456	373042	8	1	2	0	0	3
15456	59654	8	0	1	1	0	2
15456	188803	7	1	2	1	3	7
15456	205894	7	3	1	0	0	4
15456	217987	7	1	0	0	1	2
15456	287242	7	0	0	0	1	1
15456	287252	7	0	1	0	0	1
15456	373014	7	0	1	0	0	1
15456	373021	7	2	0	0	0	2
15456	373039	7	1	0	0	0	1
15456	373040	7	0	8	1	1	10
15456	78164	7	0	1	0	0	1
15456	186856	6	1	4	0	1	6
15456	373003	6	1	1	0	1	3
15456	373010	6	0	0	0	0	0
15456	373037	6	0	2	0	1	3
15456	373051	6	0	1	0	0	1
15456	105078	5	1	2	1	0	4
15456	183972	5	2	1	0	0	3
15456	211657	5	2	2	0	1	5
15456	287240	5	2	3	0	2	7
15456	287248	5	1	4	0	1	6
15456	373020	5	1	0	0	0	1
15456	87244	5	1	4	0	1	6
15456	183835	4	0	1	0	0	1
15456	195981	4	1	0	0	0	1
15456	210397	4	1	4	0	1	6
15456	217372	4	1	0	0	1	2
15456	217989	4	0	1	0	0	1
15456	220011	4	1	1	0	0	2
15456	287244	4	0	1	0	0	1
15456	287251	4	2	0	0	0	2
15456	287254	4	0	1	0	0	1
15456	373005	4	1	2	0	1	4
15456	373006	4	3	3	0	1	7
15456	373007	4	4	0	2	0	6
15456	373011	4	0	0	0	0	0
15456	373012	4	2	2	0	0	4
15456	373015	4	1	0	0	0	1
15456	373031	4	1	0	0	0	1
15456	373045	4	0	4	0	1	5
15456	84652	4	0	1	0	0	1
15456	189608	3	0	1	0	0	1
15456	373013	3	0	1	0	0	1
15456	373035	3	0	0	1	0	1
15456	198164	2	1	1	0	0	2
15456	198267	2	0	0	0	0	0
15456	200048	2	0	1	0	0	1
15456	201837	2	1	0	0	0	1
15456	208706	2	0	1	0	0	1
15456	287243	2	0	0	0	0	0
15456	373004	2	0	0	0	0	0
15456	373009	2	0	0	0	0	0
15456	373026	2	0	0	0	1	1
15456	373052	2	0	2	0	0	2
15456	207411	1	0	1	0	0	1
15456	208889	1	0	0	0	1	1
15456	211173	1	0	0	0	0	0
15456	287241	1	0	0	0	0	0
40649	69950	35	5	3	4	0	12
40649	610529	19	3	3	0	1	7
40649	610534	19	1	2	0	0	3
40649	66864	19	2	3	0	2	7
40649	610488	14	1	4	1	1	7
40649	610530	13	1	2	0	0	3
40649	610544	12	2	2	0	0	4
40649	610540	10	3	1	0	2	6
40649	610456	8	1	2	2	1	6
40649	610533	8	0	1	0	1	2
40649	81024	8	0	2	2	0	4
40649	104450	7	1	0	1	2	4
40649	610486	7	1	0	1	2	4
40649	610493	7	2	1	0	1	4
40649	610528	7	1	1	0	2	4
40649	610563	7	0	1	0	2	3
40649	191714	6	2	2	1	0	5
40649	610459	6	1	2	0	0	3
40649	610470	6	1	2	0	0	3
40649	610481	6	1	2	0	0	3
40649	610499	6	1	0	0	1	2
40649	610503	6	0	1	0	5	6
40649	610537	6	1	1	1	6	9
40649	610541	6	0	0	0	0	0
40649	610550	6	1	1	0	1	3
40649	64361	6	2	2	1	0	5
40649	610473	5	3	1	1	1	6
40649	610492	5	0	1	0	0	1
40649	610519	5	0	2	0	1	3
40649	610552	5	0	1	0	0	1
40649	610560	5	0	1	1	2	4
40649	610465	4	0	1	0	1	2
40649	610489	4	0	1	0	0	1
40649	610496	4	0	0	0	1	1
40649	610497	4	0	1	0	1	2
40649	610500	4	1	1	0	2	4
40649	610501	4	0	0	0	1	1
40649	610512	4	0	1	0	0	1
40649	610514	4	0	1	0	2	3
40649	610516	4	1	0	0	1	2
40649	610521	4	0	0	0	0	0
40649	610524	4	0	2	0	1	3
40649	610526	4	0	2	0	1	3
40649	610532	4	3	0	1	4	8
40649	610567	4	0	0	0	2	2
40649	610568	4	0	0	0	0	0
40649	610457	3	0	1	0	0	1
40649	610458	3	1	1	0	0	2
40649	610466	3	0	2	0	0	2
40649	610469	3	0	0	1	0	1
40649	610478	3	0	1	0	2	3
40649	610482	3	0	0	0	0	0
40649	610487	3	0	1	0	0	1
40649	610491	3	0	1	0	1	2
40649	610495	3	0	1	0	1	2
40649	610506	3	0	0	0	0	0
40649	610511	3	1	1	0	0	2
40649	610515	3	0	1	0	1	2
40649	610520	3	2	2	0	1	5
40649	610525	3	1	0	0	0	1
40649	610527	3	1	0	0	1	2
40649	610531	3	4	2	1	0	7
40649	610538	3	0	0	0	1	1
40649	610545	3	0	0	0	2	2
40649	610546	3	2	2	0	1	5
40649	610555	3	0	0	0	0	0
40649	610556	3	1	0	0	0	1
40649	610461	2	0	2	0	2	4
40649	610471	2	1	0	1	0	2
40649	610472	2	0	2	0	0	2
40649	610479	2	0	0	0	0	0
40649	610490	2	0	0	0	0	0
40649	610502	2	1	0	0	0	1
40649	610510	2	0	2	0	0	2
40649	610517	2	0	0	0	2	2
40649	610535	2	1	1	0	1	3
40649	610547	2	1	0	0	1	2
40649	610551	2	0	0	0	0	0
40649	610554	2	0	1	0	0	1
40649	610557	2	1	1	0	1	3
40649	610559	2	0	1	0	0	1
40649	610561	2	2	3	1	0	6
40649	610564	2	0	1	0	1	2
40649	610455	1	1	0	0	0	1
40649	610460	1	0	0	0	0	0
40649	610462	1	0	0	0	0	0
40649	610463	1	0	0	0	1	1
40649	610464	1	0	1	0	0	1
40649	610467	1	0	0	0	0	0
40649	610468	1	1	2	0	1	4
40649	610474	1	0	0	0	0	0
40649	610475	1	0	0	0	0	0
40649	610476	1	0	1	0	0	1
40649	610477	1	2	0	0	0	2
40649	610480	1	0	0	1	0	1
40649	610483	1	0	1	1	0	2
40649	610484	1	1	0	0	0	1
40649	610485	1	0	1	0	0	1
40649	610494	1	0	1	0	0	1
40649	610498	1	0	0	0	1	1
40649	610504	1	0	0	0	0	0
40649	610505	1	0	0	0	1	1
40649	610507	1	0	1	0	0	1
40649	610508	1	0	0	0	0	0
40649	610509	1	0	0	0	0	0
40649	610513	1	0	1	0	0	1
40649	610518	1	1	0	0	1	2
40649	610522	1	0	0	0	0	0
40649	610523	1	0	1	0	1	2
40649	610536	1	0	0	0	1	1
40649	610539	1	0	1	0	0	1
40649	610542	1	2	1	0	1	4
40649	610543	1	0	0	0	0	0
40649	610548	1	0	0	0	2	2
40649	610549	1	0	1	0	0	1
40649	610553	1	0	0	0	0	0
40649	610558	1	0	0	0	1	1
40649	610562	1	0	0	0	0	0
40649	610565	1	0	0	0	0	0
40649	610566	1	0	0	0	0	0
17260	196788	12	2	1	0	0	3
17260	516766	9	1	0	0	1	2
17260	516771	9	2	2	0	2	6
17260	287698	8	2	3	0	1	6
17260	516782	8	2	2	0	5	9
17260	71097	8	2	3	0	1	6
17260	188125	7	1	6	0	1	8
17260	287696	7	2	3	0	1	6
17260	287700	7	3	2	0	0	5
17260	287707	7	0	0	0	0	0
17260	516783	7	2	3	0	1	6
17260	516784	7	2	5	0	1	8
17260	516785	7	2	1	0	2	5
17260	79092	7	2	3	0	1	6
17260	90634	7	3	2	0	0	5
17260	101641	6	1	1	0	1	3
17260	210328	6	1	0	0	0	1
17260	217249	6	1	2	0	0	3
17260	218450	6	2	1	0	1	4
17260	287695	6	2	0	0	1	3
17260	287704	6	1	2	0	0	3
17260	287705	6	2	1	0	1	4
17260	287706	6	1	1	0	1	3
17260	516770	6	2	0	1	0	3
17260	516773	6	1	2	0	4	7
17260	516809	6	0	3	0	1	4
17260	91939	6	2	0	0	1	3
17260	93739	6	2	1	0	1	4
17260	102923	5	0	1	0	0	1
17260	194800	5	0	0	0	2	2
17260	516769	5	2	1	0	1	4
17260	516787	5	1	1	0	0	2
17260	516795	5	2	1	0	0	3
17260	516811	5	1	1	0	0	2
17260	516815	5	1	2	0	1	4
17260	516831	5	1	2	0	2	5
17260	516832	5	0	1	0	0	1
17260	183255	4	1	0	0	0	1
17260	189833	4	2	0	0	2	4
17260	211505	4	0	1	0	2	3
17260	287708	4	2	1	0	1	4
17260	516765	4	0	1	0	0	1
17260	516767	4	0	0	0	1	1
17260	516774	4	1	0	0	0	1
17260	516778	4	5	2	0	0	7
17260	516779	4	2	0	0	0	2
17260	516786	4	2	0	0	0	2
17260	516792	4	1	0	0	1	2
17260	516793	4	2	1	0	0	3
17260	516799	4	1	2	1	0	4
17260	516803	4	1	0	0	2	3
17260	516805	4	1	0	0	0	1
17260	516807	4	1	0	0	1	2
17260	516808	4	0	2	0	2	4
17260	516820	4	2	0	0	2	4
17260	516821	4	2	1	0	1	4
17260	516823	4	2	1	0	1	4
17260	211970	3	0	1	0	0	1
17260	220171	3	1	0	0	1	2
17260	221001	3	0	0	0	1	1
17260	287693	3	1	0	0	0	1
17260	287697	3	0	0	0	1	1
17260	287703	3	1	0	0	1	2
17260	287709	3	0	2	0	1	3
17260	516764	3	0	0	0	0	0
17260	516777	3	3	2	0	2	7
17260	516781	3	0	1	0	1	2
17260	516788	3	1	0	0	2	3
17260	516791	3	0	1	0	0	1
17260	516794	3	3	2	0	0	5
17260	516798	3	1	2	0	1	4
17260	516806	3	1	1	0	2	4
17260	516812	3	1	3	0	0	4
17260	516813	3	0	0	0	1	1
17260	516819	3	1	2	0	0	3
17260	516822	3	0	1	0	0	1
17260	516824	3	0	0	0	1	1
17260	516825	3	0	3	0	2	5
17260	516826	3	1	0	0	1	2
17260	53648	3	0	0	0	1	1
17260	70757	3	1	0	0	0	1
17260	100033	2	0	0	0	2	2
17260	191063	2	0	1	0	1	2
17260	201299	2	0	1	0	2	3
17260	203292	2	0	0	0	1	1
17260	287692	2	0	0	0	0	0
17260	287694	2	1	3	0	0	4
17260	287699	2	1	1	0	0	2
17260	287701	2	0	0	0	0	0
17260	287702	2	0	0	0	2	2
17260	516763	2	1	2	0	0	3
17260	516768	2	0	0	0	0	0
17260	516772	2	0	1	0	0	1
17260	516775	2	0	0	0	0	0
17260	516780	2	2	1	0	0	3
17260	516790	2	0	0	0	2	2
17260	516796	2	1	1	0	2	4
17260	516797	2	1	0	0	0	1
17260	516800	2	0	1	0	0	1
17260	516801	2	0	1	0	0	1
17260	516802	2	1	1	0	0	2
17260	516804	2	1	1	0	1	3
17260	516814	2	0	0	0	0	0
17260	516817	2	2	0	0	0	2
17260	516827	2	1	0	0	0	1
17260	516829	2	1	1	0	0	2
17260	66959	2	1	0	0	1	2
17260	70974	2	0	0	0	0	0
17260	84659	2	1	3	0	0	4
17260	92491	2	1	0	0	2	3
17260	186605	1	0	0	0	1	1
17260	190140	1	0	0	0	0	0
17260	204790	1	1	1	0	2	4
17260	516776	1	0	0	0	0	0
17260	516789	1	0	0	0	0	0
17260	516810	1	0	3	0	0	3
17260	516816	1	0	4	0	0	4
17260	516828	1	1	0	0	1	2
17260	516830	1	0	1	0	1	2
36311	377863	24	3	0	0	1	4
36311	377876	12	0	3	0	0	3
36311	377906	12	1	1	0	0	2
36311	84201	12	0	4	0	0	4
36311	377937	10	1	1	0	0	2
36311	199272	8	0	0	1	1	2
36311	377865	8	4	2	0	1	7
36311	194143	6	2	0	0	0	2
36311	278416	6	2	1	1	0	4
36311	377875	6	3	2	0	2	7
36311	377880	6	0	1	0	1	2
36311	377884	6	0	1	0	0	1
36311	377916	6	0	1	2	0	3
36311	377919	6	0	2	0	0	2
36311	377923	6	1	2	0	0	3
36311	377926	6	1	1	0	0	2
36311	193845	5	1	1	0	0	2
36311	215223	5	1	0	0	0	1
36311	278417	5	0	2	0	1	3
36311	377878	5	2	3	0	0	5
36311	377883	5	3	2	0	0	5
36311	377898	5	5	5	0	0	10
36311	377901	5	1	2	0	0	3
36311	377912	5	0	1	0	0	1
36311	97922	5	0	2	0	1	3
36311	206186	4	0	2	1	0	3
36311	206283	4	1	0	0	0	1
36311	215879	4	1	1	0	0	2
36311	377851	4	0	0	0	0	0
36311	377867	4	0	1	0	0	1
36311	377873	4	2	0	0	0	2
36311	377874	4	1	1	0	0	2
36311	377877	4	0	3	1	3	7
36311	377885	4	1	0	0	0	1
36311	377887	4	0	1	0	0	1
36311	377907	4	0	1	0	0	1
36311	377909	4	3	1	0	0	4
36311	377911	4	0	0	0	0	0
36311	377918	4	0	0	0	0	0
36311	377927	4	0	1	0	0	1
36311	189131	3	0	1	0	0	1
36311	201524	3	0	1	0	0	1
36311	201577	3	0	0	1	0	1
36311	202955	3	0	1	0	0	1
36311	208878	3	0	0	0	1	1
36311	278415	3	1	1	0	0	2
36311	377853	3	1	0	0	0	1
36311	377854	3	0	0	0	0	0
36311	377855	3	0	0	0	0	0
36311	377859	3	0	1	0	0	1
36311	377868	3	1	0	0	0	1
36311	377869	3	1	2	0	0	3
36311	377888	3	2	1	0	0	3
36311	377889	3	1	1	0	0	2
36311	377897	3	0	4	0	0	4
36311	377900	3	0	1	0	0	1
36311	377915	3	0	0	0	0	0
36311	377925	3	0	0	0	0	0
36311	377931	3	1	0	0	0	1
36311	377933	3	0	1	0	0	1
36311	377936	3	1	0	0	0	1
36311	79128	3	1	1	0	0	2
36311	194316	2	0	0	0	0	0
36311	204319	2	1	0	0	0	1
36311	205317	2	0	0	0	0	0
36311	207629	2	0	0	0	0	0
36311	208864	2	1	2	0	0	3
36311	278413	2	2	1	0	0	3
36311	278414	2	0	1	0	0	1
36311	377857	2	1	1	0	0	2
36311	377858	2	1	2	0	0	3
36311	377860	2	0	0	0	0	0
36311	377862	2	1	0	0	0	1
36311	377864	2	1	2	0	0	3
36311	377866	2	0	1	0	0	1
36311	377870	2	0	1	0	1	2
36311	377871	2	0	0	0	0	0
36311	377881	2	0	0	0	0	0
36311	377886	2	0	0	0	0	0
36311	377893	2	1	1	0	0	2
36311	377894	2	0	0	0	0	0
36311	377895	2	1	1	0	0	2
36311	377896	2	0	2	0	0	2
36311	377899	2	1	0	0	0	1
36311	377902	2	2	0	0	0	2
36311	377904	2	0	0	0	0	0
36311	377913	2	1	0	0	0	1
36311	377914	2	1	0	0	0	1
36311	377917	2	2	0	0	1	3
36311	377920	2	0	0	0	0	0
36311	377921	2	1	0	0	0	1
36311	377922	2	0	0	0	0	0
36311	377924	2	0	0	0	0	0
36311	377928	2	1	0	0	0	1
36311	377929	2	0	1	0	0	1
36311	377930	2	1	2	0	0	3
36311	377934	2	0	0	0	0	0
36311	377935	2	1	1	0	0	2
36311	67253	2	0	1	0	0	1
36311	79416	2	0	0	0	0	0
36311	88985	2	0	1	0	0	1
36311	185863	1	0	1	0	0	1
36311	190090	1	0	0	0	0	0
36311	201188	1	0	0	0	0	0
36311	201359	1	1	1	0	0	2
36311	217235	1	0	0	0	0	0
36311	377852	1	0	0	0	1	1
36311	377856	1	0	0	0	0	0
36311	377861	1	0	0	0	0	0
36311	377872	1	1	0	0	0	1
36311	377879	1	0	0	0	0	0
36311	377882	1	2	0	0	0	2
36311	377890	1	0	3	0	0	3
36311	377891	1	0	0	0	0	0
36311	377892	1	0	0	0	0	0
36311	377903	1	0	0	0	0	0
36311	377905	1	1	0	0	0	1
36311	377908	1	0	0	0	0	0
36311	377910	1	1	1	0	0	2
36311	377932	1	0	1	0	0	1
32543	189005	29	0	0	1	1	2
32543	604553	26	1	4	1	3	9
32543	604554	26	1	4	1	3	9
32543	604577	13	0	2	1	2	5
32543	604599	13	2	2	2	5	11
32543	604624	13	1	3	1	0	5
32543	291770	12	1	1	1	0	3
32543	604579	12	1	1	1	0	3
32543	604572	11	0	0	1	6	7
32543	291768	10	1	0	0	3	4
32543	188756	9	2	1	0	2	5
32543	604552	9	1	1	0	4	6
32543	604561	9	0	0	0	0	0
32543	604594	9	3	1	1	0	5
32543	604611	9	1	0	0	1	2
32543	291773	8	2	1	0	2	5
32543	604559	8	0	0	0	0	0
32543	604603	8	0	1	0	1	2
32543	604630	8	0	0	0	0	0
32543	198680	7	1	0	0	1	2
32543	604563	7	5	2	0	1	8
32543	604575	7	1	0	0	2	3
32543	604588	7	0	2	0	3	5
32543	604610	7	1	0	0	2	3
32543	604619	7	2	2	0	1	5
32543	604620	7	1	0	0	4	5
32543	604622	7	0	0	0	0	0
32543	214571	6	0	2	1	0	3
32543	291766	6	0	1	0	1	2
32543	604551	6	0	1	1	1	3
32543	604565	6	1	0	0	1	2
32543	604584	6	2	0	0	1	3
32543	604587	6	1	0	0	3	4
32543	604609	6	1	0	0	4	5
32543	604612	6	1	2	0	0	3
32543	604618	6	0	2	1	0	3
32543	184811	5	0	1	0	3	4
32543	186239	5	0	1	0	1	2
32543	191596	5	0	0	1	0	1
32543	192636	5	1	1	1	0	3
32543	193576	5	1	2	1	2	6
32543	220593	5	1	0	0	3	4
32543	291767	5	1	0	0	3	4
32543	291771	5	3	2	0	0	5
32543	291772	5	1	1	1	0	3
32543	604560	5	1	0	1	1	3
32543	604573	5	0	0	1	0	1
32543	604578	5	0	0	0	2	2
32543	604583	5	1	1	1	0	3
32543	604596	5	2	0	0	3	5
32543	604602	5	1	2	0	2	5
32543	604605	5	1	1	1	1	4
32543	604626	5	1	1	0	1	3
32543	604627	5	0	2	1	1	4
32543	604629	5	3	0	0	4	7
32543	207989	4	0	0	0	1	1
32543	218282	4	1	0	1	1	3
32543	291769	4	0	1	0	3	4
32543	604555	4	1	1	0	1	3
32543	604567	4	2	1	0	1	4
32543	604569	4	1	1	0	2	4
32543	604574	4	0	1	0	0	1
32543	604581	4	0	1	0	3	4
32543	604598	4	0	0	0	1	1
32543	604607	4	0	0	0	1	1
32543	604608	4	0	0	0	1	1
32543	604617	4	0	0	0	0	0
32543	604623	4	1	1	1	3	6
32543	185896	3	0	0	0	1	1
32543	193276	3	0	1	0	0	1
32543	193691	3	1	1	1	1	4
32543	201266	3	1	0	1	2	4
32543	291765	3	1	1	0	1	3
32543	604550	3	2	1	0	0	3
32543	604558	3	0	2	0	0	2
32543	604562	3	0	1	0	0	1
32543	604568	3	1	0	0	2	3
32543	604571	3	1	0	0	3	4
32543	604576	3	0	0	0	0	0
32543	604580	3	0	0	0	0	0
32543	604585	3	1	0	0	4	5
32543	604589	3	1	0	0	1	2
32543	604593	3	2	1	1	0	4
32543	604597	3	2	0	0	0	2
32543	604604	3	0	0	1	0	1
32543	604625	3	0	0	0	1	1
32543	604628	3	2	0	0	2	4
32543	184241	2	0	1	0	1	2
32543	206407	2	0	0	2	0	2
32543	211220	2	1	0	0	1	2
32543	604564	2	1	1	0	1	3
32543	604566	2	0	0	1	1	2
32543	604570	2	1	1	0	2	4
32543	604582	2	0	1	0	1	2
32543	604590	2	1	1	0	2	4
32543	604591	2	2	1	0	0	3
32543	604595	2	0	1	0	1	2
32543	604600	2	1	0	0	1	2
32543	604601	2	0	2	0	2	4
32543	604606	2	0	1	0	0	1
32543	604613	2	0	1	0	0	1
32543	604614	2	0	0	3	0	3
32543	604615	2	0	0	1	0	1
32543	604621	2	0	0	0	1	1
32543	604631	2	0	1	0	0	1
32543	604632	2	0	0	0	2	2
32543	604633	2	1	0	0	1	2
32543	604634	2	0	0	1	0	1
32543	604635	2	0	1	0	2	3
32543	190511	1	0	0	0	1	1
32543	192796	1	0	0	0	3	3
32543	604547	1	1	0	0	0	1
32543	604548	1	0	1	0	0	1
32543	604549	1	0	0	0	0	0
32543	604556	1	0	0	0	0	0
32543	604557	1	0	0	0	2	2
32543	604586	1	0	0	0	2	2
32543	604592	1	0	0	0	1	1
32543	604616	1	0	1	0	1	2
32543	604636	1	1	0	0	1	2
43865	614147	20	4	1	1	0	6
43865	614146	16	2	5	0	1	8
43865	614174	16	0	0	0	0	0
43865	614138	14	2	2	2	0	6
43865	614152	14	3	0	0	2	5
43865	614193	12	1	0	0	0	1
43865	614203	11	3	1	0	1	5
43865	527008	10	0	0	1	3	4
43865	614190	10	0	2	0	0	2
43865	614145	9	2	0	0	3	5
43865	614179	9	6	2	0	0	8
43865	614148	8	2	2	0	1	5
43865	614151	8	3	0	0	0	3
43865	614155	8	0	1	0	2	3
43865	614137	7	2	2	0	1	5
43865	614144	7	2	0	0	0	2
43865	614225	7	0	0	1	2	3
43865	294981	6	2	1	3	1	7
43865	614186	6	1	0	0	0	1
43865	614198	6	4	0	0	0	4
43865	614215	6	0	0	0	0	0
43865	614232	6	1	0	0	0	1
43865	614234	6	4	0	0	0	4
43865	90914	6	2	1	3	1	7
43865	205405	5	5	1	0	0	6
43865	294982	5	2	1	0	0	3
43865	527009	5	0	0	0	4	4
43865	614133	5	3	1	1	0	5
43865	614153	5	2	1	0	0	3
43865	614164	5	1	0	1	0	2
43865	614165	5	0	0	0	1	1
43865	614169	5	1	0	0	0	1
43865	614181	5	0	0	0	1	1
43865	614182	5	4	1	0	1	6
43865	614185	5	2	0	0	3	5
43865	614202	5	0	2	0	0	2
43865	614204	5	1	0	0	0	1
43865	614206	5	4	1	2	0	7
43865	614211	5	1	0	0	1	2
43865	614213	5	0	4	1	1	6
43865	614214	5	3	0	0	0	3
43865	614224	5	3	0	0	0	3
43865	614229	5	0	1	0	0	1
43865	527007	4	0	0	1	2	3
43865	614141	4	0	0	0	0	0
43865	614180	4	2	1	0	0	3
43865	614197	4	1	0	0	0	1
43865	614208	4	0	0	0	0	0
43865	614219	4	2	2	0	2	6
43865	614221	4	0	0	0	0	0
43865	614226	4	0	1	0	1	2
43865	614227	4	0	0	0	0	0
43865	614228	4	2	1	0	0	3
43865	614233	4	0	0	0	0	0
43865	189666	3	4	0	1	0	5
43865	207660	3	4	2	0	0	6
43865	208265	3	2	0	0	0	2
43865	527010	3	0	0	0	0	0
43865	614136	3	1	0	0	0	1
43865	614150	3	1	0	0	0	1
43865	614161	3	1	0	2	0	3
43865	614167	3	0	0	0	0	0
43865	614172	3	2	1	0	0	3
43865	614175	3	0	1	0	1	2
43865	614176	3	2	1	0	0	3
43865	614177	3	3	0	0	0	3
43865	614178	3	0	0	0	0	0
43865	614191	3	1	0	0	1	2
43865	614194	3	0	0	0	0	0
43865	614195	3	1	0	0	0	1
43865	614199	3	3	0	0	0	3
43865	614209	3	2	0	1	0	3
43865	614212	3	2	0	0	0	2
43865	614230	3	1	0	0	0	1
43865	189819	2	0	1	0	0	1
43865	200055	2	2	0	0	0	2
43865	527006	2	2	0	1	0	3
43865	614134	2	2	0	0	0	2
43865	614139	2	1	0	0	0	1
43865	614140	2	0	1	0	0	1
43865	614149	2	3	1	0	0	4
43865	614154	2	0	0	0	0	0
43865	614157	2	0	0	0	0	0
43865	614158	2	1	0	0	0	1
43865	614159	2	1	0	0	0	1
43865	614160	2	2	1	0	0	3
43865	614162	2	1	0	1	0	2
43865	614170	2	2	0	0	0	2
43865	614171	2	2	0	0	1	3
43865	614173	2	0	0	0	0	0
43865	614184	2	1	0	0	0	1
43865	614187	2	3	1	0	0	4
43865	614196	2	1	0	0	0	1
43865	614200	2	2	0	0	0	2
43865	614216	2	1	1	0	0	2
43865	614217	2	1	0	0	0	1
43865	614218	2	0	1	0	0	1
43865	614220	2	1	1	0	0	2
43865	614223	2	3	0	0	0	3
43865	614231	2	1	0	0	1	2
43865	183471	1	1	0	0	0	1
43865	213395	1	3	0	0	0	3
43865	220981	1	0	1	0	0	1
43865	614135	1	3	0	0	0	3
43865	614142	1	2	1	0	0	3
43865	614143	1	1	1	0	0	2
43865	614156	1	0	0	0	0	0
43865	614163	1	1	0	0	0	1
43865	614166	1	2	1	0	0	3
43865	614168	1	1	0	0	0	1
43865	614183	1	1	0	0	0	1
43865	614188	1	1	0	0	0	1
43865	614189	1	1	0	0	0	1
43865	614192	1	0	0	0	0	0
43865	614201	1	1	0	0	0	1
43865	614205	1	2	0	0	0	2
43865	614207	1	0	0	0	1	1
43865	614210	1	0	1	0	0	1
43865	614222	1	4	1	0	0	5
10213	451045	13	1	1	0	0	2
10213	451106	12	2	1	0	0	3
10213	451060	10	1	2	0	0	3
10213	451071	10	5	0	0	0	5
10213	451087	9	5	0	0	0	5
10213	451063	7	4	1	0	0	5
10213	451103	7	1	2	0	1	4
10213	451119	7	1	1	1	1	4
10213	186063	6	2	2	1	0	5
10213	215873	6	1	0	0	0	1
10213	451064	6	1	0	0	0	1
10213	451069	6	1	0	1	1	3
10213	451079	6	2	0	0	0	2
10213	451102	6	1	0	0	0	1
10213	206606	5	4	1	1	0	6
10213	276014	5	0	0	0	0	0
10213	276015	5	0	0	0	1	1
10213	451043	5	2	0	0	0	2
10213	451067	5	5	0	0	0	5
10213	451076	5	4	0	0	0	4
10213	451084	5	1	0	0	1	2
10213	451092	5	0	0	0	0	0
10213	451095	5	2	0	1	0	3
10213	451097	5	0	2	0	1	3
10213	451098	5	0	1	0	0	1
10213	451114	5	0	1	1	1	3
10213	451136	5	1	1	0	0	2
10213	451147	5	1	2	0	0	3
10213	215983	4	1	0	0	3	4
10213	276011	4	0	0	0	0	0
10213	451044	4	1	2	0	0	3
10213	451047	4	3	0	0	0	3
10213	451048	4	1	0	0	0	1
10213	451052	4	1	0	0	1	2
10213	451054	4	3	0	0	1	4
10213	451065	4	1	0	0	0	1
10213	451068	4	1	0	0	0	1
10213	451074	4	3	0	1	0	4
10213	451085	4	0	0	1	0	1
10213	451088	4	0	0	0	0	0
10213	451099	4	1	1	0	0	2
10213	451101	4	0	1	0	1	2
10213	451111	4	1	1	0	0	2
10213	451112	4	1	0	0	0	1
10213	451113	4	0	0	0	0	0
10213	451117	4	1	1	0	0	2
10213	451122	4	1	0	1	0	2
10213	451131	4	2	1	0	0	3
10213	451133	4	2	1	0	0	3
10213	451137	4	3	2	0	1	6
10213	451145	4	0	1	0	0	1
10213	202958	3	2	0	0	0	2
10213	205532	3	1	1	0	1	3
10213	276013	3	1	0	0	2	3
10213	451049	3	4	0	0	0	4
10213	451055	3	2	0	0	0	2
10213	451056	3	0	0	0	0	0
10213	451058	3	1	0	0	0	1
10213	451062	3	2	0	0	0	2
10213	451066	3	0	1	0	0	1
10213	451070	3	0	1	0	0	1
10213	451072	3	0	0	0	0	0
10213	451073	3	2	0	0	0	2
10213	451083	3	0	0	0	0	0
10213	451086	3	1	0	0	0	1
10213	451090	3	1	0	0	0	1
10213	451091	3	3	0	0	0	3
10213	451093	3	3	1	0	0	4
10213	451096	3	3	0	0	2	5
10213	451104	3	1	0	0	0	1
10213	451107	3	1	1	0	0	2
10213	451110	3	1	0	0	0	1
10213	451118	3	1	0	0	0	1
10213	451121	3	4	0	0	0	4
10213	451127	3	2	0	0	0	2
10213	451129	3	0	0	0	0	0
10213	451130	3	0	0	0	0	0
10213	451138	3	1	1	0	0	2
10213	451143	3	3	0	1	0	4
10213	451148	3	0	1	0	0	1
10213	451050	2	0	1	0	0	1
10213	451051	2	1	0	0	0	1
10213	451053	2	3	0	0	0	3
10213	451059	2	0	1	0	0	1
10213	451061	2	0	0	0	0	0
10213	451077	2	1	0	0	0	1
10213	451078	2	0	0	0	0	0
10213	451080	2	2	0	0	0	2
10213	451089	2	1	0	0	1	2
10213	451094	2	2	0	0	0	2
10213	451100	2	0	0	0	1	1
10213	451105	2	1	2	0	0	3
10213	451108	2	0	0	0	0	0
10213	451109	2	1	0	0	0	1
10213	451115	2	0	0	0	0	0
10213	451116	2	1	0	0	0	1
10213	451120	2	3	1	0	0	4
10213	451123	2	0	0	0	0	0
10213	451124	2	1	0	0	0	1
10213	451125	2	0	1	0	0	1
10213	451126	2	0	1	0	1	2
10213	451134	2	1	1	0	0	2
10213	451139	2	1	0	0	0	1
10213	451140	2	0	0	0	0	0
10213	451142	2	1	1	0	0	2
10213	451144	2	3	0	0	0	3
10213	451146	2	0	1	0	0	1
10213	191183	1	1	1	0	0	2
10213	276012	1	0	0	0	0	0
10213	451046	1	0	0	0	3	3
10213	451057	1	1	0	0	0	1
10213	451075	1	0	0	0	0	0
10213	451081	1	1	0	0	0	1
10213	451082	1	1	0	0	0	1
10213	451128	1	0	0	0	0	0
10213	451132	1	1	0	0	0	1
10213	451135	1	0	1	0	0	1
10213	451141	1	4	0	0	0	4
36568	202329	31	1	7	0	3	11
36568	292915	30	1	7	0	3	11
36568	185418	27	3	1	2	0	6
36568	488136	22	3	1	2	0	6
36568	488117	18	0	1	0	0	1
36568	187395	17	2	2	1	1	6
36568	488094	14	2	3	1	0	6
36568	186036	12	1	2	0	1	4
36568	221387	12	1	1	1	0	3
36568	488107	12	2	0	0	0	2
36568	488106	11	2	3	0	2	7
36568	488115	11	1	2	0	0	3
36568	292925	10	0	0	1	0	1
36568	488114	10	0	3	0	0	3
36568	488129	10	1	4	1	2	8
36568	216101	9	1	0	1	0	2
36568	292926	9	1	0	1	0	2
36568	488104	9	0	0	0	0	0
36568	183285	8	1	1	0	1	3
36568	292916	8	1	4	1	3	9
36568	292930	8	1	0	1	0	2
36568	292932	8	0	0	0	0	0
36568	488088	8	1	4	1	3	9
36568	488092	8	1	1	1	0	3
36568	488134	8	1	0	1	0	2
36568	488137	8	2	4	0	0	6
36568	488095	7	1	2	0	1	4
36568	488110	7	1	0	0	0	1
36568	195492	6	0	4	0	0	4
36568	204233	6	1	2	0	0	3
36568	205847	6	0	2	0	0	2
36568	292914	6	1	3	0	0	4
36568	292924	6	0	0	0	0	0
36568	488093	6	2	1	0	0	3
36568	488103	6	0	0	0	0	0
36568	488123	6	0	3	1	0	4
36568	488135	6	4	1	0	0	5
36568	189773	5	0	0	0	0	0
36568	197284	5	1	3	0	0	4
36568	200495	5	0	0	0	0	0
36568	207255	5	0	1	0	0	1
36568	292917	5	0	2	0	3	5
36568	488082	5	1	1	0	1	3
36568	488085	5	1	1	0	0	2
36568	488087	5	0	2	0	1	3
36568	488091	5	0	0	0	0	0
36568	488096	5	2	0	0	0	2
36568	488102	5	0	0	0	0	0
36568	488105	5	1	3	0	0	4
36568	488108	5	0	1	0	0	1
36568	488116	5	0	1	1	0	2
36568	488118	5	0	0	0	0	0
36568	488122	5	2	0	0	0	2
36568	488126	5	1	2	0	0	3
36568	488127	5	0	0	0	0	0
36568	185789	4	0	1	0	0	1
36568	186951	4	0	3	0	0	3
36568	193627	4	0	1	0	0	1
36568	195618	4	0	1	0	0	1
36568	197810	4	0	0	0	1	1
36568	201847	4	0	1	0	0	1
36568	221120	4	0	1	0	2	3
36568	292921	4	1	2	0	0	3
36568	488098	4	0	1	0	1	2
36568	488101	4	0	1	0	0	1
36568	488113	4	1	1	0	0	2
36568	488119	4	0	1	0	0	1
36568	488120	4	2	3	0	0	5
36568	488124	4	1	2	0	0	3
36568	488133	4	1	1	0	0	2
36568	184377	3	0	1	0	0	1
36568	194760	3	0	2	0	0	2
36568	201606	3	1	1	0	0	2
36568	203110	3	1	0	0	0	1
36568	208327	3	0	0	0	0	0
36568	211649	3	0	0	0	1	1
36568	214324	3	1	0	0	0	1
36568	214365	3	1	1	0	0	2
36568	292913	3	0	1	0	1	2
36568	292918	3	0	3	0	0	3
36568	292919	3	0	2	0	0	2
36568	292923	3	1	1	0	0	2
36568	292927	3	0	0	0	1	1
36568	292928	3	0	0	0	0	0
36568	292929	3	1	1	0	0	2
36568	292931	3	1	1	0	0	2
36568	488083	3	0	2	0	0	2
36568	488089	3	3	3	0	1	7
36568	488099	3	1	0	0	0	1
36568	488100	3	1	1	0	0	2
36568	488111	3	0	1	0	0	1
36568	488121	3	0	3	0	0	3
36568	488131	3	1	2	0	0	3
36568	183813	2	2	1	0	0	3
36568	186935	2	0	1	0	0	1
36568	191218	2	0	1	0	0	1
36568	198119	2	0	1	0	0	1
36568	204843	2	0	0	0	0	0
36568	205432	2	1	1	0	0	2
36568	211987	2	0	0	0	0	0
36568	213848	2	1	1	0	0	2
36568	220248	2	0	2	0	0	2
36568	292920	2	0	3	0	0	3
36568	292922	2	0	1	0	0	1
36568	488080	2	0	0	0	0	0
36568	488084	2	0	1	0	0	1
36568	488086	2	0	1	0	0	1
36568	488097	2	0	0	0	0	0
36568	488109	2	0	3	0	0	3
36568	488112	2	0	0	0	0	0
36568	488125	2	0	2	0	0	2
36568	208456	1	0	0	0	0	0
36568	218634	1	0	0	0	0	0
36568	488081	1	0	0	0	0	0
36568	488090	1	1	3	0	0	4
36568	488128	1	0	0	0	0	0
36568	488130	1	1	0	0	1	2
36568	488132	1	0	0	0	0	0
66791	301056	48	2	7	1	2	12
66791	74535	48	2	7	1	2	12
66791	591829	47	1	4	1	1	7
66791	591806	18	0	4	0	2	6
66791	104221	16	0	1	0	6	7
66791	301071	16	0	1	0	6	7
66791	591815	16	0	1	0	6	7
66791	591813	15	2	4	0	2	8
66791	591818	15	2	2	0	3	7
66791	301049	14	2	1	0	1	4
66791	56723	14	2	1	0	1	4
66791	301047	13	1	3	1	1	6
66791	591799	13	3	0	1	2	6
66791	80298	13	1	3	1	1	6
66791	301089	12	2	2	2	1	7
66791	56413	12	2	2	2	1	7
66791	301054	10	3	1	1	2	7
66791	591812	10	1	3	0	2	6
66791	66022	10	3	1	1	2	7
66791	301046	9	2	0	1	0	3
66791	301074	8	4	1	1	0	6
66791	301082	8	1	0	0	1	2
66791	51136	8	1	0	0	1	2
66791	52576	8	4	1	1	0	6
66791	101207	7	2	2	0	1	5
66791	301052	7	0	0	0	1	1
66791	301061	7	2	2	0	1	5
66791	301081	7	3	2	0	1	6
66791	591800	7	5	2	0	3	10
66791	591805	7	1	5	0	6	12
66791	591821	7	1	3	0	1	5
66791	591826	7	1	1	0	4	6
66791	64663	7	0	0	0	1	1
66791	86659	7	3	2	0	1	6
66791	106571	6	0	1	0	1	2
66791	301055	6	0	3	1	2	6
66791	301059	6	2	4	0	2	8
66791	301060	6	0	1	0	1	2
66791	301076	6	2	1	0	0	3
66791	591809	6	1	4	0	1	6
66791	591814	6	3	0	0	2	5
66791	591817	6	0	2	0	1	3
66791	591820	6	0	1	1	0	2
66791	591825	6	2	0	0	0	2
66791	70842	6	2	1	0	0	3
66791	72774	6	2	4	0	2	8
66791	98017	6	0	3	1	2	6
66791	301048	5	2	0	1	2	5
66791	301051	5	0	1	0	0	1
66791	301058	5	0	1	0	0	1
66791	301065	5	0	2	1	1	4
66791	301068	5	0	2	0	2	4
66791	301069	5	1	0	0	0	1
66791	301078	5	3	1	0	0	4
66791	301079	5	2	0	0	2	4
66791	301080	5	1	1	0	0	2
66791	301086	5	0	2	0	1	3
66791	301088	5	1	0	0	0	1
66791	49407	5	2	0	0	2	4
66791	591807	5	0	0	1	0	1
66791	591808	5	0	2	0	1	3
66791	62258	5	0	2	1	1	4
66791	84757	5	0	2	0	2	4
66791	89779	5	2	0	1	2	5
66791	90276	5	1	0	0	0	1
66791	91974	5	0	2	0	1	3
66791	94147	5	3	1	0	0	4
66791	100122	4	3	1	1	1	6
66791	101913	4	0	3	0	1	4
66791	103275	4	1	0	0	2	3
66791	301050	4	1	1	0	1	3
66791	301053	4	1	1	0	0	2
66791	301057	4	1	1	0	1	3
66791	301062	4	0	1	1	3	5
66791	301066	4	0	3	0	2	5
66791	301067	4	4	1	0	0	5
66791	301070	4	0	2	0	0	2
66791	301073	4	1	0	0	3	4
66791	301077	4	0	3	0	1	4
66791	301083	4	2	2	0	0	4
66791	301084	4	1	0	0	2	3
66791	301085	4	3	1	1	1	6
66791	301090	4	2	1	0	0	3
66791	49344	4	2	1	0	0	3
66791	54336	4	2	2	0	0	4
66791	591798	4	1	1	0	0	2
66791	591810	4	1	2	0	1	4
66791	591811	4	0	1	0	2	3
66791	591819	4	1	0	0	1	2
66791	591822	4	1	1	0	1	3
66791	591823	4	1	0	0	1	2
66791	591827	4	0	0	0	2	2
66791	91198	4	1	1	0	1	3
66791	95602	4	0	1	1	3	5
66791	98087	4	3	2	0	3	8
66791	301063	3	0	0	0	0	0
66791	301087	3	0	0	0	0	0
66791	591801	3	1	0	0	2	3
66791	591802	3	0	2	0	2	4
66791	591803	3	3	1	1	1	6
66791	591804	3	1	0	0	0	1
66791	591816	3	0	3	0	1	4
66791	591824	3	0	1	0	0	1
66791	591828	3	2	2	1	2	7
66791	591830	3	0	1	0	0	1
66791	591831	3	0	0	0	1	1
66791	591835	3	0	0	0	1	1
66791	591836	3	1	3	0	0	4
66791	62031	3	0	0	0	0	0
66791	301064	2	1	0	0	1	2
66791	301072	2	1	0	0	0	1
66791	301075	2	2	0	0	2	4
66791	591833	2	0	3	0	0	3
66791	591834	2	0	0	0	1	1
66791	79240	2	2	0	0	2	4
66791	79689	2	0	0	0	0	0
66791	86012	2	1	0	0	1	2
66791	591832	1	0	0	0	1	1
57819	298298	19	1	5	0	3	9
57819	417639	18	2	2	0	2	6
57819	200795	14	0	0	0	2	2
57819	298299	14	0	0	0	2	2
57819	417641	14	0	0	0	2	2
57819	219144	12	0	1	0	1	2
57819	417655	12	2	3	0	0	5
57819	417690	11	2	2	0	0	4
57819	417659	10	2	4	0	2	8
57819	417660	10	2	3	0	1	6
57819	417680	10	3	4	1	0	8
57819	211328	8	1	2	0	1	4
57819	298297	8	1	4	0	3	8
57819	417649	8	0	1	0	1	2
57819	417653	8	0	1	1	1	3
57819	211004	7	2	2	0	2	6
57819	417643	7	3	2	0	1	6
57819	417645	7	0	1	0	0	1
57819	417702	7	2	1	0	0	3
57819	417637	6	0	1	0	0	1
57819	417648	6	1	3	0	2	6
57819	417685	6	2	4	0	0	6
57819	417692	6	2	1	0	2	5
57819	417720	6	0	2	2	0	4
57819	298300	5	0	0	0	0	0
57819	298303	5	1	6	0	1	8
57819	417647	5	0	0	0	0	0
57819	417657	5	0	1	0	0	1
57819	417662	5	0	1	0	1	2
57819	417673	5	3	2	0	0	5
57819	417674	5	4	2	0	0	6
57819	417675	5	1	2	0	0	3
57819	417688	5	2	2	0	0	4
57819	417706	5	3	2	0	0	5
57819	417713	5	2	1	0	0	3
57819	417716	5	2	2	0	0	4
57819	417721	5	1	1	0	2	4
57819	417726	5	1	1	0	0	2
57819	417731	5	1	2	0	0	3
57819	186851	4	0	1	0	0	1
57819	187820	4	2	1	0	2	5
57819	190406	4	1	1	1	0	3
57819	417638	4	1	0	0	1	2
57819	417642	4	0	1	0	0	1
57819	417651	4	0	2	0	0	2
57819	417656	4	0	0	0	1	1
57819	417658	4	1	2	0	0	3
57819	417661	4	0	1	0	1	2
57819	417663	4	2	4	0	0	6
57819	417666	4	1	2	0	0	3
57819	417681	4	0	0	0	0	0
57819	417694	4	0	1	0	0	1
57819	417708	4	1	2	1	0	4
57819	417710	4	1	0	0	0	1
57819	417711	4	0	1	0	0	1
57819	417715	4	1	2	0	1	4
57819	417718	4	2	1	0	0	3
57819	417722	4	0	1	0	0	1
57819	417729	4	0	1	0	1	2
57819	417730	4	0	2	0	0	2
57819	417732	4	1	2	0	0	3
57819	181902	3	0	1	0	0	1
57819	417640	3	1	2	0	2	5
57819	417646	3	1	2	0	0	3
57819	417650	3	2	3	0	1	6
57819	417652	3	1	2	0	0	3
57819	417664	3	1	1	0	0	2
57819	417668	3	2	1	0	0	3
57819	417669	3	0	2	0	1	3
57819	417670	3	1	1	0	0	2
57819	417671	3	1	1	0	0	2
57819	417672	3	1	2	0	0	3
57819	417679	3	1	7	0	0	8
57819	417687	3	0	2	1	0	3
57819	417691	3	0	1	0	0	1
57819	417695	3	0	1	0	0	1
57819	417698	3	0	2	0	0	2
57819	417699	3	0	1	0	1	2
57819	417700	3	0	2	0	0	2
57819	417703	3	2	2	0	0	4
57819	417704	3	0	1	0	0	1
57819	417705	3	1	2	0	0	3
57819	417707	3	1	1	0	0	2
57819	417717	3	1	3	0	0	4
57819	417719	3	0	1	0	0	1
57819	417723	3	0	2	0	0	2
57819	417724	3	1	1	0	0	2
57819	417725	3	1	1	0	0	2
57819	417728	3	0	1	0	0	1
57819	417733	3	2	2	0	0	4
57819	417734	3	0	2	0	0	2
57819	206094	2	0	0	0	0	0
57819	216251	2	0	0	0	0	0
57819	298301	2	0	0	0	0	0
57819	417654	2	1	3	0	0	4
57819	417665	2	2	1	0	0	3
57819	417667	2	1	0	0	1	2
57819	417676	2	0	1	1	0	2
57819	417677	2	0	0	0	0	0
57819	417689	2	1	2	0	0	3
57819	417693	2	0	2	0	0	2
57819	417697	2	1	0	0	0	1
57819	417701	2	0	2	0	0	2
57819	417709	2	0	1	0	0	1
57819	417727	2	0	0	0	1	1
57819	186681	1	0	0	0	0	0
57819	188441	1	0	0	0	0	0
57819	298302	1	0	1	0	0	1
57819	417644	1	1	2	0	1	4
57819	417678	1	0	0	0	0	0
57819	417682	1	0	2	0	0	2
57819	417683	1	0	0	0	0	0
57819	417684	1	0	2	0	0	2
57819	417686	1	0	0	0	0	0
57819	417696	1	0	3	0	0	3
57819	417712	1	1	0	0	0	1
57819	417714	1	0	3	0	0	3
63711	518990	40	8	8	2	4	22
63711	518981	35	6	4	5	0	15
63711	518986	31	0	2	1	1	4
63711	518992	31	1	1	1	0	3
63711	519020	29	2	1	5	0	8
63711	67396	29	2	1	5	0	8
63711	100194	28	3	3	1	0	7
63711	70104	21	2	0	0	1	3
63711	519021	20	2	0	0	1	3
63711	189034	19	3	3	1	2	9
63711	300059	19	3	3	1	2	9
63711	518993	19	3	3	1	2	9
63711	61103	19	3	4	1	2	10
63711	222186	18	4	2	0	2	8
63711	519032	18	3	1	0	0	4
63711	518958	16	4	2	0	2	8
63711	518960	16	1	1	1	0	3
63711	519017	15	1	2	0	1	4
63711	518996	14	2	0	1	0	3
63711	188420	12	2	3	0	2	7
63711	300057	12	2	3	0	2	7
63711	518983	12	0	0	1	1	2
63711	197154	11	0	1	2	0	3
63711	518951	11	1	0	0	0	1
63711	518955	11	2	2	0	0	4
63711	518988	11	3	1	0	0	4
63711	519006	11	1	2	0	0	3
63711	519045	11	0	1	2	0	3
63711	72117	11	0	1	2	0	3
63711	518985	10	1	6	0	2	9
63711	519036	10	1	3	1	2	7
63711	519049	10	0	7	1	0	8
63711	518999	9	1	6	1	2	10
63711	519003	9	2	3	0	1	6
63711	519047	9	0	3	0	2	5
63711	518967	8	0	2	0	1	3
63711	519038	8	1	3	0	0	4
63711	519048	8	0	1	0	0	1
63711	518953	7	2	2	0	0	4
63711	518956	7	0	1	0	0	1
63711	518957	7	1	0	1	0	2
63711	519009	7	3	3	0	0	6
63711	519013	7	1	3	0	2	6
63711	519025	7	0	0	1	0	1
63711	519029	7	1	1	1	0	3
63711	519035	7	2	3	0	0	5
63711	519041	7	0	3	0	0	3
63711	519044	7	1	2	0	0	3
63711	518973	6	1	0	0	0	1
63711	518995	6	1	1	1	0	3
63711	519022	6	0	2	1	0	3
63711	519023	6	1	0	0	0	1
63711	518961	5	2	0	0	1	3
63711	518965	5	2	1	0	0	3
63711	518975	5	1	2	0	0	3
63711	518976	5	1	1	2	0	4
63711	518978	5	1	1	0	0	2
63711	518982	5	1	2	0	0	3
63711	518984	5	0	1	0	0	1
63711	518989	5	0	4	0	0	4
63711	519010	5	1	0	1	0	2
63711	519018	5	1	2	0	0	3
63711	519030	5	0	1	1	1	3
63711	519039	5	1	3	0	0	4
63711	519040	5	1	2	0	0	3
63711	102258	4	0	0	0	0	0
63711	194433	4	2	0	0	0	2
63711	300058	4	2	0	0	0	2
63711	518962	4	0	0	0	0	0
63711	518963	4	0	1	0	2	3
63711	518972	4	0	1	0	0	1
63711	518974	4	0	1	0	0	1
63711	518977	4	1	1	0	0	2
63711	518997	4	1	1	0	0	2
63711	518998	4	0	1	0	0	1
63711	519000	4	1	0	0	0	1
63711	519002	4	1	0	0	0	1
63711	519007	4	1	2	0	0	3
63711	519008	4	0	5	0	0	5
63711	519011	4	2	1	0	1	4
63711	519016	4	0	1	0	1	2
63711	519024	4	1	1	0	0	2
63711	519026	4	0	1	0	0	1
63711	519027	4	2	0	0	1	3
63711	519031	4	1	0	0	0	1
63711	519034	4	0	1	0	0	1
63711	519043	4	1	1	0	0	2
63711	519046	4	0	3	0	0	3
63711	519050	4	0	1	0	1	2
63711	519051	4	1	1	0	0	2
63711	56023	4	0	2	0	0	2
63711	68196	4	2	0	0	0	2
63711	518966	3	1	2	0	0	3
63711	518968	3	2	0	0	0	2
63711	518969	3	2	0	0	0	2
63711	518970	3	1	3	0	0	4
63711	518991	3	0	2	0	0	2
63711	518994	3	0	4	0	1	5
63711	519004	3	1	1	1	0	3
63711	519019	3	1	1	0	0	2
63711	518952	2	1	1	0	0	2
63711	518971	2	0	1	0	0	1
63711	518979	2	0	1	0	1	2
63711	518980	2	0	1	0	0	1
63711	518987	2	0	1	0	0	1
63711	519001	2	1	2	0	0	3
63711	519005	2	0	1	0	0	1
63711	519012	2	0	1	0	0	1
63711	519015	2	1	0	0	0	1
63711	519033	2	0	0	0	0	0
63711	519042	2	0	1	0	1	2
63711	518954	1	0	2	0	0	2
63711	518959	1	1	0	0	0	1
63711	518964	1	1	0	0	0	1
63711	519014	1	0	2	0	0	2
63711	519028	1	0	0	0	0	0
63711	519037	1	0	3	0	0	3
46010	220529	42	0	8	0	1	9
46010	295502	30	3	2	1	1	7
46010	528857	25	3	2	1	1	7
46010	77325	21	3	2	0	1	6
46010	528852	16	2	1	0	0	3
46010	196490	14	1	3	0	0	4
46010	528868	13	1	0	3	0	4
46010	202679	11	0	1	1	0	2
46010	528856	11	0	3	0	1	4
46010	528861	10	1	1	1	1	4
46010	104190	9	2	3	0	3	8
46010	217006	9	2	3	0	3	8
46010	295504	9	2	3	0	3	8
46010	474099	9	4	0	0	0	4
46010	528859	9	1	0	1	0	2
46010	528865	9	2	3	0	3	8
46010	204017	7	0	1	0	1	2
46010	214790	7	2	1	0	0	3
46010	295498	7	3	2	1	1	7
46010	474075	7	1	2	0	0	3
46010	474105	7	2	1	0	0	3
46010	474112	7	1	0	0	0	1
46010	474115	7	1	1	0	0	2
46010	474129	7	2	1	0	2	5
46010	528860	7	0	0	1	1	2
46010	528866	7	1	0	0	0	1
46010	90242	7	3	2	1	1	7
46010	101126	6	0	2	0	0	2
46010	102145	6	2	1	0	0	3
46010	295493	6	1	0	0	1	2
46010	295501	6	2	1	0	0	3
46010	295503	6	0	2	0	0	2
46010	474082	6	1	4	0	0	5
46010	195784	5	0	0	0	0	0
46010	205799	5	1	2	1	0	4
46010	474073	5	1	0	0	0	1
46010	474092	5	0	0	0	0	0
46010	474094	5	0	1	0	0	1
46010	474114	5	0	1	0	0	1
46010	474120	5	1	1	0	0	2
46010	474131	5	1	1	0	0	2
46010	528863	5	1	1	0	0	2
46010	295497	4	0	1	0	0	1
46010	295499	4	0	0	0	1	1
46010	474069	4	0	1	0	0	1
46010	474093	4	0	1	1	0	2
46010	474098	4	1	0	0	0	1
46010	474101	4	0	0	0	0	0
46010	474103	4	0	0	0	0	0
46010	474104	4	2	0	0	0	2
46010	474123	4	2	4	0	2	8
46010	474125	4	0	0	0	0	0
46010	528858	4	1	3	1	1	6
46010	528862	4	0	2	1	0	3
46010	528869	4	2	0	0	1	3
46010	79181	4	0	0	0	1	1
46010	90928	4	0	1	0	0	1
46010	295491	3	0	1	0	0	1
46010	295492	3	1	1	0	0	2
46010	295494	3	0	0	0	0	0
46010	295496	3	1	1	0	0	2
46010	474070	3	0	2	0	0	2
46010	474076	3	0	1	0	0	1
46010	474077	3	3	2	0	0	5
46010	474085	3	0	1	0	0	1
46010	474086	3	0	0	0	0	0
46010	474091	3	0	0	0	0	0
46010	474097	3	2	2	0	0	4
46010	474106	3	1	2	0	1	4
46010	474107	3	1	2	0	1	4
46010	474109	3	1	0	0	0	1
46010	474126	3	2	2	0	0	4
46010	474127	3	1	1	2	0	4
46010	474128	3	1	1	0	1	3
46010	49400	3	1	1	0	0	2
46010	528851	3	0	3	0	0	3
46010	528854	3	0	1	0	0	1
46010	528855	3	0	0	0	0	0
46010	528867	3	0	0	1	0	1
46010	91961	3	0	0	0	0	0
46010	295495	2	0	1	0	0	1
46010	474067	2	0	0	0	1	1
46010	474072	2	0	1	0	0	1
46010	474078	2	0	2	0	0	2
46010	474080	2	0	1	0	0	1
46010	474081	2	0	0	0	0	0
46010	474083	2	0	0	0	0	0
46010	474087	2	0	2	0	0	2
46010	474088	2	0	1	0	0	1
46010	474095	2	0	0	0	0	0
46010	474100	2	0	2	0	0	2
46010	474108	2	0	0	0	0	0
46010	474111	2	0	1	1	1	3
46010	474116	2	1	3	0	0	4
46010	474117	2	0	0	0	0	0
46010	474118	2	0	2	0	1	3
46010	474119	2	0	1	0	0	1
46010	474121	2	0	1	0	1	2
46010	474124	2	0	1	0	1	2
46010	474130	2	0	2	0	1	3
46010	528850	2	0	0	0	1	1
46010	528864	2	0	1	0	0	1
46010	95588	2	0	1	0	0	1
46010	295500	1	0	1	0	0	1
46010	474068	1	0	2	0	0	2
46010	474071	1	0	0	0	0	0
46010	474074	1	0	0	2	0	2
46010	474079	1	0	2	0	0	2
46010	474084	1	1	0	0	1	2
46010	474089	1	0	2	0	1	3
46010	474090	1	0	0	0	0	0
46010	474096	1	0	1	0	1	2
46010	474102	1	0	1	0	0	1
46010	474110	1	0	0	1	0	1
46010	474113	1	0	2	1	0	3
46010	474122	1	0	0	0	0	0
46010	528853	1	0	0	0	0	0
56528	425592	11	6	2	0	0	8
56528	425626	11	1	0	0	2	3
56528	425572	9	3	0	0	0	3
56528	425590	9	0	0	0	0	0
56528	425585	8	1	2	0	1	4
56528	587120	8	4	0	0	0	4
56528	425570	7	3	3	0	0	6
56528	425622	7	0	0	0	0	0
56528	425632	7	2	1	0	0	3
56528	425640	7	1	0	0	0	1
56528	425648	7	0	0	0	0	0
56528	425658	7	1	0	0	1	2
56528	425659	7	2	1	0	1	4
56528	298002	6	0	0	0	1	1
56528	425578	6	1	0	0	0	1
56528	425582	6	0	0	0	0	0
56528	425601	6	1	1	0	0	2
56528	425613	6	2	0	0	0	2
56528	425656	6	1	0	0	0	1
56528	425660	6	4	0	0	0	4
56528	425666	6	1	0	0	0	1
56528	425577	5	1	0	0	0	1
56528	425589	5	3	0	0	0	3
56528	425604	5	0	0	0	0	0
56528	425609	5	3	0	0	1	4
56528	425611	5	1	1	0	0	2
56528	425629	5	1	1	0	0	2
56528	425661	5	3	0	1	0	4
56528	425667	5	3	0	0	0	3
56528	425668	5	2	2	0	0	4
56528	297999	4	3	0	1	0	4
56528	425574	4	2	1	0	0	3
56528	425580	4	0	0	0	0	0
56528	425591	4	3	0	0	0	3
56528	425594	4	2	0	0	0	2
56528	425606	4	1	1	0	1	3
56528	425608	4	1	0	0	1	2
56528	425615	4	3	0	0	0	3
56528	425616	4	4	0	0	0	4
56528	425619	4	1	0	0	0	1
56528	425633	4	2	1	0	0	3
56528	425635	4	1	1	0	0	2
56528	425639	4	2	0	0	0	2
56528	425641	4	2	0	0	0	2
56528	425642	4	2	0	0	0	2
56528	425644	4	1	0	0	1	2
56528	425646	4	0	0	0	0	0
56528	425651	4	0	0	0	0	0
56528	425652	4	0	0	0	0	0
56528	425657	4	3	1	0	0	4
56528	425664	4	2	0	0	0	2
56528	587119	4	1	1	1	0	3
56528	219956	3	1	0	0	0	1
56528	425568	3	1	0	0	0	1
56528	425569	3	1	0	0	0	1
56528	425575	3	0	0	0	1	1
56528	425576	3	3	1	0	0	4
56528	425581	3	1	0	0	0	1
56528	425586	3	1	2	0	0	3
56528	425587	3	2	0	0	0	2
56528	425596	3	0	1	0	0	1
56528	425598	3	2	0	0	0	2
56528	425599	3	2	0	0	0	2
56528	425600	3	1	0	0	0	1
56528	425605	3	2	0	0	0	2
56528	425610	3	1	0	0	0	1
56528	425617	3	2	0	0	1	3
56528	425623	3	1	0	0	1	2
56528	425624	3	2	0	1	0	3
56528	425625	3	1	0	0	1	2
56528	425627	3	2	1	0	0	3
56528	425630	3	1	2	0	0	3
56528	425634	3	0	0	0	0	0
56528	425638	3	1	0	0	1	2
56528	425643	3	1	1	0	0	2
56528	425650	3	0	2	0	0	2
56528	425655	3	1	0	0	0	1
56528	425663	3	3	0	0	0	3
56528	425665	3	3	0	0	0	3
56528	425670	3	0	0	0	0	0
56528	425671	3	0	1	0	2	3
56528	208612	2	3	0	0	0	3
56528	298000	2	0	1	1	1	3
56528	298001	2	2	0	0	0	2
56528	425579	2	0	0	0	0	0
56528	425583	2	0	0	0	0	0
56528	425593	2	4	0	0	0	4
56528	425595	2	0	0	0	0	0
56528	425597	2	2	0	0	0	2
56528	425607	2	2	0	0	0	2
56528	425614	2	2	1	0	0	3
56528	425618	2	0	0	0	1	1
56528	425620	2	1	0	0	0	1
56528	425621	2	0	0	0	0	0
56528	425636	2	1	1	0	0	2
56528	425637	2	0	0	1	1	2
56528	425645	2	0	1	0	0	1
56528	425647	2	0	0	0	0	0
56528	425649	2	3	0	0	0	3
56528	425653	2	0	0	0	0	0
56528	425654	2	1	0	0	0	1
56528	425669	2	4	0	0	0	4
56528	587118	2	2	0	0	1	3
56528	189677	1	1	0	0	0	1
56528	206275	1	1	0	0	0	1
56528	216248	1	0	0	0	0	0
56528	216250	1	0	0	0	1	1
56528	425573	1	2	0	0	1	3
56528	425584	1	0	0	0	0	0
56528	425588	1	0	0	0	3	3
56528	425602	1	0	0	0	0	0
56528	425603	1	0	2	0	1	3
56528	425612	1	1	0	0	1	2
56528	425628	1	1	0	0	0	1
56528	425631	1	2	3	0	0	5
56528	425662	1	0	1	0	0	1
32701	50151	55	5	9	6	1	21
32701	93060	47	5	5	3	2	15
32701	96014	46	5	7	2	2	16
32701	102710	43	4	5	3	4	16
32701	558014	39	5	7	4	1	17
32701	107524	34	1	4	1	0	6
32701	558027	34	1	4	1	0	6
32701	78463	34	3	10	4	3	20
32701	49425	33	3	8	2	1	14
32701	202413	32	0	7	1	1	9
32701	558040	31	0	7	1	1	9
32701	82776	31	0	7	1	1	9
32701	107234	30	3	4	3	0	10
32701	105989	27	0	1	4	1	6
32701	88134	27	0	2	1	0	3
32701	219627	26	0	1	4	1	6
32701	74762	25	1	2	1	1	5
32701	56938	24	2	2	0	1	5
32701	103320	23	1	3	1	0	5
32701	106981	23	2	0	5	1	8
32701	558029	23	2	0	5	1	8
32701	103536	22	1	3	4	0	8
32701	558018	22	0	4	1	0	5
32701	558030	22	0	6	1	0	7
32701	58141	22	1	7	1	1	10
32701	94492	22	0	4	1	0	5
32701	102070	21	1	6	6	0	13
32701	558020	21	1	6	6	0	13
32701	84866	21	6	3	0	0	9
32701	558023	20	5	4	0	2	11
32701	80902	20	3	6	2	1	12
32701	69993	19	1	2	3	1	7
32701	78769	19	0	4	0	2	6
32701	90128	19	0	3	2	0	5
32701	101492	18	1	7	3	2	13
32701	70634	18	1	2	2	4	9
32701	61978	17	5	7	4	0	16
32701	88568	17	2	6	2	1	11
32701	91440	17	1	2	1	1	5
32701	94348	17	3	3	1	1	8
32701	99415	17	2	8	1	0	11
32701	107439	16	4	3	1	1	9
32701	52469	16	2	3	1	1	7
32701	558022	16	1	4	2	0	7
32701	558041	16	1	3	1	0	5
32701	73990	16	1	6	2	4	13
32701	81241	16	1	3	1	0	5
32701	92800	16	1	4	2	0	7
32701	107766	15	0	4	1	0	5
32701	65343	15	3	2	1	0	6
32701	65491	15	0	1	0	0	1
32701	86522	15	0	1	0	2	3
32701	98945	15	1	3	1	0	5
32701	558017	14	2	4	1	2	9
32701	558036	14	0	1	0	2	3
32701	56313	14	1	2	2	1	6
32701	67533	14	2	3	2	2	9
32701	72078	14	2	2	0	1	5
32701	74709	14	0	3	0	1	4
32701	82036	14	1	4	0	0	5
32701	558038	13	1	3	10	0	14
32701	558043	13	1	4	0	0	5
32701	81970	13	2	3	1	0	6
32701	88296	13	0	1	0	0	1
32701	95702	13	0	5	2	1	8
32701	100227	12	0	1	1	1	3
32701	54415	12	1	2	1	0	4
32701	558024	12	1	2	1	0	4
32701	558032	12	1	0	1	1	3
32701	558033	12	1	9	2	1	13
32701	558042	12	1	2	0	0	3
32701	81027	12	3	1	0	3	7
32701	82069	12	1	2	0	1	4
32701	92724	12	1	9	2	1	13
32701	558026	11	4	6	3	0	13
32701	558039	11	3	1	0	3	7
32701	74614	11	1	4	0	0	5
32701	84206	11	1	2	0	0	3
32701	89616	11	1	3	0	2	6
32701	558028	10	0	6	0	0	6
32701	558031	10	1	4	0	0	5
32701	56314	10	1	2	1	1	5
32701	56443	10	1	1	0	0	2
32701	81810	10	0	0	0	1	1
32701	93090	10	0	6	0	0	6
32701	183132	9	2	1	0	1	4
32701	204123	9	0	1	0	0	1
32701	49411	9	1	1	3	2	7
32701	558025	9	0	3	0	0	3
32701	75609	9	3	3	0	0	6
32701	89979	9	1	1	2	0	4
32701	49846	8	2	1	0	1	4
32701	558037	8	2	1	0	1	4
32701	58718	8	0	3	0	0	3
32701	65733	8	0	1	5	2	8
32701	84350	8	0	1	0	0	1
32701	87159	8	0	1	0	0	1
32701	94532	8	1	2	1	0	4
32701	94573	8	0	4	3	0	7
32701	558035	7	0	1	0	0	1
32701	78614	7	2	5	0	0	7
32701	104454	6	1	4	2	0	7
32701	50451	6	1	1	1	1	4
32701	50665	6	2	3	1	2	8
32701	558034	6	1	4	2	0	7
32701	81825	6	0	2	0	0	2
32701	558016	5	0	1	0	0	1
32701	558019	5	1	1	1	0	3
32701	89116	5	0	3	1	0	4
32701	558021	4	2	1	0	0	3
32701	105244	3	0	3	2	0	5
32701	558013	3	0	2	0	0	2
32701	558011	2	0	0	0	0	0
32701	558012	1	0	1	0	0	1
32701	558015	1	0	0	0	0	0
32701	61761	1	0	1	0	0	1
21628	105892	21	1	1	0	0	2
21628	219338	21	1	1	0	0	2
21628	88552	20	1	1	0	0	2
21628	96192	20	0	8	0	2	10
21628	386702	16	1	3	0	1	5
21628	79462	16	1	3	0	1	5
21628	187029	15	0	4	0	0	4
21628	80714	14	3	1	0	0	4
21628	49641	11	1	1	0	0	2
21628	289030	10	0	5	2	3	10
21628	386675	10	1	3	0	0	4
21628	386696	10	2	1	0	0	3
21628	289032	9	0	1	0	0	1
21628	386692	9	1	1	0	0	2
21628	200459	8	0	0	0	0	0
21628	211251	8	5	2	0	0	7
21628	217954	8	2	1	1	0	4
21628	386679	8	0	0	0	0	0
21628	386682	8	1	1	0	0	2
21628	386685	8	3	3	0	0	6
21628	51195	8	0	2	0	0	2
21628	52747	8	0	2	0	0	2
21628	64076	8	1	3	0	0	4
21628	386672	7	2	1	0	0	3
21628	386698	7	0	3	1	0	4
21628	386710	7	2	1	0	0	3
21628	50412	7	3	5	4	6	18
21628	57126	7	1	5	0	1	7
21628	214212	6	1	0	0	0	1
21628	289022	6	0	1	0	0	1
21628	386699	6	2	0	0	0	2
21628	55856	6	1	2	0	2	5
21628	90673	6	0	1	0	0	1
21628	289027	5	0	3	0	0	3
21628	386680	5	0	1	0	2	3
21628	386693	5	0	1	0	0	1
21628	386694	5	0	1	0	0	1
21628	386700	5	0	2	0	1	3
21628	386711	5	0	5	0	1	6
21628	386714	5	2	2	0	0	4
21628	57683	5	0	1	0	1	2
21628	76580	5	0	3	0	0	3
21628	86362	5	0	1	0	1	2
21628	206883	4	0	2	0	1	3
21628	217142	4	0	0	0	0	0
21628	217994	4	1	1	0	0	2
21628	289026	4	0	1	1	0	2
21628	289029	4	0	4	0	0	4
21628	289033	4	2	2	0	0	4
21628	386666	4	1	2	0	0	3
21628	386684	4	0	1	0	1	2
21628	386689	4	0	2	0	0	2
21628	386697	4	0	2	1	0	3
21628	386701	4	2	1	0	0	3
21628	386704	4	1	3	0	0	4
21628	386707	4	1	2	0	0	3
21628	386713	4	1	2	1	0	4
21628	386715	4	2	4	0	1	7
21628	53663	4	0	4	0	0	4
21628	55386	4	0	0	0	0	0
21628	59305	4	2	0	0	0	2
21628	62897	4	2	2	0	0	4
21628	88765	4	1	3	0	0	4
21628	99231	4	1	3	0	1	5
21628	99669	4	2	0	0	0	2
21628	187062	3	0	1	0	0	1
21628	194232	3	0	0	0	0	0
21628	199042	3	0	1	0	0	1
21628	221971	3	1	1	0	1	3
21628	289023	3	0	2	0	0	2
21628	289024	3	2	1	0	0	3
21628	289028	3	0	1	0	0	1
21628	289035	3	2	1	0	0	3
21628	386667	3	1	1	0	0	2
21628	386668	3	1	0	0	0	1
21628	386669	3	0	1	0	0	1
21628	386674	3	0	4	0	0	4
21628	386676	3	1	1	0	0	2
21628	386678	3	1	2	1	0	4
21628	386683	3	0	1	0	0	1
21628	386686	3	1	0	0	0	1
21628	386688	3	0	1	0	0	1
21628	386690	3	2	1	0	0	3
21628	386706	3	0	0	0	0	0
21628	386712	3	2	1	0	0	3
21628	50498	3	0	0	0	0	0
21628	59786	3	2	1	0	0	3
21628	71191	3	0	2	0	0	2
21628	86922	3	0	4	0	0	4
21628	98600	3	0	1	0	0	1
21628	184869	2	0	1	0	0	1
21628	185352	2	0	0	0	0	0
21628	190134	2	0	1	0	0	1
21628	197811	2	0	1	0	1	2
21628	289021	2	0	0	0	0	0
21628	289031	2	0	0	0	0	0
21628	289034	2	0	1	0	0	1
21628	386664	2	3	0	0	0	3
21628	386665	2	1	2	0	0	3
21628	386671	2	0	1	0	0	1
21628	386673	2	2	2	0	0	4
21628	386677	2	2	3	0	0	5
21628	386681	2	1	3	0	0	4
21628	386695	2	2	0	0	0	2
21628	54169	2	0	1	0	0	1
21628	74376	2	0	0	0	0	0
21628	206416	1	1	2	0	0	3
21628	289025	1	0	1	0	0	1
21628	386670	1	0	0	0	0	0
21628	386687	1	0	1	0	0	1
21628	386691	1	0	2	0	0	2
21628	386703	1	0	1	0	0	1
21628	386705	1	0	1	0	0	1
21628	386708	1	1	0	0	0	1
21628	386709	1	1	0	0	0	1
69963	202277	35	5	6	2	2	15
69963	445863	34	5	6	2	2	15
69963	82927	34	5	6	2	2	15
69963	58586	30	1	5	0	0	6
69963	102246	19	0	1	2	1	4
69963	445867	15	1	1	1	0	3
69963	193812	14	2	1	1	1	5
69963	274679	13	2	1	1	1	5
69963	89072	13	2	1	1	1	5
69963	89169	13	0	3	2	5	10
69963	221563	11	1	0	0	0	1
69963	95544	11	0	1	0	0	1
69963	445878	10	0	6	0	0	6
69963	197118	9	2	2	0	1	5
69963	445872	9	1	0	0	1	2
69963	445874	9	2	5	1	0	8
69963	445919	9	1	1	1	0	3
69963	189972	8	1	3	0	3	7
69963	201724	8	0	1	2	0	3
69963	445871	8	0	3	0	0	3
69963	445913	8	1	1	0	0	2
69963	445924	8	1	5	0	0	6
69963	445876	7	0	2	0	1	3
69963	445877	7	0	0	0	0	0
69963	445905	7	2	1	0	0	3
69963	101941	6	0	3	0	0	3
69963	103017	6	0	2	0	0	2
69963	274676	6	0	2	0	0	2
69963	274682	6	0	3	0	0	3
69963	445873	6	1	2	0	0	3
69963	445881	6	1	3	0	0	4
69963	445884	6	2	0	0	1	3
69963	445886	6	2	2	0	0	4
69963	445888	6	0	0	0	0	0
69963	445896	6	0	3	0	0	3
69963	78570	6	1	3	0	0	4
69963	93027	6	1	1	0	0	2
69963	212964	5	1	2	2	2	7
69963	216646	5	0	3	0	0	3
69963	274681	5	0	0	0	0	0
69963	445864	5	3	2	0	1	6
69963	445866	5	1	3	0	0	4
69963	445869	5	0	1	0	0	1
69963	445897	5	1	1	0	1	3
69963	445903	5	1	1	0	3	5
69963	445908	5	2	1	0	2	5
69963	445911	5	1	0	0	0	1
69963	445918	5	0	0	0	1	1
69963	51574	5	1	2	2	1	6
69963	81294	5	1	4	3	1	9
69963	91247	5	0	0	0	0	0
69963	205378	4	0	0	0	1	1
69963	216871	4	1	0	0	0	1
69963	218521	4	2	3	1	1	7
69963	274675	4	1	1	0	0	2
69963	274685	4	1	1	0	0	2
69963	274686	4	2	3	1	1	7
69963	445875	4	0	1	0	0	1
69963	445880	4	0	3	0	0	3
69963	445883	4	0	1	0	1	2
69963	445887	4	2	1	0	0	3
69963	445889	4	3	3	0	0	6
69963	445890	4	0	2	0	0	2
69963	445892	4	2	1	0	0	3
69963	445894	4	1	1	0	0	2
69963	445898	4	0	1	1	0	2
69963	445899	4	1	1	0	0	2
69963	445900	4	0	2	0	0	2
69963	445904	4	1	2	0	0	3
69963	445906	4	1	1	0	1	3
69963	445907	4	0	0	0	0	0
69963	445914	4	0	1	0	0	1
69963	445915	4	1	1	0	1	3
69963	445920	4	1	1	0	0	2
69963	445921	4	0	2	0	0	2
69963	94186	4	2	3	1	1	7
69963	185688	3	1	1	0	0	2
69963	204230	3	0	1	0	0	1
69963	212593	3	0	2	0	0	2
69963	218768	3	1	0	0	0	1
69963	274677	3	0	0	0	0	0
69963	274678	3	0	0	1	1	2
69963	274683	3	0	1	0	0	1
69963	445868	3	0	1	0	0	1
69963	445882	3	0	0	0	0	0
69963	445893	3	0	2	0	0	2
69963	445895	3	0	0	1	1	2
69963	445901	3	2	2	0	1	5
69963	445902	3	1	1	0	1	3
69963	445909	3	2	2	1	0	5
69963	445910	3	1	1	0	0	2
69963	445912	3	2	1	0	0	3
69963	445916	3	1	2	0	0	3
69963	445917	3	0	0	0	0	0
69963	445922	3	1	1	0	0	2
69963	445925	3	1	1	0	0	2
69963	70943	3	0	1	0	0	1
69963	78843	3	0	0	0	0	0
69963	102245	2	0	0	0	0	0
69963	212765	2	1	0	0	0	1
69963	214818	2	0	0	0	0	0
69963	218622	2	3	0	0	0	3
69963	274680	2	0	2	0	0	2
69963	274684	2	1	1	2	0	4
69963	445870	2	0	1	0	2	3
69963	445879	2	0	1	0	2	3
69963	445885	2	0	0	0	0	0
69963	445891	2	0	1	0	0	1
69963	445923	2	1	0	0	0	1
69963	59083	2	0	2	0	0	2
69963	98521	2	1	1	2	0	4
69963	191045	1	0	1	0	0	1
69963	197175	1	0	0	0	0	0
69963	205980	1	0	0	0	0	0
69963	445865	1	1	1	0	0	2
36310	556452	23	2	0	2	2	6
36310	556394	12	7	0	0	2	9
36310	556407	12	2	0	0	1	3
36310	556426	12	6	2	2	1	11
36310	195941	11	1	0	0	1	2
36310	556446	11	3	3	0	0	6
36310	556420	10	2	0	0	0	2
36310	556410	9	2	0	1	0	3
36310	67455	9	2	0	0	1	3
36310	202954	8	2	3	0	0	5
36310	84202	8	0	0	0	0	0
36310	193846	7	2	1	0	0	3
36310	199273	7	0	0	1	0	1
36310	556465	7	3	1	0	0	4
36310	194144	6	0	2	0	0	2
36310	278418	6	4	2	0	2	8
36310	556424	6	1	0	0	2	3
36310	278420	5	2	1	0	0	3
36310	556392	5	2	1	0	0	3
36310	556395	5	1	1	0	1	3
36310	556409	5	0	0	0	0	0
36310	556415	5	1	0	0	0	1
36310	556418	5	2	2	0	0	4
36310	556419	5	2	0	0	0	2
36310	556437	5	0	4	0	0	4
36310	556439	5	3	0	0	0	3
36310	556462	5	0	2	0	0	2
36310	556463	5	3	0	0	0	3
36310	88986	5	2	1	0	0	3
36310	206181	4	1	0	1	0	2
36310	214151	4	2	0	0	0	2
36310	556396	4	2	0	0	0	2
36310	556401	4	0	0	0	0	0
36310	556425	4	0	0	0	2	2
36310	556431	4	1	0	0	0	1
36310	556441	4	2	1	0	0	3
36310	556442	4	3	2	0	0	5
36310	556444	4	1	1	0	0	2
36310	556448	4	1	1	0	1	3
36310	556456	4	2	1	0	1	4
36310	556457	4	0	1	0	0	1
36310	183108	3	0	0	0	0	0
36310	204320	3	0	0	0	0	0
36310	207338	3	2	0	0	0	2
36310	212365	3	0	1	0	0	1
36310	213965	3	0	1	0	1	2
36310	215928	3	0	0	0	0	0
36310	556385	3	0	0	0	0	0
36310	556389	3	0	2	0	0	2
36310	556390	3	0	0	0	0	0
36310	556391	3	0	0	0	0	0
36310	556393	3	0	1	0	0	1
36310	556398	3	0	0	0	0	0
36310	556400	3	4	0	0	0	4
36310	556403	3	2	0	0	0	2
36310	556404	3	1	1	0	1	3
36310	556406	3	0	1	0	0	1
36310	556411	3	1	2	0	1	4
36310	556412	3	0	0	0	0	0
36310	556417	3	3	1	0	1	5
36310	556429	3	1	0	0	0	1
36310	556432	3	0	0	0	0	0
36310	556438	3	0	1	0	0	1
36310	556440	3	0	0	0	0	0
36310	556449	3	0	1	0	2	3
36310	556451	3	0	0	0	0	0
36310	556455	3	1	0	0	0	1
36310	556458	3	0	0	1	0	1
36310	556459	3	0	0	0	0	0
36310	556466	3	0	0	0	0	0
36310	83879	3	0	1	1	1	3
36310	189132	2	1	1	0	0	2
36310	194317	2	0	0	0	0	0
36310	201539	2	1	0	0	0	1
36310	207628	2	0	0	0	0	0
36310	208879	2	1	0	0	0	1
36310	278419	2	2	1	0	0	3
36310	556384	2	0	0	0	1	1
36310	556386	2	0	1	0	0	1
36310	556399	2	0	0	0	0	0
36310	556413	2	0	1	0	0	1
36310	556416	2	1	0	0	1	2
36310	556422	2	0	0	0	0	0
36310	556433	2	0	0	0	0	0
36310	556434	2	1	0	0	0	1
36310	556436	2	1	0	0	1	2
36310	556443	2	1	0	0	0	1
36310	556450	2	0	0	0	2	2
36310	556453	2	1	0	0	0	1
36310	556454	2	0	0	0	0	0
36310	556460	2	1	0	0	0	1
36310	556464	2	1	0	0	0	1
36310	79417	2	0	0	0	0	0
36310	87820	2	2	1	0	0	3
36310	201189	1	2	0	0	0	2
36310	201383	1	0	0	0	0	0
36310	209783	1	0	0	0	0	0
36310	218999	1	0	2	0	0	2
36310	556387	1	2	0	0	0	2
36310	556388	1	0	0	0	1	1
36310	556397	1	0	0	0	0	0
36310	556402	1	0	0	0	1	1
36310	556405	1	0	0	0	0	0
36310	556408	1	0	0	0	0	0
36310	556414	1	0	0	0	1	1
36310	556421	1	2	0	0	0	2
36310	556423	1	1	0	0	1	2
36310	556427	1	0	0	0	0	0
36310	556428	1	0	0	0	0	0
36310	556430	1	1	0	0	1	2
36310	556435	1	1	0	0	0	1
36310	556445	1	1	0	0	0	1
36310	556447	1	0	1	0	1	2
36310	556461	1	0	0	0	0	0
36310	67254	1	0	0	0	0	0
19224	193836	23	2	0	6	1	9
19224	215222	17	0	0	0	0	0
19224	414488	15	2	0	0	0	2
19224	414490	15	2	5	2	2	11
19224	414498	14	2	4	4	0	10
19224	212160	12	1	0	1	0	2
19224	414479	12	1	0	1	0	2
19224	414480	12	1	0	1	0	2
19224	288330	11	5	1	2	0	8
19224	414489	11	5	1	2	0	8
19224	65949	11	5	1	2	0	8
19224	414504	10	0	3	1	0	4
19224	414516	10	2	1	1	1	5
19224	414502	9	2	0	0	0	2
19224	414518	9	0	2	1	1	4
19224	414477	8	0	1	0	1	2
19224	414499	7	0	2	2	1	5
19224	414514	7	0	2	2	0	4
19224	414521	7	1	0	0	0	1
19224	414523	7	1	0	0	1	2
19224	185295	6	0	0	2	0	2
19224	414486	6	0	0	0	0	0
19224	414487	6	1	1	2	0	4
19224	414492	6	2	1	1	3	7
19224	414542	6	0	0	0	0	0
19224	414545	6	0	0	0	0	0
19224	414483	5	0	0	1	0	1
19224	414491	5	0	0	0	2	2
19224	414493	5	0	0	0	0	0
19224	414513	5	1	0	0	1	2
19224	414517	5	1	0	2	0	3
19224	414520	5	2	1	0	3	6
19224	414528	5	1	1	1	0	3
19224	414529	5	1	1	1	0	3
19224	414533	5	1	1	1	0	3
19224	414534	5	2	1	0	0	3
19224	414544	5	0	0	2	0	2
19224	414549	5	0	0	2	0	2
19224	414550	5	1	0	0	3	4
19224	414551	5	1	0	0	0	1
19224	209631	4	2	0	0	1	3
19224	210023	4	3	0	0	1	4
19224	214125	4	1	2	1	0	4
19224	288331	4	1	0	1	0	2
19224	414469	4	4	0	1	0	5
19224	414471	4	0	0	0	1	1
19224	414472	4	0	0	0	1	1
19224	414475	4	0	0	0	0	0
19224	414476	4	0	0	1	0	1
19224	414482	4	2	0	0	0	2
19224	414485	4	0	0	0	0	0
19224	414505	4	1	0	0	0	1
19224	414507	4	1	1	1	0	3
19224	414515	4	2	1	0	2	5
19224	414522	4	0	0	1	1	2
19224	414526	4	1	0	0	0	1
19224	414527	4	1	1	1	1	4
19224	414536	4	3	0	0	1	4
19224	414538	4	1	1	1	0	3
19224	185308	3	1	1	0	0	2
19224	189193	3	1	0	0	0	1
19224	193756	3	0	0	0	0	0
19224	194372	3	0	0	1	0	1
19224	199071	3	1	0	1	0	2
19224	204797	3	1	1	0	0	2
19224	207709	3	0	0	0	0	0
19224	217842	3	1	0	0	1	2
19224	414460	3	1	0	0	0	1
19224	414465	3	1	1	0	0	2
19224	414468	3	0	0	1	0	1
19224	414474	3	0	1	0	1	2
19224	414478	3	0	0	0	3	3
19224	414484	3	0	0	0	0	0
19224	414494	3	0	0	0	0	0
19224	414496	3	1	0	1	0	2
19224	414497	3	0	1	0	0	1
19224	414500	3	0	0	2	0	2
19224	414506	3	0	0	0	0	0
19224	414519	3	2	1	0	0	3
19224	414524	3	2	0	0	0	2
19224	414530	3	0	0	1	1	2
19224	414531	3	0	0	1	0	1
19224	414537	3	0	0	0	0	0
19224	414539	3	1	1	2	2	6
19224	414541	3	3	0	0	0	3
19224	414547	3	0	1	2	1	4
19224	181944	2	1	1	0	0	2
19224	206471	2	0	0	0	0	0
19224	211232	2	0	0	0	0	0
19224	414463	2	1	0	0	1	2
19224	414464	2	0	0	0	0	0
19224	414466	2	0	0	0	0	0
19224	414467	2	2	0	0	0	2
19224	414473	2	1	0	0	0	1
19224	414481	2	1	0	0	0	1
19224	414495	2	2	0	1	0	3
19224	414503	2	1	0	0	0	1
19224	414508	2	0	2	0	0	2
19224	414509	2	0	0	0	0	0
19224	414510	2	1	0	0	0	1
19224	414511	2	1	0	0	0	1
19224	414512	2	2	0	0	0	2
19224	414525	2	1	0	1	0	2
19224	414532	2	0	1	2	0	3
19224	414540	2	1	0	0	0	1
19224	414546	2	0	0	0	0	0
19224	414458	1	0	0	0	0	0
19224	414459	1	0	1	0	1	2
19224	414461	1	1	0	0	1	2
19224	414462	1	0	1	1	0	2
19224	414470	1	0	0	0	0	0
19224	414501	1	0	0	1	0	1
19224	414535	1	1	0	0	0	1
19224	414543	1	2	2	0	0	4
19224	414548	1	0	0	1	0	1
19816	469056	11	0	0	0	0	0
19816	385114	10	0	0	0	1	1
19816	385126	10	1	1	0	0	2
19816	469055	10	1	0	0	1	2
19816	385093	9	2	0	0	3	5
19816	385138	9	2	0	0	1	3
19816	469065	8	1	0	0	1	2
19816	385091	7	1	0	0	0	1
19816	385094	7	2	0	0	1	3
19816	385095	7	1	0	0	0	1
19816	469040	7	1	0	0	0	1
19816	385100	6	2	0	0	1	3
19816	385104	6	2	0	0	0	2
19816	385113	6	0	0	0	1	1
19816	385116	6	0	0	0	2	2
19816	385137	6	1	0	0	0	1
19816	385144	6	0	0	0	0	0
19816	385151	6	0	0	0	0	0
19816	385096	5	1	0	0	1	2
19816	385105	5	0	0	0	0	0
19816	385106	5	1	0	0	1	2
19816	385110	5	2	2	0	0	4
19816	385117	5	1	0	0	0	1
19816	385121	5	1	1	0	0	2
19816	385129	5	1	0	0	0	1
19816	385134	5	0	0	0	1	1
19816	385140	5	0	0	0	1	1
19816	385149	5	0	0	0	1	1
19816	385156	5	1	0	0	0	1
19816	385158	5	1	0	0	0	1
19816	469043	5	0	0	0	1	1
19816	469047	5	0	0	0	0	0
19816	469060	5	0	0	0	0	0
19816	469061	5	1	0	0	1	2
19816	469074	5	1	0	0	1	2
19816	385097	4	1	0	1	0	2
19816	385101	4	1	0	1	0	2
19816	385111	4	1	0	0	0	1
19816	385115	4	0	0	0	0	0
19816	385118	4	1	0	1	0	2
19816	385125	4	3	0	0	1	4
19816	385128	4	2	0	0	0	2
19816	385133	4	0	0	1	1	2
19816	385135	4	1	0	0	0	1
19816	385136	4	0	0	0	0	0
19816	385152	4	0	0	0	0	0
19816	385153	4	0	0	0	0	0
19816	385154	4	0	0	0	0	0
19816	469046	4	1	0	0	0	1
19816	469066	4	0	0	0	0	0
19816	469068	4	2	0	0	2	4
19816	469075	4	0	0	0	1	1
19816	214140	3	0	0	0	0	0
19816	385099	3	0	0	0	0	0
19816	385119	3	0	0	0	1	1
19816	385122	3	0	0	0	1	1
19816	385123	3	0	0	0	0	0
19816	385124	3	1	0	0	1	2
19816	385130	3	1	0	0	0	1
19816	385131	3	1	0	0	0	1
19816	385139	3	2	0	0	0	2
19816	385142	3	1	0	0	0	1
19816	385143	3	0	0	0	0	0
19816	385145	3	0	0	0	0	0
19816	385150	3	0	0	0	0	0
19816	385155	3	0	0	0	2	2
19816	385160	3	0	0	0	0	0
19816	469044	3	0	0	0	1	1
19816	469045	3	1	0	0	1	2
19816	469049	3	3	0	0	0	3
19816	469050	3	0	0	0	1	1
19816	469052	3	0	0	0	1	1
19816	469054	3	0	0	0	0	0
19816	469062	3	0	0	0	1	1
19816	469064	3	0	0	0	0	0
19816	469067	3	1	0	0	1	2
19816	469072	3	0	0	0	0	0
19816	200013	2	1	0	0	0	1
19816	213946	2	0	0	0	0	0
19816	385092	2	0	0	1	1	2
19816	385102	2	1	0	0	1	2
19816	385107	2	0	1	0	0	1
19816	385108	2	1	0	0	0	1
19816	385109	2	0	0	0	1	1
19816	385127	2	0	0	0	0	0
19816	385147	2	2	0	0	0	2
19816	385148	2	1	0	0	0	1
19816	385157	2	2	0	0	0	2
19816	385159	2	0	0	0	0	0
19816	385161	2	1	0	0	0	1
19816	385162	2	0	0	0	0	0
19816	469039	2	1	0	0	2	3
19816	469041	2	0	0	0	0	0
19816	469042	2	1	0	0	0	1
19816	469051	2	0	0	0	0	0
19816	469053	2	0	0	0	0	0
19816	469057	2	0	0	0	0	0
19816	469058	2	1	0	0	0	1
19816	469059	2	1	0	0	1	2
19816	469063	2	0	0	0	0	0
19816	469069	2	0	0	0	1	1
19816	469076	2	0	0	0	0	0
19816	385098	1	0	0	0	0	0
19816	385103	1	0	0	0	0	0
19816	385112	1	1	0	0	1	2
19816	385120	1	0	0	0	0	0
19816	385132	1	4	0	0	1	5
19816	385141	1	0	0	0	0	0
19816	385146	1	1	0	0	0	1
19816	469037	1	0	0	0	0	0
19816	469038	1	2	0	0	0	2
19816	469048	1	1	0	0	0	1
19816	469070	1	0	0	0	0	0
19816	469071	1	0	0	0	1	1
19816	469073	1	0	0	0	1	1
39675	190291	29	0	1	0	0	1
39675	220552	27	1	1	0	5	7
39675	293856	19	3	4	2	5	14
39675	102990	17	2	3	0	1	6
39675	293851	17	2	3	0	1	6
39675	212116	16	1	3	2	0	6
39675	454387	16	4	6	1	2	13
39675	213231	12	3	1	0	2	6
39675	293849	12	1	1	0	0	2
39675	454386	12	1	1	1	0	3
39675	71515	12	1	1	0	0	2
39675	191570	11	2	3	1	1	7
39675	501973	10	1	1	0	1	3
39675	211071	9	0	1	0	0	1
39675	293853	9	0	2	0	0	2
39675	454397	9	0	0	3	4	7
39675	501977	9	1	3	0	1	5
39675	50959	9	0	2	0	0	2
39675	97105	9	0	0	0	2	2
39675	184749	8	0	2	0	0	2
39675	192376	8	0	2	1	1	4
39675	293854	8	0	2	0	0	2
39675	501976	8	0	2	0	1	3
39675	54234	8	0	2	0	0	2
39675	85202	8	0	1	0	1	2
39675	189912	7	0	1	1	1	3
39675	194263	7	2	0	0	1	3
39675	203436	7	2	0	2	1	5
39675	209547	7	1	3	1	1	6
39675	217992	7	0	3	1	0	4
39675	454384	7	0	0	0	1	1
39675	454390	7	1	0	1	0	2
39675	501959	7	1	0	1	0	2
39675	501961	7	2	2	0	1	5
39675	189599	6	1	3	1	1	6
39675	192989	6	1	0	0	0	1
39675	205877	6	0	2	0	4	6
39675	206086	6	1	0	0	2	3
39675	293857	6	0	0	0	0	0
39675	454383	6	0	2	0	2	4
39675	454385	6	0	2	0	3	5
39675	454391	6	0	5	0	0	5
39675	501969	6	0	1	0	0	1
39675	501972	6	1	1	0	1	3
39675	190907	5	0	0	1	1	2
39675	197059	5	1	1	0	1	3
39675	199734	5	0	2	1	0	3
39675	212672	5	1	1	0	2	4
39675	212707	5	2	0	0	0	2
39675	293850	5	1	0	1	2	4
39675	454392	5	3	1	0	0	4
39675	454399	5	1	0	1	1	3
39675	501958	5	0	2	0	0	2
39675	501966	5	0	2	0	0	2
39675	501978	5	1	4	0	1	6
39675	501979	5	2	1	0	3	6
39675	87739	5	1	0	1	2	4
39675	190530	4	1	3	0	1	5
39675	191175	4	0	1	0	3	4
39675	194592	4	1	0	0	0	1
39675	201199	4	3	0	0	1	4
39675	201628	4	1	2	1	1	5
39675	207878	4	0	0	0	3	3
39675	209573	4	1	1	1	1	4
39675	210003	4	0	1	0	1	2
39675	210042	4	1	0	0	1	2
39675	214912	4	0	1	0	2	3
39675	221528	4	2	0	0	0	2
39675	454388	4	1	2	0	1	4
39675	454389	4	1	1	0	0	2
39675	454393	4	0	1	1	0	2
39675	454394	4	1	0	0	0	1
39675	454395	4	1	1	0	1	3
39675	501962	4	1	1	0	1	3
39675	501963	4	0	0	0	0	0
39675	501965	4	1	2	0	2	5
39675	501967	4	0	0	0	1	1
39675	183951	3	2	2	0	0	4
39675	202217	3	0	1	0	1	2
39675	207465	3	0	1	0	0	1
39675	207515	3	0	2	0	0	2
39675	207861	3	1	1	0	1	3
39675	212929	3	0	0	0	0	0
39675	213924	3	0	1	0	0	1
39675	214369	3	0	0	0	0	0
39675	293852	3	1	0	0	0	1
39675	501956	3	1	0	0	0	1
39675	501960	3	0	2	0	0	2
39675	501964	3	1	1	2	1	5
39675	501968	3	1	2	0	0	3
39675	501971	3	1	0	0	0	1
39675	501974	3	0	1	0	1	2
39675	501975	3	0	1	0	1	2
39675	90234	3	1	0	0	0	1
39675	187503	2	1	0	0	1	2
39675	193085	2	1	1	0	1	3
39675	197275	2	3	4	1	1	9
39675	206884	2	0	0	0	0	0
39675	206922	2	2	0	0	0	2
39675	206960	2	1	0	0	0	1
39675	215143	2	0	0	0	0	0
39675	218262	2	1	0	0	0	1
39675	293855	2	0	0	0	0	0
39675	454396	2	0	0	0	0	0
39675	501957	2	0	0	0	0	0
39675	501970	2	0	2	0	0	2
39675	83498	2	1	2	0	0	3
39675	205880	1	0	0	0	0	0
39675	206112	1	0	0	0	0	0
39675	210490	1	0	1	0	0	1
39675	454398	1	0	2	0	1	3
39675	86172	1	1	0	1	3	5
1566	202534	26	4	1	0	0	5
1566	283355	26	4	1	0	0	5
1566	283347	23	2	5	5	2	14
1566	283352	18	3	1	0	6	10
1566	595883	18	2	0	0	2	4
1566	595913	14	3	1	1	3	8
1566	595896	13	4	0	2	2	8
1566	212175	12	3	0	0	0	3
1566	595890	12	3	0	0	0	3
1566	206647	11	0	3	0	0	3
1566	207702	11	0	1	1	1	3
1566	595937	11	1	1	0	0	2
1566	595902	10	3	1	2	0	6
1566	595905	10	2	0	0	1	3
1566	595929	10	3	4	1	0	8
1566	196989	9	2	2	0	0	4
1566	595886	9	2	0	3	0	5
1566	595893	9	3	0	0	2	5
1566	595899	9	3	0	2	0	5
1566	194524	8	0	0	0	1	1
1566	204954	8	3	1	0	2	6
1566	207723	8	0	0	0	0	0
1566	215739	8	2	0	1	1	4
1566	219321	8	0	1	0	0	1
1566	283358	8	2	3	1	2	8
1566	595903	8	2	0	0	1	3
1566	595907	8	1	0	1	1	3
1566	198071	7	1	1	0	0	2
1566	283343	7	0	1	1	4	6
1566	283354	7	2	1	0	0	3
1566	595898	7	4	2	0	0	6
1566	595919	7	1	0	0	2	3
1566	595923	7	3	0	0	0	3
1566	595931	7	0	2	1	0	3
1566	595941	7	3	0	0	1	4
1566	183794	6	2	2	0	0	4
1566	206986	6	3	0	1	0	4
1566	595908	6	2	0	0	0	2
1566	595910	6	1	0	0	1	2
1566	595936	6	0	1	0	0	1
1566	595938	6	1	2	0	2	5
1566	595940	6	0	1	0	0	1
1566	193122	5	1	0	0	1	2
1566	195430	5	3	0	1	0	4
1566	198123	5	3	1	0	0	4
1566	283346	5	4	1	0	2	7
1566	283361	5	0	0	0	1	1
1566	595897	5	2	0	2	1	5
1566	595904	5	0	0	0	1	1
1566	595914	5	1	0	0	1	2
1566	595927	5	1	0	0	2	3
1566	595932	5	2	0	0	0	2
1566	194893	4	1	1	0	0	2
1566	202859	4	0	0	0	0	0
1566	215391	4	0	0	0	0	0
1566	283344	4	0	1	0	0	1
1566	283348	4	2	0	0	3	5
1566	283349	4	0	1	0	0	1
1566	283350	4	0	0	0	0	0
1566	283356	4	1	1	0	0	2
1566	283360	4	2	0	0	1	3
1566	595894	4	2	0	0	0	2
1566	595915	4	0	1	1	1	3
1566	595916	4	0	1	1	1	3
1566	595918	4	0	0	1	0	1
1566	595921	4	0	1	0	1	2
1566	595926	4	1	0	0	0	1
1566	595939	4	1	0	1	0	2
1566	595944	4	0	2	0	0	2
1566	595945	4	0	0	0	0	0
1566	199837	3	0	0	0	0	0
1566	206238	3	1	0	0	0	1
1566	206618	3	1	0	0	0	1
1566	207936	3	2	1	0	0	3
1566	211229	3	0	0	1	1	2
1566	212400	3	0	0	0	3	3
1566	215999	3	0	0	0	1	1
1566	217091	3	0	0	0	0	0
1566	283345	3	0	0	0	0	0
1566	283351	3	2	1	0	0	3
1566	283353	3	1	2	0	1	4
1566	283357	3	0	1	0	1	2
1566	595884	3	1	1	1	1	4
1566	595891	3	2	1	0	3	6
1566	595901	3	1	1	1	0	3
1566	595906	3	0	1	0	1	2
1566	595911	3	0	0	1	0	1
1566	595920	3	2	1	1	0	4
1566	595928	3	2	1	0	0	3
1566	595930	3	0	1	0	0	1
1566	595933	3	0	0	0	1	1
1566	595942	3	1	1	0	0	2
1566	595943	3	0	2	0	0	2
1566	283359	2	1	0	0	0	1
1566	283362	2	1	0	0	0	1
1566	595881	2	2	0	0	1	3
1566	595885	2	0	0	0	1	1
1566	595887	2	2	0	0	0	2
1566	595888	2	1	0	0	1	2
1566	595889	2	3	0	0	0	3
1566	595892	2	0	0	0	0	0
1566	595909	2	0	0	0	2	2
1566	595912	2	0	1	0	0	1
1566	595917	2	1	0	1	0	2
1566	595922	2	1	0	0	1	2
1566	595924	2	2	0	0	0	2
1566	595925	2	2	0	0	0	2
1566	595934	2	1	0	0	1	2
1566	595935	2	0	0	0	2	2
1566	209247	1	0	0	0	0	0
1566	595879	1	0	0	0	1	1
1566	595880	1	1	0	0	0	1
1566	595882	1	0	0	1	0	1
1566	595900	1	1	0	0	0	1
26172	514781	21	5	0	0	0	5
26172	514757	15	2	1	1	0	4
26172	514808	10	5	1	0	3	9
26172	514816	10	5	1	0	1	7
26172	514761	9	2	3	0	0	5
26172	514771	9	0	1	0	1	2
26172	514778	9	1	0	1	0	2
26172	514788	9	4	1	1	2	8
26172	514789	9	4	1	1	2	8
26172	514756	8	1	0	0	0	1
26172	514767	8	2	0	0	0	2
26172	514779	8	3	0	0	0	3
26172	514766	7	2	0	0	0	2
26172	514774	7	6	0	0	1	7
26172	514776	7	2	0	0	0	2
26172	514797	7	3	0	0	0	3
26172	514804	7	0	0	0	0	0
26172	514810	7	3	0	0	2	5
26172	423073	6	2	1	0	1	4
26172	514723	6	1	0	0	0	1
26172	514746	6	1	0	0	0	1
26172	514770	6	2	0	0	0	2
26172	514786	6	0	1	0	1	2
26172	514811	6	1	0	0	0	1
26172	423071	5	0	0	0	1	1
26172	423075	5	5	0	0	0	5
26172	514728	5	2	0	0	0	2
26172	514764	5	2	0	0	0	2
26172	514773	5	0	0	0	0	0
26172	514782	5	4	0	0	0	4
26172	514783	5	2	0	0	0	2
26172	514805	5	1	2	2	0	5
26172	514809	5	2	0	0	1	3
26172	514813	5	2	1	0	0	3
26172	514814	5	0	1	0	0	1
26172	514734	4	1	0	0	2	3
26172	514735	4	1	0	0	0	1
26172	514737	4	0	0	0	0	0
26172	514741	4	2	0	0	1	3
26172	514752	4	2	1	0	0	3
26172	514758	4	2	0	0	0	2
26172	514759	4	5	0	0	0	5
26172	514760	4	1	0	0	0	1
26172	514772	4	0	0	0	0	0
26172	514775	4	3	0	0	1	4
26172	514777	4	0	1	1	2	4
26172	514798	4	2	0	0	0	2
26172	514800	4	0	0	0	2	2
26172	423076	3	1	1	1	1	4
26172	423081	3	2	0	0	0	2
26172	423082	3	0	0	0	0	0
26172	514722	3	0	0	0	0	0
26172	514736	3	1	0	0	0	1
26172	514738	3	1	0	0	0	1
26172	514740	3	0	1	0	0	1
26172	514744	3	1	0	0	0	1
26172	514751	3	3	1	0	1	5
26172	514753	3	1	0	0	0	1
26172	514755	3	1	1	1	0	3
26172	514765	3	1	0	0	1	2
26172	514787	3	3	0	0	0	3
26172	514792	3	2	0	1	0	3
26172	514794	3	3	0	0	0	3
26172	514799	3	1	0	0	1	2
26172	514802	3	2	0	0	0	2
26172	514806	3	2	1	0	1	4
26172	514815	3	1	3	0	2	6
26172	423072	2	0	0	0	0	0
26172	423074	2	1	0	0	0	1
26172	423077	2	0	0	0	0	0
26172	423078	2	1	0	0	0	1
26172	423080	2	0	0	0	0	0
26172	423084	2	4	1	1	0	6
26172	514725	2	1	0	0	0	1
26172	514727	2	1	1	0	0	2
26172	514729	2	0	0	0	0	0
26172	514732	2	1	0	0	0	1
26172	514733	2	0	0	0	0	0
26172	514739	2	1	0	0	1	2
26172	514743	2	0	2	0	1	3
26172	514745	2	2	0	0	0	2
26172	514747	2	2	1	0	0	3
26172	514750	2	2	0	0	0	2
26172	514754	2	2	0	0	0	2
26172	514769	2	0	0	0	0	0
26172	514784	2	1	0	0	0	1
26172	514791	2	3	2	0	0	5
26172	514793	2	2	0	0	0	2
26172	514801	2	3	0	0	0	3
26172	514807	2	1	0	0	0	1
26172	514818	2	1	0	0	0	1
26172	514820	2	2	0	0	0	2
26172	423079	1	0	0	0	0	0
26172	423083	1	1	0	0	1	2
26172	423085	1	0	0	0	0	0
26172	514724	1	2	0	0	0	2
26172	514726	1	1	0	0	0	1
26172	514730	1	1	0	0	0	1
26172	514731	1	2	0	0	1	3
26172	514742	1	2	0	0	0	2
26172	514748	1	0	0	0	0	0
26172	514749	1	2	0	0	0	2
26172	514762	1	0	1	0	0	1
26172	514763	1	0	0	0	0	0
26172	514768	1	1	0	0	0	1
26172	514780	1	0	0	0	0	0
26172	514785	1	1	2	0	1	4
26172	514790	1	3	0	0	1	4
26172	514795	1	2	0	0	0	2
26172	514796	1	1	0	0	2	3
26172	514803	1	1	0	0	0	1
26172	514812	1	1	1	0	1	3
26172	514817	1	0	0	0	0	0
26172	514819	1	2	0	0	0	2
19911	83979	29	2	4	0	1	7
19911	108300	28	0	8	0	3	11
19911	100425	21	0	2	2	1	5
19911	98183	19	0	3	1	1	5
19911	61476	17	3	1	1	0	5
19911	288524	11	3	1	1	0	5
19911	98797	11	0	1	0	0	1
19911	288530	10	0	4	0	0	4
19911	477601	10	0	0	0	0	0
19911	477622	9	1	1	0	0	2
19911	56605	9	2	0	0	1	3
19911	99118	9	2	1	0	1	4
19911	288520	8	1	1	0	0	2
19911	288527	8	3	0	0	0	3
19911	477643	8	0	0	0	0	0
19911	71659	8	1	1	0	0	2
19911	78008	8	3	0	0	0	3
19911	85059	8	2	3	0	0	5
19911	211363	7	0	2	0	0	2
19911	477623	7	0	3	0	0	3
19911	477630	7	1	3	0	0	4
19911	94741	7	0	3	0	0	3
19911	477600	6	3	2	0	1	6
19911	477604	6	1	1	0	0	2
19911	477606	6	0	2	0	0	2
19911	477617	6	1	2	1	1	5
19911	477627	6	0	2	0	0	2
19911	477631	6	2	1	0	0	3
19911	86889	6	0	3	0	1	4
19911	100251	5	1	2	0	0	3
19911	101645	5	2	1	1	0	4
19911	102275	5	0	1	0	0	1
19911	207109	5	0	1	0	0	1
19911	217213	5	1	4	0	0	5
19911	288519	5	3	2	0	0	5
19911	288526	5	0	3	0	0	3
19911	288529	5	2	1	1	0	4
19911	477640	5	1	2	0	0	3
19911	477642	5	2	2	0	0	4
19911	477645	5	2	0	0	0	2
19911	477647	5	0	1	0	0	1
19911	49470	5	2	0	0	1	3
19911	51480	5	0	2	0	0	2
19911	57994	5	1	1	0	0	2
19911	71597	5	3	2	0	0	5
19911	84997	5	0	1	0	0	1
19911	203060	4	1	1	0	0	2
19911	215940	4	0	0	0	2	2
19911	288522	4	1	3	0	0	4
19911	477597	4	0	1	0	0	1
19911	477603	4	1	1	0	0	2
19911	477611	4	0	1	0	0	1
19911	477613	4	1	1	0	0	2
19911	477618	4	2	4	0	0	6
19911	477620	4	1	1	0	0	2
19911	477624	4	0	1	0	1	2
19911	477628	4	0	3	0	1	4
19911	477629	4	0	1	0	0	1
19911	477634	4	0	3	0	0	3
19911	477644	4	0	0	0	0	0
19911	477646	4	1	0	0	0	1
19911	55221	4	0	0	0	1	1
19911	85093	4	2	2	0	0	4
19911	86866	4	1	0	0	0	1
19911	105864	3	1	1	0	0	2
19911	182210	3	0	0	0	0	0
19911	189449	3	3	1	0	0	4
19911	191024	3	2	3	0	3	8
19911	192068	3	0	4	0	0	4
19911	201696	3	1	0	0	0	1
19911	204470	3	0	0	0	2	2
19911	205389	3	0	0	0	0	0
19911	216665	3	0	1	0	0	1
19911	219612	3	1	1	0	0	2
19911	288521	3	0	0	0	0	0
19911	288525	3	1	2	0	0	3
19911	477602	3	0	2	0	0	2
19911	477605	3	2	0	0	1	3
19911	477612	3	0	4	0	0	4
19911	477616	3	1	0	0	0	1
19911	477621	3	0	3	2	1	6
19911	477626	3	1	2	0	0	3
19911	477638	3	0	0	0	2	2
19911	477648	3	0	0	0	2	2
19911	56280	3	1	1	0	0	2
19911	71629	3	0	0	0	0	0
19911	81060	3	0	1	0	0	1
19911	99863	3	1	1	0	0	2
19911	182699	2	0	1	0	0	1
19911	197809	2	0	0	0	0	0
19911	209284	2	0	2	0	0	2
19911	288523	2	0	0	0	0	0
19911	288528	2	0	1	0	0	1
19911	477598	2	0	1	0	0	1
19911	477599	2	0	1	0	0	1
19911	477607	2	1	2	0	0	3
19911	477608	2	2	2	0	0	4
19911	477609	2	1	2	0	0	3
19911	477610	2	1	3	0	0	4
19911	477614	2	0	3	0	0	3
19911	477632	2	1	0	0	0	1
19911	477635	2	0	0	0	0	0
19911	477636	2	0	1	0	0	1
19911	477637	2	0	1	0	0	1
19911	477641	2	0	0	0	1	1
19911	53654	2	0	0	0	0	0
19911	90653	2	0	1	0	0	1
19911	96519	2	1	4	0	0	5
19911	477615	1	0	1	0	0	1
19911	477619	1	1	2	0	0	3
19911	477625	1	2	1	0	1	4
19911	477633	1	0	1	0	1	2
19911	477639	1	0	1	0	0	1
27739	71706	31	1	0	2	0	3
27739	61509	23	0	1	1	1	3
27739	220894	20	0	5	2	0	7
27739	290451	20	0	5	2	0	7
27739	536900	20	0	5	2	0	7
27739	58083	19	0	3	0	0	3
27739	200595	18	4	3	1	0	8
27739	536888	17	3	4	1	0	8
27739	71841	17	2	4	0	1	7
27739	75310	15	3	3	2	0	8
27739	107019	14	0	3	2	0	5
27739	139894	14	1	1	0	1	3
27739	78761	14	3	4	1	0	8
27739	106640	12	0	1	0	1	2
27739	219731	12	1	4	3	0	8
27739	536922	11	3	1	0	0	4
27739	86572	11	0	0	0	0	0
27739	290445	10	0	0	0	0	0
27739	536867	10	1	3	0	0	4
27739	536921	10	0	2	0	0	2
27739	59262	10	0	2	0	0	2
27739	105945	9	0	1	0	0	1
27739	219121	9	0	1	0	0	1
27739	536893	9	3	0	0	2	5
27739	290446	8	0	2	0	1	3
27739	536859	8	0	1	0	1	2
27739	536874	8	1	2	0	0	3
27739	536883	8	0	0	0	0	0
27739	92603	8	2	2	1	0	5
27739	193442	7	1	2	1	0	4
27739	221224	7	0	1	0	0	1
27739	290444	7	0	0	2	0	2
27739	536890	7	1	3	0	0	4
27739	536906	7	1	1	1	0	3
27739	536917	7	0	1	0	2	3
27739	71432	7	0	0	2	0	2
27739	290449	6	2	1	2	0	5
27739	536860	6	2	0	0	0	2
27739	536868	6	1	3	0	2	6
27739	536880	6	0	0	0	0	0
27739	536882	6	2	0	0	0	2
27739	536896	6	0	0	0	0	0
27739	536897	6	1	5	0	2	8
27739	536902	6	1	0	0	0	1
27739	536918	6	1	2	0	0	3
27739	97915	6	2	1	2	0	5
27739	213402	5	0	1	0	0	1
27739	217117	5	0	0	0	0	0
27739	536889	5	1	1	1	0	3
27739	536891	5	3	1	0	1	5
27739	536892	5	1	1	0	2	4
27739	536901	5	1	2	0	0	3
27739	536912	5	1	2	0	0	3
27739	139896	4	0	3	0	0	3
27739	204250	4	0	0	0	0	0
27739	205170	4	0	2	0	0	2
27739	214491	4	1	0	0	0	1
27739	215857	4	1	2	0	0	3
27739	536864	4	1	1	1	1	4
27739	536869	4	1	2	0	1	4
27739	536870	4	1	0	0	0	1
27739	536873	4	0	1	0	0	1
27739	536877	4	0	0	0	0	0
27739	536879	4	1	2	0	0	3
27739	536885	4	0	1	0	0	1
27739	536894	4	1	0	0	0	1
27739	536895	4	0	2	0	0	2
27739	536905	4	0	0	0	0	0
27739	536907	4	0	2	0	0	2
27739	536910	4	2	0	0	0	2
27739	536913	4	0	1	0	0	1
27739	536923	4	0	2	0	0	2
27739	100045	3	1	0	0	0	1
27739	139895	3	1	1	0	1	3
27739	290447	3	1	0	0	0	1
27739	536861	3	0	0	0	0	0
27739	536863	3	2	1	0	0	3
27739	536866	3	0	2	0	0	2
27739	536871	3	2	1	0	2	5
27739	536875	3	0	0	0	0	0
27739	536878	3	1	0	0	0	1
27739	536884	3	1	0	0	0	1
27739	536886	3	0	1	0	0	1
27739	536887	3	1	0	0	0	1
27739	536903	3	1	2	0	0	3
27739	536914	3	1	1	0	0	2
27739	536915	3	2	1	0	0	3
27739	536919	3	1	0	0	0	1
27739	72211	3	1	0	0	0	1
27739	184409	2	1	1	0	0	2
27739	290448	2	0	0	0	1	1
27739	290450	2	0	2	0	0	2
27739	536854	2	0	1	0	1	2
27739	536858	2	1	1	0	0	2
27739	536862	2	1	1	0	0	2
27739	536865	2	0	0	0	0	0
27739	536872	2	1	2	0	0	3
27739	536876	2	0	1	0	0	1
27739	536898	2	1	0	0	0	1
27739	536899	2	0	1	0	0	1
27739	536908	2	1	1	2	0	4
27739	536909	2	2	1	0	0	3
27739	536911	2	0	0	0	0	0
27739	536916	2	1	0	0	0	1
27739	64388	2	0	0	0	1	1
27739	87254	2	0	2	0	0	2
27739	183721	1	0	1	0	0	1
27739	536855	1	0	0	0	0	0
27739	536856	1	0	1	0	0	1
27739	536857	1	0	1	0	0	1
27739	536881	1	1	2	0	0	3
27739	536904	1	0	0	0	0	0
27739	536920	1	1	1	0	1	3
56052	198821	43	1	6	0	0	7
56052	297850	43	1	6	0	0	7
56052	74492	43	1	6	0	0	7
56052	490866	37	2	5	2	1	10
56052	59027	37	2	5	2	1	10
56052	89614	31	2	13	1	4	20
56052	81043	23	1	1	0	1	3
56052	490868	22	2	5	2	1	10
56052	490845	16	2	1	0	2	5
56052	490849	16	3	2	0	0	5
56052	297866	14	4	3	0	2	9
56052	80610	14	1	2	0	1	4
56052	99285	14	1	1	0	0	2
56052	297865	13	3	6	0	1	10
56052	197382	12	0	2	1	0	3
56052	297852	12	0	2	1	0	3
56052	490851	12	3	6	0	1	10
56052	72762	12	0	2	1	0	3
56052	79482	12	0	2	0	3	5
56052	490846	11	2	2	0	0	4
56052	490865	11	0	2	0	4	6
56052	297871	10	0	2	0	1	3
56052	490860	10	1	1	0	0	2
56052	51544	10	1	1	0	1	3
56052	52593	10	2	0	0	1	3
56052	297851	9	3	0	1	1	5
56052	66003	9	3	0	1	1	5
56052	94800	9	2	3	0	3	8
56052	97668	9	0	0	0	0	0
56052	297853	8	2	2	0	1	5
56052	297858	8	2	1	0	1	4
56052	297867	8	4	4	0	2	10
56052	52543	8	2	2	0	1	5
56052	76244	8	4	4	0	2	10
56052	91032	8	2	1	0	1	4
56052	297872	7	3	1	0	3	7
56052	297873	7	3	1	1	0	5
56052	490834	7	1	3	0	1	5
56052	490839	7	7	3	0	0	10
56052	490841	7	2	0	0	0	2
56052	490848	7	2	1	0	0	3
56052	490850	7	0	0	0	0	0
56052	490852	7	3	1	1	0	5
56052	490856	7	2	1	0	0	3
56052	490869	7	1	1	1	1	4
56052	490870	7	0	0	0	0	0
56052	70520	7	1	1	1	1	4
56052	97780	7	3	1	0	3	7
56052	97988	7	3	1	1	0	5
56052	98451	7	0	4	1	1	6
56052	194817	6	0	1	0	0	1
56052	490830	6	0	1	0	0	1
56052	490832	6	1	2	0	1	4
56052	490836	6	0	0	0	0	0
56052	490838	6	1	2	0	0	3
56052	490840	6	3	0	0	1	4
56052	490843	6	3	2	0	0	5
56052	490853	6	1	0	0	0	1
56052	490857	6	1	1	0	3	5
56052	73751	6	1	1	0	0	2
56052	99265	6	0	1	0	0	1
56052	103597	5	1	1	0	2	4
56052	216427	5	0	2	0	0	2
56052	297857	5	4	0	0	0	4
56052	297861	5	1	1	0	0	2
56052	490829	5	3	0	0	1	4
56052	490844	5	0	0	0	0	0
56052	490858	5	0	1	0	0	1
56052	57215	5	1	3	0	0	4
56052	74234	5	1	4	0	1	6
56052	90061	5	1	2	0	0	3
56052	96650	5	1	3	0	0	4
56052	106444	4	1	2	0	1	4
56052	182303	4	1	2	0	0	3
56052	216643	4	1	4	0	5	10
56052	297855	4	1	2	0	1	4
56052	297859	4	2	0	0	0	2
56052	297862	4	1	0	0	0	1
56052	297863	4	0	0	0	0	0
56052	297869	4	0	2	2	1	5
56052	490842	4	2	2	1	2	7
56052	490855	4	1	1	0	0	2
56052	490859	4	0	2	0	0	2
56052	490861	4	0	3	0	0	3
56052	49371	4	1	1	0	1	3
56052	49403	4	1	0	0	0	1
56052	56383	4	0	0	0	0	0
56052	66688	4	0	2	2	1	5
56052	86660	4	1	3	0	0	4
56052	198091	3	3	1	0	0	4
56052	214510	3	0	0	0	0	0
56052	297860	3	1	0	0	1	2
56052	297864	3	2	0	0	0	2
56052	297868	3	0	0	0	0	0
56052	297870	3	3	1	0	1	5
56052	490828	3	1	2	0	2	5
56052	490837	3	0	0	0	0	0
56052	490847	3	0	1	0	0	1
56052	490854	3	0	1	0	0	1
56052	490862	3	1	0	0	3	4
56052	490864	3	0	1	0	0	1
56052	490867	3	0	1	0	0	1
56052	76942	3	2	0	0	0	2
56052	90257	3	1	0	0	1	2
56052	100097	2	0	0	0	0	0
56052	297854	2	2	1	0	0	3
56052	297856	2	0	0	0	0	0
56052	490831	2	2	1	0	0	3
56052	490835	2	2	0	0	0	2
56052	490863	2	0	0	0	0	0
56052	196688	1	0	1	0	0	1
56052	220266	1	0	0	0	1	1
56052	490833	1	1	1	0	0	2
117082	398707	24	3	4	0	0	7
117082	398709	22	3	3	0	0	6
117082	398749	15	1	4	0	3	8
117082	398774	14	5	3	0	0	8
117082	398689	13	0	1	0	1	2
117082	398690	13	0	1	0	1	2
117082	398692	13	0	1	0	1	2
117082	398693	13	0	1	0	1	2
117082	398752	13	2	3	0	0	5
117082	398715	12	1	2	0	0	3
117082	398770	12	1	1	1	3	6
117082	398683	11	2	2	0	0	4
117082	398760	11	4	1	0	2	7
117082	398744	10	0	0	0	1	1
117082	398747	10	2	2	0	0	4
117082	398712	9	0	1	2	1	4
117082	398720	9	2	0	1	1	4
117082	398742	9	3	0	0	2	5
117082	398751	9	1	0	0	0	1
117082	398672	8	1	2	0	0	3
117082	398673	8	1	0	0	0	1
117082	398695	8	1	5	0	1	7
117082	398723	8	2	2	0	0	4
117082	398738	8	4	2	0	0	6
117082	398740	8	1	5	0	0	6
117082	398741	8	2	5	1	0	8
117082	398748	8	3	1	0	2	6
117082	398750	8	1	0	0	1	2
117082	398768	8	1	1	0	0	2
117082	398775	8	0	0	0	0	0
117082	398674	7	0	1	0	0	1
117082	398678	7	2	1	1	0	4
117082	398704	7	1	0	0	2	3
117082	398716	7	2	2	0	1	5
117082	398721	7	1	4	0	2	7
117082	398732	7	4	2	1	1	8
117082	398757	7	2	1	0	0	3
117082	398769	7	0	1	0	0	1
117082	398778	7	2	0	0	1	3
117082	398668	6	2	3	0	0	5
117082	398753	6	2	1	1	4	8
117082	398762	6	1	2	0	0	3
117082	398765	6	3	0	0	0	3
117082	398766	6	0	4	0	3	7
117082	398680	5	3	1	0	0	4
117082	398686	5	0	1	0	0	1
117082	398687	5	0	0	0	1	1
117082	398696	5	0	0	0	0	0
117082	398702	5	3	1	0	0	4
117082	398703	5	2	2	0	0	4
117082	398705	5	4	0	0	2	6
117082	398711	5	1	3	0	0	4
117082	398717	5	3	2	0	3	8
117082	398718	5	3	1	0	0	4
117082	398727	5	3	1	0	0	4
117082	398728	5	0	3	1	1	5
117082	398734	5	0	1	0	0	1
117082	398746	5	1	3	0	0	4
117082	398756	5	2	0	0	1	3
117082	398764	5	2	4	0	0	6
117082	398777	5	0	1	0	0	1
117082	398697	4	0	0	0	0	0
117082	398722	4	0	0	0	0	0
117082	398726	4	2	1	0	0	3
117082	398729	4	1	4	0	0	5
117082	398735	4	1	2	0	1	4
117082	398743	4	2	0	0	2	4
117082	398754	4	1	1	0	0	2
117082	398758	4	2	0	0	0	2
117082	398759	4	1	1	1	0	3
117082	398761	4	1	2	0	0	3
117082	398767	4	1	1	0	2	4
117082	398670	3	0	0	0	1	1
117082	398676	3	1	1	0	0	2
117082	398677	3	0	0	0	1	1
117082	398681	3	1	1	0	0	2
117082	398684	3	3	4	0	1	8
117082	398694	3	1	1	0	1	3
117082	398699	3	1	1	0	0	2
117082	398701	3	1	4	0	1	6
117082	398706	3	2	0	0	0	2
117082	398710	3	0	1	0	0	1
117082	398719	3	0	1	0	0	1
117082	398724	3	1	0	0	0	1
117082	398725	3	1	2	0	0	3
117082	398731	3	0	1	0	1	2
117082	398736	3	2	1	0	0	3
117082	398745	3	2	1	0	0	3
117082	398771	3	1	2	0	1	4
117082	398772	3	2	1	0	1	4
117082	398776	3	1	2	0	0	3
117082	398665	2	0	1	0	0	1
117082	398666	2	1	0	0	0	1
117082	398667	2	0	0	0	0	0
117082	398669	2	0	0	0	0	0
117082	398671	2	1	0	0	0	1
117082	398675	2	3	1	0	0	4
117082	398679	2	0	1	0	0	1
117082	398682	2	0	1	0	0	1
117082	398700	2	1	1	0	0	2
117082	398708	2	1	1	0	0	2
117082	398713	2	2	0	0	0	2
117082	398714	2	0	3	0	0	3
117082	398730	2	0	3	0	0	3
117082	398733	2	0	2	0	1	3
117082	398737	2	1	1	0	1	3
117082	398685	1	0	0	0	1	1
117082	398698	1	0	1	0	0	1
117082	398739	1	0	0	0	2	2
117082	398755	1	0	1	0	0	1
117082	398763	1	0	2	0	0	2
117082	398773	1	0	0	0	0	0
3565	101240	35	3	1	0	0	4
3565	100367	31	0	4	0	1	5
3565	191515	22	0	3	0	0	3
3565	423715	19	1	3	0	0	4
3565	63745	19	1	3	0	0	4
3565	423766	17	3	2	0	1	6
3565	55226	14	0	3	1	0	4
3565	423732	13	3	4	0	0	7
3565	423733	12	1	4	0	1	6
3565	57698	12	0	2	0	0	2
3565	210815	11	2	5	2	2	11
3565	423725	11	2	5	2	2	11
3565	423747	11	1	0	0	0	1
3565	423729	10	1	3	2	0	6
3565	55434	10	2	5	2	2	11
3565	89300	10	3	2	0	0	5
3565	210180	9	0	5	0	0	5
3565	73686	9	3	3	0	0	6
3565	283789	8	0	5	0	0	5
3565	423763	8	2	2	0	0	4
3565	423764	8	1	1	0	0	2
3565	84143	8	0	3	0	1	4
3565	93169	8	0	5	0	0	5
3565	205810	7	2	0	0	2	4
3565	423712	7	3	0	0	0	3
3565	423742	7	0	0	0	0	0
3565	423755	7	1	3	0	0	4
3565	220197	6	0	0	0	0	0
3565	423707	6	1	2	0	0	3
3565	423720	6	0	2	0	1	3
3565	423724	6	1	1	0	0	2
3565	423727	6	1	2	0	0	3
3565	423738	6	2	1	0	0	3
3565	423741	6	0	1	0	0	1
3565	423743	6	2	3	0	0	5
3565	423748	6	0	2	0	0	2
3565	423750	6	2	2	0	1	5
3565	189836	5	1	1	0	0	2
3565	423704	5	1	2	0	0	3
3565	423710	5	2	1	0	0	3
3565	423730	5	0	0	2	0	2
3565	423734	5	1	1	0	0	2
3565	423745	5	1	2	0	0	3
3565	423752	5	2	0	0	0	2
3565	423754	5	3	2	0	1	6
3565	423759	5	1	0	0	1	2
3565	423762	5	1	1	0	0	2
3565	423765	5	0	2	0	0	2
3565	423767	5	2	1	0	1	4
3565	100897	4	0	1	0	0	1
3565	219903	4	0	0	0	0	0
3565	283798	4	1	0	0	0	1
3565	423703	4	2	3	0	0	5
3565	423713	4	2	1	0	0	3
3565	423717	4	2	0	0	0	2
3565	423719	4	0	3	0	0	3
3565	423723	4	1	0	0	0	1
3565	423728	4	0	0	0	0	0
3565	53831	4	1	0	0	0	1
3565	187086	3	0	1	0	0	1
3565	204277	3	0	0	0	0	0
3565	206054	3	0	1	0	0	1
3565	216935	3	0	0	0	0	0
3565	283795	3	0	0	0	0	0
3565	423702	3	0	0	1	0	1
3565	423711	3	0	3	0	0	3
3565	423718	3	0	0	1	0	1
3565	423721	3	1	0	0	1	2
3565	423726	3	1	0	0	0	1
3565	423736	3	0	0	0	0	0
3565	423737	3	2	0	1	0	3
3565	423749	3	0	1	0	0	1
3565	423751	3	1	1	0	0	2
3565	423753	3	0	2	0	0	2
3565	423760	3	0	1	0	0	1
3565	186508	2	1	0	0	0	1
3565	203723	2	0	1	0	0	1
3565	283792	2	2	0	0	0	2
3565	283793	2	1	0	0	0	1
3565	283794	2	0	0	0	0	0
3565	283796	2	0	0	0	0	0
3565	283797	2	0	0	0	1	1
3565	283799	2	0	0	0	0	0
3565	283800	2	0	1	0	0	1
3565	423705	2	0	1	0	0	1
3565	423709	2	0	0	0	1	1
3565	423714	2	0	1	0	0	1
3565	423716	2	0	1	0	0	1
3565	423722	2	0	0	0	0	0
3565	423731	2	1	1	0	0	2
3565	423735	2	0	1	0	0	1
3565	423739	2	0	1	0	0	1
3565	423756	2	0	0	0	1	1
3565	423757	2	0	0	0	0	0
3565	423758	2	0	0	0	0	0
3565	84362	2	1	0	0	0	1
3565	88852	2	0	0	0	1	1
3565	90531	2	2	0	0	0	2
3565	191293	1	1	0	0	0	1
3565	208011	1	1	0	0	0	1
3565	208013	1	1	0	0	0	1
3565	208631	1	1	0	0	0	1
3565	423699	1	1	0	0	0	1
3565	423700	1	0	2	0	0	2
3565	423701	1	3	1	0	0	4
3565	423706	1	0	0	0	0	0
3565	423708	1	1	1	0	0	2
3565	423740	1	0	0	0	0	0
3565	423744	1	0	0	0	0	0
3565	423746	1	0	0	0	1	1
3565	423761	1	1	0	0	0	1
12893	564692	16	1	1	0	1	3
12893	564683	15	0	0	0	1	1
12893	564752	14	0	2	0	1	3
12893	564750	13	2	1	0	0	3
12893	564737	12	0	1	0	0	1
12893	564744	12	0	1	0	0	1
12893	564759	12	1	1	0	0	2
12893	564762	12	2	3	0	0	5
12893	209892	11	0	3	1	1	5
12893	564728	11	2	2	0	0	4
12893	564731	10	2	1	0	0	3
12893	286487	9	0	3	1	1	5
12893	564706	8	3	2	0	0	5
12893	564743	8	1	0	0	0	1
12893	211765	7	2	0	0	0	2
12893	564689	7	0	0	0	0	0
12893	564697	7	2	1	0	0	3
12893	564705	7	4	0	0	0	4
12893	564709	7	0	0	0	3	3
12893	564711	7	0	1	0	0	1
12893	564714	7	1	0	0	0	1
12893	564765	7	0	2	0	1	3
12893	200642	6	0	1	0	0	1
12893	564681	6	1	0	0	0	1
12893	564690	6	0	0	0	0	0
12893	564691	6	1	1	0	0	2
12893	564708	6	1	1	0	0	2
12893	564715	6	1	0	0	0	1
12893	564719	6	0	2	0	1	3
12893	564739	6	1	1	0	0	2
12893	564751	6	0	1	0	0	1
12893	564755	6	0	0	0	0	0
12893	564757	6	1	0	0	0	1
12893	185293	5	0	1	0	0	1
12893	186145	5	1	1	0	1	3
12893	214941	5	2	1	0	0	3
12893	217284	5	1	1	0	0	2
12893	564684	5	4	1	0	0	5
12893	564688	5	1	0	0	0	1
12893	564696	5	1	1	0	0	2
12893	564700	5	1	0	0	0	1
12893	564702	5	0	0	0	0	0
12893	564703	5	0	0	0	3	3
12893	564712	5	0	0	0	0	0
12893	564716	5	0	0	0	0	0
12893	564721	5	0	2	0	1	3
12893	564733	5	0	0	0	0	0
12893	564736	5	0	0	0	0	0
12893	564740	5	1	2	0	0	3
12893	564748	5	1	1	0	1	3
12893	564753	5	2	0	0	0	2
12893	564758	5	0	0	0	0	0
12893	564764	5	1	0	0	2	3
12893	185480	4	0	1	0	2	3
12893	220047	4	1	0	0	1	2
12893	286490	4	1	1	0	1	3
12893	286491	4	3	0	0	1	4
12893	564687	4	1	1	0	0	2
12893	564698	4	0	0	0	0	0
12893	564710	4	1	0	0	0	1
12893	564724	4	2	0	0	0	2
12893	564729	4	0	0	0	0	0
12893	564732	4	0	0	0	0	0
12893	564741	4	1	1	0	0	2
12893	564742	4	2	0	0	1	3
12893	564746	4	1	0	0	0	1
12893	564760	4	0	0	0	0	0
12893	564761	4	1	1	0	0	2
12893	564763	4	2	1	0	0	3
12893	187074	3	1	0	0	0	1
12893	192606	3	0	0	0	1	1
12893	205354	3	0	0	0	0	0
12893	211891	3	0	0	0	0	0
12893	286492	3	1	0	0	0	1
12893	564679	3	0	0	0	0	0
12893	564682	3	1	0	0	1	2
12893	564685	3	1	0	0	0	1
12893	564693	3	1	0	1	3	5
12893	564695	3	0	1	2	2	5
12893	564699	3	1	1	0	0	2
12893	564701	3	0	0	0	0	0
12893	564707	3	0	3	0	2	5
12893	564713	3	0	0	0	0	0
12893	564718	3	0	0	0	0	0
12893	564722	3	2	0	0	0	2
12893	564725	3	1	0	0	2	3
12893	564726	3	0	1	0	0	1
12893	564727	3	0	1	1	0	2
12893	564730	3	1	0	0	0	1
12893	564734	3	2	0	0	0	2
12893	564738	3	2	1	0	0	3
12893	564747	3	1	0	0	0	1
12893	564749	3	0	1	0	0	1
12893	564754	3	0	1	0	0	1
12893	564766	3	0	1	0	0	1
12893	199858	2	0	0	0	0	0
12893	286489	2	1	1	0	0	2
12893	564680	2	0	0	0	0	0
12893	564694	2	0	0	0	0	0
12893	564704	2	0	0	0	0	0
12893	564717	2	1	0	1	1	3
12893	564723	2	0	0	0	2	2
12893	564756	2	0	1	0	0	1
12893	203137	1	0	0	0	0	0
12893	286488	1	2	0	0	0	2
12893	286493	1	0	0	0	0	0
12893	564686	1	0	1	0	0	1
12893	564720	1	0	0	0	0	0
12893	564735	1	0	0	0	0	0
12893	564745	1	0	1	0	0	1
12893	564767	1	0	0	0	1	1
8640	573266	61	5	10	1	0	16
8640	573268	41	3	3	1	0	7
8640	199785	10	0	0	0	0	0
8640	573271	9	0	0	0	0	0
8640	573277	9	0	0	0	1	1
8640	275783	8	2	1	0	0	3
8640	275785	7	0	2	0	0	2
8640	573286	7	1	1	0	0	2
8640	573301	7	2	2	0	0	4
8640	573311	7	0	0	0	1	1
8640	573330	7	2	2	0	4	8
8640	573331	7	1	0	0	0	1
8640	187043	6	3	3	0	0	6
8640	275784	6	2	1	0	0	3
8640	573278	6	0	1	0	1	2
8640	573282	6	1	1	0	0	2
8640	573285	6	0	1	0	2	3
8640	573291	6	1	1	0	3	5
8640	573293	6	0	1	0	0	1
8640	573296	6	0	1	0	0	1
8640	573300	6	0	1	0	1	2
8640	573325	6	3	1	0	0	4
8640	573333	6	2	2	0	1	5
8640	573342	6	2	4	0	0	6
8640	573351	6	1	1	0	0	2
8640	202991	5	0	0	0	0	0
8640	573272	5	1	1	0	0	2
8640	573275	5	1	2	0	0	3
8640	573276	5	0	2	0	1	3
8640	573281	5	1	1	0	1	3
8640	573299	5	1	3	0	0	4
8640	573304	5	0	4	0	0	4
8640	573309	5	0	1	0	0	1
8640	573314	5	0	2	0	0	2
8640	573322	5	1	0	0	3	4
8640	573326	5	1	1	0	0	2
8640	573329	5	0	1	0	0	1
8640	573335	5	1	1	0	0	2
8640	193901	4	2	1	0	0	3
8640	195231	4	0	2	0	0	2
8640	211012	4	1	3	0	0	4
8640	275786	4	0	0	0	2	2
8640	573280	4	0	1	0	0	1
8640	573288	4	1	1	0	0	2
8640	573289	4	1	0	0	0	1
8640	573298	4	2	2	0	1	5
8640	573307	4	0	1	0	0	1
8640	573310	4	0	0	0	0	0
8640	573312	4	0	0	0	0	0
8640	573323	4	0	0	0	0	0
8640	573327	4	0	3	0	1	4
8640	573332	4	0	1	0	0	1
8640	573334	4	0	1	0	0	1
8640	573337	4	2	1	0	0	3
8640	573341	4	2	1	0	0	3
8640	573345	4	0	1	0	0	1
8640	573346	4	0	1	0	1	2
8640	573349	4	0	1	0	0	1
8640	573354	4	0	1	0	0	1
8640	275780	3	0	0	0	0	0
8640	275781	3	0	0	0	0	0
8640	275782	3	0	0	0	0	0
8640	573270	3	0	1	0	0	1
8640	573292	3	1	1	0	0	2
8640	573302	3	0	0	0	0	0
8640	573303	3	0	2	0	0	2
8640	573305	3	0	0	0	0	0
8640	573315	3	1	3	0	0	4
8640	573316	3	0	1	0	0	1
8640	573317	3	2	0	0	0	2
8640	573324	3	3	1	0	1	5
8640	573339	3	0	1	0	1	2
8640	573344	3	0	1	0	0	1
8640	573348	3	3	0	0	0	3
8640	573352	3	1	1	0	0	2
8640	573353	3	0	2	0	0	2
8640	196514	2	0	1	0	0	1
8640	200124	2	1	2	0	0	3
8640	215760	2	1	0	0	0	1
8640	573265	2	1	1	0	0	2
8640	573269	2	1	0	0	0	1
8640	573273	2	0	2	0	0	2
8640	573274	2	0	0	0	0	0
8640	573279	2	0	1	0	0	1
8640	573283	2	0	3	0	0	3
8640	573284	2	0	1	0	0	1
8640	573287	2	1	1	0	0	2
8640	573290	2	0	1	0	0	1
8640	573295	2	0	0	0	0	0
8640	573297	2	1	0	0	0	1
8640	573306	2	1	0	0	0	1
8640	573308	2	0	2	0	0	2
8640	573313	2	0	1	0	0	1
8640	573318	2	1	2	0	0	3
8640	573319	2	1	0	0	0	1
8640	573321	2	0	0	0	0	0
8640	573328	2	0	1	0	0	1
8640	573336	2	0	3	0	0	3
8640	573338	2	1	0	0	0	1
8640	573340	2	0	0	0	0	0
8640	573347	2	1	0	0	0	1
8640	573350	2	0	0	0	0	0
8640	186632	1	0	1	0	0	1
8640	199257	1	1	2	0	0	3
8640	204397	1	0	0	0	0	0
8640	207064	1	1	1	0	0	2
8640	573267	1	0	1	0	0	1
8640	573294	1	0	2	0	0	2
8640	573320	1	1	0	0	0	1
8640	573343	1	0	0	0	0	0
52189	59576	37	0	3	4	1	8
52189	208316	35	1	4	1	4	10
52189	440938	35	1	4	1	4	10
52189	91818	35	1	4	1	4	10
52189	92551	31	5	5	0	3	13
52189	93074	29	4	7	0	5	16
52189	440933	28	3	2	1	1	7
52189	72657	28	3	2	1	1	7
52189	440923	27	4	7	0	5	16
52189	297039	25	3	3	1	0	7
52189	86596	25	3	3	1	0	7
52189	51969	23	2	1	3	3	9
52189	107457	22	2	1	0	0	3
52189	297042	22	1	4	1	0	6
52189	73633	22	1	4	1	0	6
52189	440934	21	1	4	1	0	6
52189	64973	21	1	4	0	1	6
52189	70059	21	1	4	2	2	9
52189	189821	20	1	7	8	1	17
52189	440926	20	1	7	8	1	17
52189	83652	20	4	1	0	0	5
52189	58369	19	4	4	0	1	9
52189	106922	18	2	7	1	2	12
52189	297037	18	0	3	1	0	4
52189	297040	18	3	5	2	1	11
52189	440929	18	2	5	2	1	10
52189	94547	18	2	5	2	1	10
52189	188422	17	0	2	0	1	3
52189	59663	17	0	2	0	1	3
52189	61078	17	2	4	1	8	15
52189	189116	16	2	4	1	8	15
52189	440928	16	0	2	0	1	3
52189	440939	16	2	4	1	8	15
52189	96080	15	0	6	6	1	13
52189	101505	14	3	4	2	0	9
52189	440936	14	3	4	0	2	9
52189	65642	14	3	5	0	1	9
52189	440924	13	1	3	3	2	9
52189	440931	13	1	2	0	2	5
52189	297038	12	1	3	0	2	6
52189	440927	12	1	1	0	1	3
52189	49981	12	1	1	0	1	3
52189	91544	12	1	3	0	2	6
52189	440909	11	1	0	0	1	2
52189	440920	11	1	2	0	0	3
52189	61720	11	1	0	0	1	2
52189	80444	11	1	2	0	0	3
52189	88310	11	3	2	1	0	6
52189	106166	10	0	0	0	1	1
52189	219244	10	0	0	0	1	1
52189	297032	10	1	2	0	0	3
52189	440925	10	1	3	0	2	6
52189	440935	10	0	3	0	0	3
52189	51036	10	1	2	0	0	3
52189	94461	10	0	3	0	0	3
52189	105023	9	1	2	0	1	4
52189	50466	9	0	2	0	2	4
52189	74642	9	3	2	0	1	6
52189	297033	8	1	2	0	3	6
52189	440912	8	0	0	0	1	1
52189	440932	8	2	1	1	0	4
52189	50677	8	2	1	1	0	4
52189	53891	8	1	2	0	3	6
52189	61272	8	1	2	0	0	3
52189	103700	7	2	4	2	1	9
52189	297035	7	0	2	0	2	4
52189	440911	7	1	6	0	0	7
52189	440937	7	1	2	1	0	4
52189	80991	7	1	1	0	1	3
52189	81984	7	1	3	1	0	5
52189	88573	7	1	2	1	0	4
52189	97772	7	0	2	0	2	4
52189	440915	6	1	2	0	0	3
52189	440919	6	1	2	0	1	4
52189	440930	6	0	1	1	0	2
52189	92472	6	0	3	1	0	4
52189	191721	5	0	0	0	0	0
52189	297036	5	1	3	1	0	5
52189	440905	5	1	0	0	0	1
52189	440916	5	1	1	1	0	3
52189	440922	5	0	2	0	1	3
52189	66972	5	3	1	0	1	5
52189	84873	5	2	3	0	0	5
52189	88333	5	1	3	1	0	5
52189	94610	5	0	2	0	0	2
52189	99211	5	1	3	0	0	4
52189	297034	4	0	0	0	0	0
52189	440902	4	1	1	0	0	2
52189	440904	4	1	2	0	0	3
52189	440910	4	0	4	0	0	4
52189	440918	4	0	1	0	1	2
52189	64573	4	0	0	0	0	0
52189	85677	4	0	1	1	1	3
52189	440906	3	1	1	0	0	2
52189	440908	3	1	2	0	0	3
52189	440917	3	0	1	0	0	1
52189	68791	3	1	1	0	0	2
52189	78884	3	0	1	0	0	1
52189	86410	3	1	1	0	3	5
52189	89117	3	0	0	0	0	0
52189	98892	3	0	2	0	1	3
52189	440903	2	1	0	0	0	1
52189	440907	2	0	1	0	0	1
52189	440913	2	0	0	2	0	2
52189	440921	2	0	2	0	0	2
52189	440901	1	0	1	0	1	2
52189	440914	1	0	1	0	0	1
52189	62851	1	1	0	1	0	2
254	198791	47	2	2	0	0	4
254	283014	47	2	2	0	0	4
254	74296	47	2	2	0	0	4
254	187341	44	3	5	1	3	12
254	69016	44	3	5	1	3	12
254	190990	38	3	1	0	0	4
254	184153	33	1	9	0	1	11
254	53007	32	1	9	0	1	11
254	493899	25	5	3	2	1	11
254	493889	23	1	2	1	0	4
254	89635	20	1	0	0	1	2
254	283019	19	4	1	1	2	8
254	90175	19	4	1	1	2	8
254	88415	18	0	1	0	1	2
254	493924	17	4	1	1	2	8
254	493923	13	1	0	0	0	1
254	283017	12	0	2	1	0	3
254	493929	12	2	1	1	2	6
254	493931	12	4	4	1	1	10
254	493941	12	4	3	0	0	7
254	103356	11	2	1	1	0	4
254	493932	11	1	2	0	0	3
254	493937	11	1	0	0	1	2
254	192149	10	2	3	0	1	6
254	493898	10	1	1	0	1	3
254	493919	10	0	2	1	0	3
254	493927	10	0	4	1	1	6
254	217333	9	3	0	0	0	3
254	493928	9	0	2	0	2	4
254	493942	9	2	0	1	2	5
254	188080	8	2	4	3	0	9
254	214176	8	1	1	1	1	4
254	493896	8	2	3	1	1	7
254	493926	8	7	6	0	2	15
254	201497	7	1	3	2	2	8
254	211734	7	0	2	1	0	3
254	493892	7	1	5	0	0	6
254	493893	7	0	0	0	0	0
254	493894	7	0	1	0	1	2
254	493907	7	2	0	1	0	3
254	493909	7	1	1	0	1	3
254	493916	7	1	1	0	0	2
254	493917	7	1	0	0	0	1
254	493934	7	2	2	2	0	6
254	493935	7	1	2	0	0	3
254	100938	6	0	1	2	0	3
254	105075	6	2	1	1	0	4
254	190916	6	2	0	0	0	2
254	203926	6	0	2	0	0	2
254	283013	6	3	1	2	0	6
254	283016	6	0	1	2	0	3
254	493891	6	0	0	0	0	0
254	493905	6	1	0	1	0	2
254	493906	6	3	1	0	6	10
254	493908	6	1	0	0	0	1
254	576799	6	1	0	0	0	1
254	576800	6	1	1	0	0	2
254	202610	5	1	0	0	1	2
254	215129	5	1	0	0	0	1
254	283018	5	0	0	1	0	1
254	493886	5	1	3	0	1	5
254	493888	5	0	1	2	2	5
254	493895	5	0	2	2	1	5
254	493904	5	0	0	0	0	0
254	493913	5	1	1	0	0	2
254	493920	5	2	0	0	1	3
254	493930	5	0	1	0	1	2
254	493933	5	2	3	0	2	7
254	493936	5	2	2	1	0	5
254	493939	5	1	0	0	1	2
254	51216	5	0	0	1	0	1
254	96428	5	1	0	0	1	2
254	105654	4	1	1	0	0	2
254	194074	4	2	0	0	0	2
254	207843	4	0	0	1	1	2
254	211798	4	0	1	0	0	1
254	219107	4	1	1	0	0	2
254	220770	4	0	0	0	1	1
254	283020	4	0	0	0	0	0
254	493897	4	0	0	0	0	0
254	493903	4	1	4	0	0	5
254	493915	4	3	0	0	0	3
254	493922	4	1	1	0	0	2
254	70183	4	0	0	0	0	0
254	74684	4	0	2	0	0	2
254	493887	3	0	2	0	0	2
254	493900	3	1	1	0	0	2
254	493901	3	0	1	0	1	2
254	493902	3	0	4	1	0	5
254	493914	3	0	2	0	0	2
254	493921	3	0	2	0	0	2
254	493938	3	0	1	0	0	1
254	70567	3	0	1	0	0	1
254	86186	3	1	1	0	0	2
254	193221	2	0	1	0	0	1
254	217840	2	0	0	0	0	0
254	283015	2	0	0	0	0	0
254	493890	2	0	0	0	0	0
254	493910	2	0	1	1	0	2
254	493912	2	3	2	0	0	5
254	493925	2	0	0	0	0	0
254	576798	2	0	1	0	0	1
254	99822	2	0	0	0	0	0
254	192846	1	0	3	0	0	3
254	206794	1	0	0	0	0	0
254	493911	1	0	2	0	2	4
254	493918	1	5	4	0	1	10
254	493940	1	1	2	0	0	3
254	80903	1	1	0	2	1	4
38748	198952	34	1	1	0	0	2
38748	279548	34	1	1	0	0	2
38748	74435	34	2	1	0	0	3
38748	103922	21	2	0	0	1	3
38748	546519	17	0	0	0	2	2
38748	103411	16	1	0	0	0	1
38748	546527	14	1	1	2	0	4
38748	188154	13	0	0	1	0	1
38748	546540	13	2	3	0	0	5
38748	546549	13	0	1	0	0	1
38748	546520	11	0	0	0	1	1
38748	546523	11	2	0	0	2	4
38748	211591	10	0	1	2	2	5
38748	51182	10	1	0	0	0	1
38748	206312	9	4	1	0	1	6
38748	279549	9	2	1	2	0	5
38748	419619	9	3	1	1	6	11
38748	546529	9	2	1	0	0	3
38748	546539	9	0	0	0	0	0
38748	87995	9	2	1	2	0	5
38748	212315	8	3	0	2	2	7
38748	279545	8	0	0	1	0	1
38748	546518	8	3	0	2	2	7
38748	546541	8	1	0	1	0	2
38748	546545	8	3	0	0	6	9
38748	72182	8	1	0	0	0	1
38748	183460	7	2	0	1	1	4
38748	207146	7	2	0	1	0	3
38748	279552	7	2	0	0	0	2
38748	546521	7	2	0	0	2	4
38748	546524	7	1	4	0	0	5
38748	546525	7	2	0	1	1	4
38748	546532	7	1	1	0	3	5
38748	546544	7	2	0	1	0	3
38748	546554	7	0	0	1	0	1
38748	79156	7	2	0	0	0	2
38748	182442	6	2	0	0	1	3
38748	193549	6	1	0	1	1	3
38748	214117	6	0	0	0	0	0
38748	279547	6	1	0	1	0	2
38748	546542	6	2	0	1	1	4
38748	71136	6	1	0	1	0	2
38748	101088	5	1	2	0	1	4
38748	107063	5	1	0	0	0	1
38748	196975	5	0	0	0	1	1
38748	200169	5	1	0	0	0	1
38748	207200	5	1	1	0	1	3
38748	279550	5	1	2	0	1	4
38748	279551	5	0	0	0	0	0
38748	279558	5	1	0	0	2	3
38748	546535	5	4	0	0	1	5
38748	546546	5	0	1	0	1	2
38748	546551	5	2	1	0	1	4
38748	97955	5	0	0	0	0	0
38748	185445	4	1	0	0	1	2
38748	204821	4	0	1	0	1	2
38748	216010	4	1	0	0	1	2
38748	279546	4	1	0	1	0	2
38748	279554	4	1	0	0	1	2
38748	279556	4	1	0	0	0	1
38748	279557	4	0	0	0	1	1
38748	419609	4	0	0	1	4	5
38748	419610	4	1	0	0	1	2
38748	419611	4	0	0	1	1	2
38748	546511	4	1	0	0	2	3
38748	546534	4	0	1	0	0	1
38748	546536	4	1	0	0	0	1
38748	546537	4	1	1	1	0	3
38748	546547	4	1	0	0	1	2
38748	546553	4	1	0	0	0	1
38748	54731	4	1	0	0	1	2
38748	56337	4	0	0	0	1	1
38748	78993	4	1	0	0	0	1
38748	85083	4	0	2	0	0	2
38748	208771	3	0	1	0	2	3
38748	279555	3	1	0	0	1	2
38748	419612	3	0	2	0	2	4
38748	546515	3	2	0	1	0	3
38748	546517	3	1	0	0	1	2
38748	546522	3	0	1	0	1	2
38748	546531	3	2	0	0	1	3
38748	546533	3	1	0	0	1	2
38748	546538	3	0	0	0	1	1
38748	546548	3	0	1	0	2	3
38748	546550	3	2	0	1	1	4
38748	546552	3	0	0	0	1	1
38748	546555	3	1	2	0	1	4
38748	546556	3	1	0	0	0	1
38748	191059	2	0	1	0	2	3
38748	196243	2	0	0	0	0	0
38748	208156	2	1	0	0	0	1
38748	419614	2	0	0	0	0	0
38748	419615	2	0	0	0	0	0
38748	419616	2	0	0	0	0	0
38748	419617	2	0	0	0	0	0
38748	546510	2	1	0	0	0	1
38748	546512	2	1	0	0	1	2
38748	546516	2	1	0	0	0	1
38748	546526	2	1	0	0	3	4
38748	546528	2	0	0	1	0	1
38748	546530	2	0	2	1	1	4
38748	612823	2	1	0	0	2	3
38748	211075	1	0	0	0	1	1
38748	279553	1	0	0	0	0	0
38748	419608	1	0	0	0	1	1
38748	419613	1	0	0	0	0	0
38748	419618	1	0	0	0	1	1
38748	546513	1	1	0	0	1	2
38748	546514	1	1	0	0	0	1
38748	546543	1	0	0	0	0	0
18974	412992	53	7	2	0	0	9
18974	187617	30	3	3	1	3	10
18974	89731	20	1	1	1	2	5
18974	412996	19	1	0	0	1	2
18974	99878	19	1	0	0	1	2
18974	413000	16	1	5	2	1	9
18974	63623	16	2	1	0	1	4
18974	79743	14	0	4	1	2	7
18974	412990	13	1	3	0	2	6
18974	91746	13	1	3	0	2	6
18974	105853	12	0	1	0	0	1
18974	219507	12	0	1	0	0	1
18974	412966	11	1	8	3	2	14
18974	288240	10	2	4	0	0	6
18974	412979	10	0	4	0	0	4
18974	106474	9	0	1	0	0	1
18974	191865	9	0	5	1	0	6
18974	288247	9	0	5	1	0	6
18974	412973	9	0	0	0	0	0
18974	412976	9	1	0	0	0	1
18974	412980	9	2	2	1	2	7
18974	64338	9	0	5	1	0	6
18974	75840	9	2	1	1	0	4
18974	108566	8	1	0	0	0	1
18974	412982	8	1	0	0	0	1
18974	49797	8	1	1	0	0	2
18974	57552	8	1	6	0	2	9
18974	193353	7	3	0	0	2	5
18974	212163	7	3	4	1	4	12
18974	288243	7	0	1	0	0	1
18974	412960	7	3	4	1	4	12
18974	412984	7	1	1	0	1	3
18974	412988	7	1	2	0	2	5
18974	412991	7	2	2	1	1	6
18974	413005	7	2	0	0	0	2
18974	70761	7	0	1	0	0	1
18974	75715	7	2	1	0	2	5
18974	98285	7	0	0	0	0	0
18974	288241	6	1	1	1	0	3
18974	412952	6	0	1	0	0	1
18974	412965	6	1	2	0	2	5
18974	412993	6	0	1	0	0	1
18974	80230	6	1	1	1	0	3
18974	86618	6	2	1	1	0	4
18974	98037	6	2	0	0	1	3
18974	220609	5	0	3	0	0	3
18974	221626	5	1	1	1	0	3
18974	412955	5	0	0	0	1	1
18974	412958	5	0	0	0	0	0
18974	412959	5	2	0	1	0	3
18974	412967	5	2	0	0	0	2
18974	412972	5	0	5	0	0	5
18974	412985	5	2	0	0	2	4
18974	412994	5	1	0	0	0	1
18974	413002	5	2	2	0	1	5
18974	74119	5	0	2	0	1	3
18974	78929	5	0	0	1	0	1
18974	84536	5	0	3	0	3	6
18974	92443	5	1	2	0	1	4
18974	183697	4	2	3	0	0	5
18974	202087	4	1	3	1	0	5
18974	288242	4	0	0	0	0	0
18974	412949	4	2	0	0	0	2
18974	412950	4	2	1	0	0	3
18974	412951	4	0	0	0	0	0
18974	412957	4	0	2	0	0	2
18974	412974	4	1	1	0	0	2
18974	412986	4	2	2	0	0	4
18974	412999	4	1	0	0	2	3
18974	413001	4	0	0	0	0	0
18974	413007	4	0	0	0	1	1
18974	413008	4	0	0	0	0	0
18974	52103	4	1	3	0	1	5
18974	74188	4	0	0	0	0	0
18974	81404	4	2	0	0	0	2
18974	103125	3	2	1	0	1	4
18974	202198	3	1	4	0	0	5
18974	288236	3	0	0	0	0	0
18974	288244	3	2	1	0	1	4
18974	412953	3	0	2	0	0	2
18974	412954	3	1	0	0	0	1
18974	412956	3	0	0	0	0	0
18974	412961	3	0	1	0	0	1
18974	412962	3	1	2	0	1	4
18974	412969	3	1	0	0	0	1
18974	412970	3	1	0	0	0	1
18974	412971	3	0	0	1	0	1
18974	412977	3	0	0	0	0	0
18974	412978	3	1	1	0	0	2
18974	412981	3	1	0	0	0	1
18974	412983	3	1	3	0	0	4
18974	412987	3	0	4	0	0	4
18974	412989	3	2	1	0	0	3
18974	412998	3	0	1	0	0	1
18974	413003	3	1	0	0	0	1
18974	53113	3	0	1	0	1	2
18974	92820	3	0	0	0	0	0
18974	190002	2	1	1	0	1	3
18974	288238	2	0	0	0	0	0
18974	412963	2	0	3	0	0	3
18974	412964	2	0	0	0	0	0
18974	412975	2	0	0	0	0	0
18974	412995	2	1	0	0	0	1
18974	413004	2	0	0	1	0	1
18974	190828	1	0	0	0	0	0
18974	412968	1	0	0	0	0	0
18974	412997	1	0	1	2	1	4
18974	413006	1	0	1	0	2	3
18974	84956	1	1	2	0	0	3
7964	375039	32	3	0	1	3	7
7964	399113	32	3	0	1	3	7
7964	548100	32	3	0	1	3	7
7964	399173	27	4	2	1	1	8
7964	399142	24	7	3	1	1	12
7964	399118	22	1	1	1	2	5
7964	399133	22	3	1	1	2	7
7964	399184	20	1	5	0	0	6
7964	399177	17	2	4	2	1	9
7964	399182	16	3	4	0	0	7
7964	399169	15	5	1	0	0	6
7964	399114	13	2	0	1	1	4
7964	375041	12	0	1	0	0	1
7964	399123	12	5	4	0	4	13
7964	548096	12	0	0	0	0	0
7964	399160	11	0	0	0	0	0
7964	399174	11	4	0	0	0	4
7964	548099	11	1	1	0	0	2
7964	285050	9	1	0	1	2	4
7964	399151	9	4	4	0	3	11
7964	399153	9	2	2	0	0	4
7964	399163	9	1	0	0	1	2
7964	399166	9	0	0	0	1	1
7964	399180	9	0	0	0	0	0
7964	285051	8	3	0	0	3	6
7964	399110	8	0	0	0	1	1
7964	399112	8	2	1	0	0	3
7964	399138	8	0	2	0	0	2
7964	399162	8	3	1	0	0	4
7964	399171	8	1	0	0	0	1
7964	399175	8	3	0	2	1	6
7964	375042	7	1	0	0	1	2
7964	399119	7	3	2	0	0	5
7964	399127	7	2	0	0	1	3
7964	399148	7	1	0	0	1	2
7964	399150	7	1	0	0	0	1
7964	399164	7	2	1	0	0	3
7964	399167	7	1	0	0	0	1
7964	399172	7	2	0	0	0	2
7964	548097	7	2	1	0	1	4
7964	285049	6	1	0	0	1	2
7964	375037	6	0	0	0	1	1
7964	399108	6	0	0	0	0	0
7964	399117	6	1	0	0	0	1
7964	399120	6	2	1	0	0	3
7964	399122	6	0	1	0	3	4
7964	399129	6	0	3	0	1	4
7964	399132	6	2	1	0	1	4
7964	399137	6	2	2	0	0	4
7964	399152	6	1	1	1	3	6
7964	399165	6	0	2	0	0	2
7964	399168	6	0	0	0	0	0
7964	399170	6	1	0	0	0	1
7964	399178	6	2	0	0	0	2
7964	190955	5	1	1	0	0	2
7964	285052	5	1	0	0	1	2
7964	399121	5	2	2	0	2	6
7964	399124	5	1	0	0	0	1
7964	399134	5	0	0	0	0	0
7964	399140	5	1	0	0	1	2
7964	399154	5	2	1	0	0	3
7964	399155	5	1	0	0	0	1
7964	399156	5	0	0	0	1	1
7964	399176	5	1	2	0	1	4
7964	399183	5	2	0	0	0	2
7964	548101	5	0	0	0	0	0
7964	548104	5	0	1	1	0	2
7964	375036	4	2	0	0	0	2
7964	375038	4	1	0	0	0	1
7964	375040	4	0	1	0	0	1
7964	399106	4	1	1	0	1	3
7964	399109	4	1	0	0	1	2
7964	399130	4	2	0	0	1	3
7964	399131	4	0	0	0	1	1
7964	399136	4	1	0	0	0	1
7964	399141	4	0	0	0	1	1
7964	399145	4	1	0	0	0	1
7964	399146	4	1	0	0	0	1
7964	399147	4	0	1	0	0	1
7964	399149	4	0	0	0	0	0
7964	399157	4	0	0	0	0	0
7964	399158	4	1	0	0	0	1
7964	399181	4	2	0	0	0	2
7964	399187	4	1	0	0	0	1
7964	399111	3	1	0	0	0	1
7964	399125	3	0	1	0	1	2
7964	399128	3	1	0	0	0	1
7964	399135	3	1	0	0	0	1
7964	399144	3	1	0	0	0	1
7964	399185	3	0	2	0	0	2
7964	399186	3	2	1	0	0	3
7964	548098	3	0	1	0	0	1
7964	399104	2	1	0	0	0	1
7964	399107	2	0	0	0	0	0
7964	399115	2	0	1	0	0	1
7964	399126	2	1	0	0	0	1
7964	399143	2	1	0	0	0	1
7964	399159	2	0	0	0	0	0
7964	399188	2	0	0	0	1	1
7964	548103	2	0	1	0	0	1
7964	548105	2	0	0	0	0	0
7964	399105	1	0	1	0	1	2
7964	399116	1	1	1	0	0	2
7964	399139	1	0	0	0	1	1
7964	399161	1	0	0	0	0	0
7964	399179	1	0	0	0	0	0
7964	548102	1	3	0	0	2	5
7964	548106	1	1	0	0	2	3
63155	73566	31	0	8	1	0	9
63155	202311	30	1	6	0	1	8
63155	299903	29	1	6	0	1	8
63155	299904	29	2	5	0	1	8
63155	449061	29	1	6	0	1	8
63155	80048	29	2	5	0	1	8
63155	82892	29	1	6	0	1	8
63155	85846	29	1	6	1	3	11
63155	83166	23	3	12	2	1	18
63155	200453	13	3	1	0	1	5
63155	69743	13	2	0	1	0	3
63155	299905	11	1	2	0	1	4
63155	449059	11	3	0	0	0	3
63155	59662	11	1	2	0	1	4
63155	449060	9	1	4	0	1	6
63155	449069	8	2	2	0	2	6
63155	449077	8	1	2	0	0	3
63155	449096	8	1	3	0	0	4
63155	449116	8	1	4	0	0	5
63155	60965	8	2	2	1	2	7
63155	76095	8	2	2	4	0	8
63155	89615	8	1	4	1	1	7
63155	449088	7	1	1	0	1	3
63155	449091	7	2	2	0	1	5
63155	449103	7	0	1	0	1	2
63155	63015	7	2	2	0	0	4
63155	449083	6	2	1	0	0	3
63155	449105	6	0	1	0	0	1
63155	449111	6	2	4	0	0	6
63155	449118	6	1	3	0	2	6
63155	449132	6	1	1	0	0	2
63155	67515	6	1	1	0	1	3
63155	82292	6	1	2	1	0	4
63155	449063	5	1	0	0	0	1
63155	449064	5	1	0	0	0	1
63155	449066	5	0	1	0	1	2
63155	449067	5	2	1	0	0	3
63155	449074	5	0	1	0	2	3
63155	449082	5	2	2	0	0	4
63155	449084	5	0	1	0	0	1
63155	449093	5	0	2	0	1	3
63155	449114	5	0	2	0	0	2
63155	449122	5	0	1	0	0	1
63155	54663	5	1	2	0	0	3
63155	70575	5	0	0	1	0	1
63155	299906	4	1	2	0	0	3
63155	449062	4	2	2	0	0	4
63155	449068	4	1	1	0	0	2
63155	449081	4	1	0	0	0	1
63155	449086	4	0	0	0	0	0
63155	449097	4	0	0	0	0	0
63155	449098	4	1	1	0	0	2
63155	449102	4	1	1	0	0	2
63155	449128	4	1	0	0	0	1
63155	449129	4	0	1	0	0	1
63155	449131	4	1	1	0	0	2
63155	53776	4	1	2	0	0	3
63155	54390	4	1	0	0	0	1
63155	88451	4	1	1	1	2	5
63155	92421	4	0	1	0	0	1
63155	99110	4	2	1	0	0	3
63155	449057	3	0	3	0	0	3
63155	449065	3	1	1	0	1	3
63155	449070	3	1	1	0	0	2
63155	449073	3	2	2	0	0	4
63155	449075	3	1	1	0	1	3
63155	449076	3	0	1	0	0	1
63155	449078	3	0	1	0	0	1
63155	449079	3	0	1	0	0	1
63155	449087	3	1	1	0	0	2
63155	449089	3	0	0	0	0	0
63155	449094	3	0	2	0	0	2
63155	449106	3	1	2	0	0	3
63155	449107	3	1	0	0	0	1
63155	449108	3	1	0	0	0	1
63155	449109	3	1	1	0	0	2
63155	449121	3	0	2	0	0	2
63155	449124	3	1	1	0	1	3
63155	449125	3	1	1	0	0	2
63155	449127	3	0	1	0	0	1
63155	54436	3	0	2	1	0	3
63155	61709	3	0	1	0	0	1
63155	449072	2	1	1	0	1	3
63155	449080	2	0	0	0	0	0
63155	449085	2	1	2	0	0	3
63155	449092	2	0	2	0	0	2
63155	449095	2	1	2	0	0	3
63155	449099	2	0	1	0	0	1
63155	449100	2	0	1	0	0	1
63155	449101	2	0	1	0	0	1
63155	449104	2	0	1	0	0	1
63155	449110	2	0	1	0	0	1
63155	449113	2	2	1	0	1	4
63155	449115	2	1	1	0	0	2
63155	449117	2	1	3	0	0	4
63155	449119	2	1	2	0	0	3
63155	449120	2	1	1	0	0	2
63155	449123	2	1	1	0	0	2
63155	449126	2	0	2	0	0	2
63155	449130	2	0	1	0	0	1
63155	53951	2	0	1	0	0	1
63155	85852	2	0	2	0	0	2
63155	184474	1	0	1	0	0	1
63155	216746	1	0	1	0	0	1
63155	449058	1	0	2	0	0	2
63155	449071	1	0	1	0	1	2
63155	449090	1	1	1	0	0	2
63155	449112	1	0	2	0	0	2
63155	55291	1	0	0	0	0	0
15539	201390	27	2	3	2	2	9
15539	550320	26	6	3	2	9	20
15539	203802	23	7	8	1	0	16
15539	200922	22	1	4	0	0	5
15539	210451	15	0	8	0	1	9
15539	276672	12	1	1	0	0	2
15539	550316	11	2	3	1	0	6
15539	276668	9	1	2	0	1	4
15539	550343	9	3	1	0	1	5
15539	211526	8	1	1	1	1	4
15539	550309	7	2	0	0	2	4
15539	550337	7	1	1	0	0	2
15539	550346	7	1	1	0	1	3
15539	556311	7	2	1	0	0	3
15539	214838	6	0	0	0	0	0
15539	276667	6	0	3	1	1	5
15539	550308	6	1	1	1	1	4
15539	550323	6	2	1	1	2	6
15539	550338	6	0	0	0	0	0
15539	550341	6	1	1	0	2	4
15539	550342	6	3	3	0	2	8
15539	550366	6	2	0	0	0	2
15539	206195	5	2	2	0	1	5
15539	276669	5	0	0	0	0	0
15539	550318	5	1	1	2	0	4
15539	550329	5	1	1	0	1	3
15539	550331	5	1	1	0	0	2
15539	550345	5	4	1	1	1	7
15539	550353	5	2	1	0	0	3
15539	550359	5	0	3	0	0	3
15539	183246	4	1	1	0	0	2
15539	187229	4	1	1	0	0	2
15539	218982	4	1	1	0	0	2
15539	276673	4	0	0	0	0	0
15539	550330	4	0	1	0	0	1
15539	550334	4	1	1	0	2	4
15539	550340	4	1	1	0	2	4
15539	550347	4	4	3	0	0	7
15539	550354	4	1	1	0	0	2
15539	550358	4	3	0	0	0	3
15539	556309	4	0	2	1	1	4
15539	193573	3	2	2	0	0	4
15539	198570	3	0	1	0	0	1
15539	203040	3	1	2	0	0	3
15539	205525	3	0	0	0	0	0
15539	212385	3	0	0	0	1	1
15539	214412	3	1	1	0	1	3
15539	216006	3	0	1	0	2	3
15539	218030	3	0	2	0	0	2
15539	221012	3	2	1	0	1	4
15539	276670	3	1	0	1	2	4
15539	276671	3	0	0	0	4	4
15539	550310	3	1	1	0	1	3
15539	550311	3	1	1	0	1	3
15539	550312	3	0	0	0	0	0
15539	550317	3	0	0	0	0	0
15539	550319	3	1	0	0	0	1
15539	550327	3	0	0	0	0	0
15539	550328	3	0	0	0	0	0
15539	550335	3	3	0	0	0	3
15539	550339	3	0	1	0	2	3
15539	550348	3	1	1	0	0	2
15539	550350	3	1	1	0	2	4
15539	550357	3	0	1	1	1	3
15539	550360	3	3	0	0	0	3
15539	550361	3	2	0	0	0	2
15539	550363	3	4	1	0	2	7
15539	550364	3	1	0	0	0	1
15539	550367	3	0	1	0	1	2
15539	550371	3	0	1	0	1	2
15539	550372	3	3	1	0	1	5
15539	556308	3	0	0	0	0	0
15539	556310	3	0	2	0	1	3
15539	195664	2	1	1	0	0	2
15539	202971	2	0	2	0	0	2
15539	211108	2	0	0	0	1	1
15539	215716	2	1	0	0	0	1
15539	219004	2	1	2	0	0	3
15539	276664	2	0	1	0	2	3
15539	276665	2	0	2	0	0	2
15539	276666	2	0	2	0	0	2
15539	550313	2	1	1	0	0	2
15539	550324	2	3	3	0	0	6
15539	550332	2	0	1	0	0	1
15539	550333	2	0	1	0	0	1
15539	550336	2	2	0	0	1	3
15539	550344	2	1	0	0	1	2
15539	550351	2	0	0	0	0	0
15539	550352	2	0	0	1	1	2
15539	550362	2	1	2	0	0	3
15539	550370	2	1	0	0	1	2
15539	550373	2	1	0	3	0	4
15539	550374	2	0	0	0	0	0
15539	183958	1	0	1	0	0	1
15539	190078	1	0	1	0	0	1
15539	195641	1	0	1	0	1	2
15539	276674	1	0	0	0	0	0
15539	550314	1	0	0	0	0	0
15539	550315	1	2	0	0	3	5
15539	550321	1	0	0	0	1	1
15539	550322	1	1	1	0	2	4
15539	550325	1	0	0	0	1	1
15539	550326	1	1	0	0	1	2
15539	550349	1	0	0	0	0	0
15539	550355	1	0	0	0	0	0
15539	550356	1	1	1	0	0	2
15539	550365	1	1	1	0	0	2
15539	550368	1	0	1	0	0	1
15539	550369	1	0	1	0	0	1
7614	56749	72	7	11	5	10	33
7614	284925	71	7	11	5	10	33
7614	198755	54	3	4	3	0	10
7614	284923	54	3	3	3	0	9
7614	74312	54	3	3	3	0	9
7614	555094	49	1	6	3	13	23
7614	61882	41	2	2	2	6	12
7614	555081	35	2	1	1	2	6
7614	102476	31	1	1	0	4	6
7614	182812	31	1	2	2	5	10
7614	284924	31	1	2	2	5	10
7614	49485	31	1	2	2	5	10
7614	103434	30	0	3	2	2	7
7614	555090	24	1	5	2	3	11
7614	51263	18	1	1	2	1	5
7614	188406	17	1	1	0	0	2
7614	284915	17	1	1	0	0	2
7614	284927	16	5	0	0	0	5
7614	555047	16	4	2	0	1	7
7614	555096	16	5	0	0	0	5
7614	91292	16	5	0	0	0	5
7614	284916	13	4	2	0	1	7
7614	555058	13	1	1	1	2	5
7614	86469	13	4	2	0	1	7
7614	92978	13	0	0	1	1	2
7614	96176	13	2	2	0	5	9
7614	50223	12	1	1	0	2	4
7614	555098	12	2	1	1	2	6
7614	555103	12	2	6	1	2	11
7614	284926	11	3	2	1	8	14
7614	52188	11	3	2	1	8	14
7614	204143	10	1	0	0	0	1
7614	284921	10	1	1	0	1	3
7614	555073	10	1	1	0	1	3
7614	90481	10	1	1	0	1	3
7614	191762	9	1	1	0	0	2
7614	284922	9	1	0	0	0	1
7614	555041	9	2	3	0	1	6
7614	555043	9	1	0	1	0	2
7614	555085	9	0	1	0	0	1
7614	84368	9	1	0	0	0	1
7614	284917	8	1	1	0	0	2
7614	555056	8	1	1	1	3	6
7614	555061	8	0	0	1	2	3
7614	64247	8	1	1	0	0	2
7614	196867	7	2	0	0	0	2
7614	212582	7	0	0	0	1	1
7614	555046	7	0	0	0	2	2
7614	555053	7	4	1	0	1	6
7614	555062	7	2	1	1	1	5
7614	555077	7	1	0	0	0	1
7614	555079	7	2	0	2	2	6
7614	555052	6	0	1	0	1	2
7614	555066	6	0	1	1	1	3
7614	555076	6	2	3	0	0	5
7614	555089	6	2	1	0	0	3
7614	555101	6	1	4	1	2	8
7614	68894	6	1	2	0	1	4
7614	284918	5	1	1	0	0	2
7614	284919	5	2	0	0	1	3
7614	555057	5	0	1	1	1	3
7614	555060	5	2	2	0	2	6
7614	555082	5	1	3	1	1	6
7614	555088	5	0	1	0	2	3
7614	555091	5	5	1	1	1	8
7614	555092	5	0	0	1	0	1
7614	555099	5	1	2	0	0	3
7614	61866	5	2	0	0	1	3
7614	74056	5	0	0	1	3	4
7614	188564	4	0	2	0	1	3
7614	205814	4	0	1	0	0	1
7614	555051	4	5	2	0	2	9
7614	555059	4	1	2	0	2	5
7614	555070	4	1	1	0	1	3
7614	555071	4	0	0	0	1	1
7614	555074	4	2	3	1	1	7
7614	555075	4	1	2	0	0	3
7614	555078	4	1	0	0	1	2
7614	555084	4	3	0	0	0	3
7614	555086	4	0	0	0	0	0
7614	555087	4	0	3	0	5	8
7614	555093	4	2	3	0	1	6
7614	555100	4	2	2	0	1	5
7614	555102	4	0	4	1	1	6
7614	203995	3	0	1	0	0	1
7614	284914	3	1	1	0	1	3
7614	284920	3	0	0	0	0	0
7614	555042	3	0	0	0	1	1
7614	555044	3	0	0	0	0	0
7614	555049	3	1	0	0	0	1
7614	555054	3	0	0	2	0	2
7614	555063	3	0	0	0	1	1
7614	555064	3	1	0	0	1	2
7614	555067	3	0	0	0	0	0
7614	555072	3	1	1	0	0	2
7614	555097	3	0	1	0	2	3
7614	75599	3	0	0	0	0	0
7614	83950	3	1	1	0	1	3
7614	555045	2	0	0	0	0	0
7614	555048	2	0	0	0	1	1
7614	555050	2	1	2	0	1	4
7614	555083	2	0	0	1	0	1
7614	555095	2	0	2	0	1	3
7614	208470	1	0	0	0	0	0
7614	555055	1	0	0	0	0	0
7614	555065	1	0	1	0	2	3
7614	555068	1	0	3	0	1	4
7614	555069	1	0	1	0	0	1
7614	555080	1	0	0	1	1	2
63777	63902	57	2	2	1	0	5
63777	79695	43	3	1	4	2	10
63777	68944	42	2	2	0	3	7
63777	52033	34	2	3	2	1	8
63777	90446	31	3	2	3	4	12
63777	300077	29	4	5	0	2	11
63777	97805	29	4	5	0	2	11
63777	93444	28	2	2	0	0	4
63777	492147	27	2	2	0	0	4
63777	107570	26	1	4	1	2	8
63777	103528	24	0	0	3	0	3
63777	58509	21	2	5	1	1	9
63777	80858	21	2	1	1	0	4
63777	300079	20	0	2	0	0	2
63777	53208	20	0	2	0	0	2
63777	300081	18	0	0	0	0	0
63777	300076	17	5	1	1	1	8
63777	50123	17	5	1	1	1	8
63777	106287	16	1	1	0	1	3
63777	148863	16	0	0	3	2	5
63777	219416	16	1	1	0	1	3
63777	492119	15	5	2	1	1	9
63777	492098	13	0	2	1	1	4
63777	300078	12	1	8	0	4	13
63777	492144	12	1	2	0	1	4
63777	71340	12	1	8	0	4	13
63777	492142	11	5	2	1	0	8
63777	188572	10	1	0	0	2	3
63777	300082	10	1	0	0	2	3
63777	492101	10	0	3	0	0	3
63777	59298	10	0	1	0	0	1
63777	59945	10	1	0	0	2	3
63777	93019	10	2	1	0	0	3
63777	204160	9	0	1	0	0	1
63777	492133	9	0	0	0	0	0
63777	492145	9	2	1	0	0	3
63777	107472	8	0	0	1	1	2
63777	492111	8	0	1	0	2	3
63777	492116	8	1	1	0	0	2
63777	492127	8	0	0	0	0	0
63777	53158	8	1	2	1	0	4
63777	492110	7	0	0	1	0	1
63777	492141	7	3	0	1	2	6
63777	492148	7	0	1	0	0	1
63777	300080	6	0	2	0	1	3
63777	492094	6	0	1	0	0	1
63777	492100	6	1	4	0	0	5
63777	492103	6	1	3	0	0	4
63777	492107	6	1	0	0	0	1
63777	53476	6	1	3	0	0	4
63777	77895	6	0	0	0	0	0
63777	492099	5	1	0	0	0	1
63777	492106	5	1	1	1	0	3
63777	492109	5	1	1	0	0	2
63777	492134	5	2	0	0	0	2
63777	85296	5	0	0	0	1	1
63777	300073	4	1	0	0	0	1
63777	492096	4	2	2	1	0	5
63777	492105	4	0	1	0	0	1
63777	492114	4	0	1	0	1	2
63777	492139	4	2	2	0	0	4
63777	74978	4	1	0	0	0	1
63777	193366	3	1	0	0	0	1
63777	300075	3	0	1	0	0	1
63777	492092	3	0	2	0	0	2
63777	492095	3	0	0	0	1	1
63777	492113	3	1	1	0	0	2
63777	492115	3	0	0	0	0	0
63777	492117	3	0	0	1	0	1
63777	492118	3	0	1	0	0	1
63777	492123	3	0	2	0	0	2
63777	492126	3	0	1	0	0	1
63777	492128	3	0	0	0	0	0
63777	492131	3	0	2	0	0	2
63777	492136	3	0	1	0	0	1
63777	492138	3	1	2	0	0	3
63777	492140	3	1	0	0	0	1
63777	58618	3	0	0	0	0	0
63777	71456	3	0	1	0	0	1
63777	92955	3	1	0	1	0	2
63777	184329	2	1	0	0	0	1
63777	300074	2	0	1	0	0	1
63777	492091	2	0	0	0	0	0
63777	492104	2	0	1	0	0	1
63777	492108	2	0	1	0	0	1
63777	492120	2	0	0	0	0	0
63777	492121	2	0	0	0	0	0
63777	492122	2	0	2	0	0	2
63777	492124	2	1	0	0	0	1
63777	492125	2	0	4	0	0	4
63777	492129	2	0	1	0	0	1
63777	492132	2	1	2	0	0	3
63777	492143	2	2	2	0	0	4
63777	492149	2	0	1	0	2	3
63777	87686	2	0	1	0	0	1
63777	92166	2	0	0	0	0	0
63777	191501	1	0	1	0	0	1
63777	492090	1	0	0	0	0	0
63777	492093	1	1	1	0	0	2
63777	492097	1	3	1	0	0	4
63777	492102	1	0	2	0	1	3
63777	492112	1	0	0	0	0	0
63777	492130	1	1	1	0	0	2
63777	492135	1	0	0	0	0	0
63777	492137	1	0	1	0	0	1
63777	492146	1	1	0	0	0	1
63777	72555	1	1	0	0	0	1
63777	83517	1	0	1	0	0	1
54546	406196	28	1	1	0	3	5
54546	406146	22	1	1	2	0	4
54546	95615	22	5	0	2	1	8
54546	85021	15	1	3	0	2	6
54546	297491	13	2	1	0	1	4
54546	406149	13	2	1	0	1	4
54546	406195	13	4	1	3	0	8
54546	61998	13	2	1	0	1	4
54546	406163	11	0	4	2	0	6
54546	406203	11	2	2	0	0	4
54546	196293	10	0	0	0	2	2
54546	406182	10	2	3	0	1	6
54546	182512	9	1	0	0	1	2
54546	188274	8	1	2	0	0	3
54546	212314	8	1	3	0	1	5
54546	406148	8	4	0	0	0	4
54546	406154	8	2	2	0	1	5
54546	406155	8	2	4	1	1	8
54546	406158	8	1	3	0	1	5
54546	406192	8	1	0	0	0	1
54546	406205	8	1	0	1	0	2
54546	406160	7	3	2	0	1	6
54546	406166	7	3	2	0	0	5
54546	406193	7	2	1	0	1	4
54546	406197	7	1	3	2	0	6
54546	406209	7	4	0	0	0	4
54546	196729	6	0	1	0	1	2
54546	297494	6	1	0	1	0	2
54546	406143	6	0	0	1	2	3
54546	406161	6	4	1	0	2	7
54546	406173	6	2	3	0	1	6
54546	406178	6	2	1	0	0	3
54546	406179	6	1	3	1	1	6
54546	406187	6	0	0	1	0	1
54546	406189	6	1	1	0	1	3
54546	406194	6	1	1	1	1	4
54546	406207	6	2	1	1	1	5
54546	55201	6	3	1	0	1	5
54546	85088	6	0	4	2	3	9
54546	97986	6	1	0	1	0	2
54546	193610	5	2	2	0	0	4
54546	297492	5	2	0	1	2	5
54546	406147	5	1	0	0	3	4
54546	406168	5	2	1	0	1	4
54546	406175	5	0	0	0	1	1
54546	406176	5	1	1	2	0	4
54546	406181	5	1	2	0	2	5
54546	406184	5	0	0	0	0	0
54546	84732	5	2	0	1	2	5
54546	101157	4	1	0	0	2	3
54546	182337	4	0	0	0	0	0
54546	184404	4	1	0	0	1	2
54546	185766	4	0	3	0	2	5
54546	208205	4	4	0	0	1	5
54546	297495	4	1	0	0	2	3
54546	406135	4	0	1	2	2	5
54546	406137	4	0	1	1	2	4
54546	406140	4	1	0	0	2	3
54546	406145	4	1	1	0	0	2
54546	406156	4	1	2	0	0	3
54546	406159	4	2	2	0	1	5
54546	406169	4	1	0	0	1	2
54546	406172	4	1	1	0	0	2
54546	406174	4	0	0	1	0	1
54546	406202	4	1	2	1	0	4
54546	406204	4	1	0	0	1	2
54546	51187	4	0	1	0	0	1
54546	190773	3	0	0	0	0	0
54546	206715	3	2	0	0	1	3
54546	406141	3	3	1	0	0	4
54546	406142	3	1	1	0	1	3
54546	406151	3	1	0	1	1	3
54546	406157	3	0	0	0	0	0
54546	406164	3	0	0	0	2	2
54546	406165	3	0	1	0	1	2
54546	406170	3	1	1	0	1	3
54546	406177	3	0	4	1	0	5
54546	406180	3	1	2	0	1	4
54546	406183	3	0	2	0	0	2
54546	406185	3	2	0	0	1	3
54546	406186	3	0	1	0	2	3
54546	406188	3	0	0	0	1	1
54546	406191	3	0	1	0	1	2
54546	406200	3	3	0	0	0	3
54546	406201	3	1	0	0	2	3
54546	406208	3	0	0	1	2	3
54546	79603	3	0	0	0	0	0
54546	182222	2	1	0	0	1	2
54546	202069	2	0	0	0	1	1
54546	211074	2	1	0	0	1	2
54546	297493	2	2	2	0	1	5
54546	406134	2	0	0	0	2	2
54546	406136	2	0	0	1	0	1
54546	406138	2	1	0	0	1	2
54546	406139	2	0	1	0	1	2
54546	406144	2	0	0	0	0	0
54546	406150	2	0	0	0	1	1
54546	406153	2	0	0	0	0	0
54546	406162	2	0	0	1	0	1
54546	406167	2	0	1	0	2	3
54546	406171	2	2	1	0	2	5
54546	406198	2	1	1	0	1	3
54546	406199	2	1	2	0	0	3
54546	406206	2	1	1	0	0	2
54546	71498	2	2	2	0	1	5
54546	194718	1	0	0	0	0	0
54546	406152	1	0	1	0	0	1
54546	406190	1	0	0	0	0	0
35625	503881	12	1	1	0	0	2
35625	503836	11	1	0	0	5	6
35625	503840	10	0	0	1	0	1
35625	503797	9	1	5	1	0	7
35625	503819	9	4	1	0	0	5
35625	503804	8	2	2	0	0	4
35625	503815	8	4	2	1	0	7
35625	503875	8	1	0	0	0	1
35625	503813	7	4	1	0	0	5
35625	503850	7	2	0	0	1	3
35625	503859	7	2	2	0	0	4
35625	503885	7	2	0	0	0	2
35625	503855	6	0	0	0	1	1
35625	503858	6	1	0	0	0	1
35625	503860	6	3	1	0	0	4
35625	503807	5	1	0	0	0	1
35625	503811	5	2	0	0	1	3
35625	503834	5	0	0	0	0	0
35625	503838	5	2	1	0	0	3
35625	503839	5	0	0	0	2	2
35625	503861	5	0	1	0	0	1
35625	503880	5	4	0	0	0	4
35625	503888	5	5	0	0	0	5
35625	279097	4	1	0	0	0	1
35625	503800	4	3	2	1	1	7
35625	503801	4	5	0	0	0	5
35625	503805	4	1	1	0	0	2
35625	503820	4	3	0	0	0	3
35625	503829	4	3	0	0	0	3
35625	503854	4	1	0	0	0	1
35625	503867	4	2	1	0	0	3
35625	503879	4	1	1	0	1	3
35625	503882	4	2	0	0	0	2
35625	503899	4	3	0	0	0	3
35625	78517	4	2	0	0	0	2
35625	503796	3	2	0	0	0	2
35625	503798	3	0	0	0	0	0
35625	503799	3	0	0	0	0	0
35625	503802	3	3	0	0	0	3
35625	503809	3	2	0	0	0	2
35625	503814	3	0	0	0	0	0
35625	503817	3	2	0	0	0	2
35625	503821	3	2	0	0	0	2
35625	503828	3	3	1	0	0	4
35625	503832	3	0	0	0	1	1
35625	503841	3	0	1	0	1	2
35625	503851	3	2	0	0	0	2
35625	503868	3	1	2	1	0	4
35625	503872	3	1	0	0	0	1
35625	503891	3	0	0	0	0	0
35625	503892	3	0	0	0	0	0
35625	503895	3	2	0	0	0	2
35625	503900	3	1	0	0	0	1
35625	503810	2	0	0	0	1	1
35625	503812	2	2	0	0	0	2
35625	503816	2	1	3	0	0	4
35625	503823	2	2	0	0	0	2
35625	503824	2	4	1	0	0	5
35625	503825	2	5	0	0	0	5
35625	503827	2	2	1	0	0	3
35625	503833	2	1	0	0	0	1
35625	503845	2	3	1	0	0	4
35625	503847	2	2	0	0	0	2
35625	503848	2	3	0	0	0	3
35625	503849	2	1	0	0	0	1
35625	503853	2	2	1	0	0	3
35625	503856	2	0	0	0	0	0
35625	503857	2	1	0	0	0	1
35625	503869	2	2	0	0	0	2
35625	503873	2	0	0	0	0	0
35625	503876	2	2	0	0	0	2
35625	503883	2	3	1	0	0	4
35625	503884	2	1	0	0	0	1
35625	503889	2	2	0	0	0	2
35625	503890	2	1	0	0	0	1
35625	503898	2	0	1	0	0	1
35625	503794	1	1	0	0	0	1
35625	503795	1	0	1	0	0	1
35625	503803	1	1	0	0	0	1
35625	503806	1	0	0	0	0	0
35625	503808	1	1	0	0	0	1
35625	503818	1	1	0	0	0	1
35625	503822	1	1	0	0	0	1
35625	503826	1	1	1	0	0	2
35625	503830	1	1	0	0	0	1
35625	503831	1	0	0	0	0	0
35625	503835	1	4	2	0	2	8
35625	503837	1	1	0	0	0	1
35625	503842	1	2	0	0	0	2
35625	503844	1	1	0	0	0	1
35625	503846	1	0	0	0	1	1
35625	503852	1	0	0	0	0	0
35625	503862	1	1	0	0	0	1
35625	503863	1	0	0	0	0	0
35625	503864	1	1	0	0	0	1
35625	503865	1	2	0	0	0	2
35625	503866	1	1	1	0	0	2
35625	503870	1	1	0	0	0	1
35625	503871	1	1	0	0	0	1
35625	503874	1	2	0	0	0	2
35625	503877	1	2	0	0	0	2
35625	503878	1	2	0	0	0	2
35625	503886	1	1	0	0	0	1
35625	503887	1	3	0	0	0	3
35625	503893	1	0	0	0	0	0
35625	503894	1	3	0	0	0	3
35625	503896	1	1	1	0	0	2
35625	503897	1	2	0	0	0	2
968	203082	44	2	1	0	1	4
968	283191	38	5	1	0	3	9
968	65909	38	5	1	0	3	9
968	283188	24	2	0	0	1	3
968	76318	24	2	0	0	1	3
968	200800	23	2	0	0	0	2
968	103424	21	0	2	0	1	3
968	217622	15	3	3	0	1	7
968	407020	15	1	0	0	2	3
968	100941	11	2	1	0	3	6
968	283213	11	2	1	0	3	6
968	101949	10	2	2	0	3	7
968	214797	10	2	2	0	3	7
968	283190	9	1	2	1	3	7
968	283194	9	2	1	1	1	5
968	283197	9	1	2	0	1	4
968	283207	9	5	0	1	3	9
968	70906	9	5	0	1	3	9
968	200200	8	2	0	1	0	3
968	218565	8	1	1	0	2	4
968	283192	8	1	3	0	0	4
968	283195	8	3	1	1	2	7
968	283201	8	1	3	1	3	8
968	283203	8	1	1	0	2	4
968	283212	8	2	2	0	3	7
968	591151	8	3	2	0	1	6
968	71075	8	3	1	1	2	7
968	81019	8	0	3	2	0	5
968	93613	8	1	1	0	2	4
968	283186	7	4	2	0	3	9
968	407018	7	2	1	0	0	3
968	57414	7	4	2	0	3	9
968	68796	7	1	0	0	0	1
968	100009	6	0	3	1	1	5
968	101564	6	2	0	0	2	4
968	183226	6	3	0	0	1	4
968	190439	6	1	3	2	5	11
968	193524	6	2	3	0	2	7
968	199163	6	0	2	0	1	3
968	215092	6	1	2	0	1	4
968	217356	6	2	0	0	0	2
968	283182	6	0	3	1	1	5
968	283184	6	3	0	1	0	4
968	283189	6	0	0	0	0	0
968	283199	6	2	0	0	2	4
968	407019	6	0	1	0	2	3
968	407021	6	0	2	0	2	4
968	591145	6	3	2	0	2	7
968	197293	5	0	2	0	2	4
968	283185	5	1	0	0	0	1
968	283200	5	1	1	0	0	2
968	591141	5	0	1	0	0	1
968	591144	5	0	2	0	0	2
968	66655	5	1	1	0	0	2
968	182302	4	4	0	0	0	4
968	185563	4	1	1	0	1	3
968	189399	4	0	1	0	1	2
968	198605	4	1	0	0	0	1
968	208102	4	3	1	1	1	6
968	211815	4	1	2	0	0	3
968	216718	4	2	5	0	1	8
968	217266	4	0	2	0	1	3
968	218640	4	2	1	0	1	4
968	219863	4	0	2	0	0	2
968	283183	4	0	1	1	1	3
968	283187	4	1	0	0	2	3
968	283198	4	1	2	0	1	4
968	283204	4	0	2	0	1	3
968	283205	4	1	0	0	1	2
968	283210	4	1	0	0	0	1
968	407017	4	1	2	0	1	4
968	591143	4	1	0	0	2	3
968	591147	4	1	1	0	1	3
968	591153	4	2	1	0	2	5
968	70806	4	1	0	0	0	1
968	76239	4	1	2	0	1	4
968	90503	4	0	1	1	1	3
968	108406	3	0	1	0	0	1
968	184803	3	0	0	0	0	0
968	196543	3	2	2	0	0	4
968	199902	3	1	3	0	0	4
968	204813	3	0	1	0	2	3
968	213821	3	0	2	0	1	3
968	220777	3	0	0	0	1	1
968	283202	3	0	1	0	0	1
968	283209	3	0	0	0	0	0
968	283211	3	0	0	0	0	0
968	54083	3	0	0	0	0	0
968	591149	3	1	0	0	1	2
968	72412	3	0	0	0	0	0
968	101325	2	1	2	0	0	3
968	196445	2	1	0	0	1	2
968	208585	2	1	0	0	1	2
968	219790	2	0	1	0	1	2
968	283193	2	2	0	0	0	2
968	283206	2	0	0	0	1	1
968	283208	2	1	1	1	0	3
968	591142	2	0	1	0	1	2
968	591150	2	0	0	0	1	1
968	98487	2	2	0	0	0	2
968	215273	1	0	0	0	0	0
968	283196	1	1	0	0	0	1
968	591146	1	0	1	0	0	1
968	591148	1	0	2	0	0	2
968	591152	1	1	1	0	1	3
968	70948	1	1	0	0	0	1
49117	520468	31	8	8	3	3	22
49117	191514	30	1	5	1	5	12
49117	520439	28	1	5	1	5	12
49117	63869	28	1	5	1	5	12
49117	50591	24	3	3	2	4	12
49117	201000	17	2	4	2	1	9
49117	217838	16	2	1	0	0	3
49117	520469	10	2	1	0	1	4
49117	520477	10	3	1	0	2	6
49117	520441	9	0	2	0	2	4
49117	65428	9	3	2	0	0	5
49117	106659	8	0	3	0	1	4
49117	520470	8	3	0	0	1	4
49117	520471	8	4	1	0	1	6
49117	79666	8	2	2	0	6	10
49117	220166	7	0	2	0	0	2
49117	520427	7	0	2	0	0	2
49117	520430	7	1	4	0	0	5
49117	520458	7	0	1	0	2	3
49117	520478	7	1	0	0	0	1
49117	520483	7	2	1	0	1	4
49117	520486	7	3	0	0	2	5
49117	296192	6	3	1	0	0	4
49117	520426	6	0	0	0	0	0
49117	520440	6	4	0	0	0	4
49117	520445	6	1	0	0	0	1
49117	520455	6	2	4	0	0	6
49117	520479	6	1	1	1	0	3
49117	520484	6	1	0	0	0	1
49117	90966	6	3	1	0	0	4
49117	203515	5	0	2	0	0	2
49117	213466	5	0	2	0	0	2
49117	216260	5	0	1	0	0	1
49117	520428	5	0	1	0	0	1
49117	520431	5	1	3	0	3	7
49117	520435	5	2	1	0	0	3
49117	520437	5	4	2	0	6	12
49117	520446	5	1	0	0	2	3
49117	520450	5	2	2	0	0	4
49117	520475	5	0	0	0	1	1
49117	54669	5	2	2	0	0	4
49117	95722	5	0	0	0	0	0
49117	204240	4	0	1	0	0	1
49117	211035	4	0	0	0	0	0
49117	211036	4	0	0	0	0	0
49117	219898	4	0	0	0	0	0
49117	520432	4	0	1	0	0	1
49117	520433	4	0	1	0	1	2
49117	520447	4	2	2	0	0	4
49117	520451	4	0	0	0	1	1
49117	520456	4	1	1	0	0	2
49117	520457	4	3	0	0	1	4
49117	520459	4	0	0	0	0	0
49117	520465	4	1	1	0	1	3
49117	520473	4	1	0	0	2	3
49117	520480	4	0	2	0	0	2
49117	520481	4	0	0	0	0	0
49117	520485	4	0	1	0	0	1
49117	520488	4	2	2	0	0	4
49117	520490	4	1	1	0	1	3
49117	212957	3	0	2	0	2	4
49117	296194	3	1	1	0	0	2
49117	296195	3	1	0	1	0	2
49117	520416	3	0	2	0	0	2
49117	520425	3	0	3	0	1	4
49117	520429	3	5	0	0	0	5
49117	520436	3	0	0	0	0	0
49117	520438	3	0	1	0	0	1
49117	520443	3	1	0	0	0	1
49117	520452	3	0	1	0	1	2
49117	520453	3	1	2	0	0	3
49117	520454	3	0	0	0	0	0
49117	520460	3	1	2	0	0	3
49117	520461	3	1	1	0	0	2
49117	520463	3	3	2	0	0	5
49117	520482	3	1	3	0	0	4
49117	520487	3	0	0	0	0	0
49117	520494	3	0	0	0	0	0
49117	520495	3	1	1	0	0	2
49117	84463	3	1	1	0	0	2
49117	196446	2	0	0	0	0	0
49117	520418	2	0	0	0	0	0
49117	520421	2	0	1	0	0	1
49117	520434	2	0	0	0	0	0
49117	520442	2	1	1	0	0	2
49117	520444	2	0	0	0	0	0
49117	520462	2	1	1	0	0	2
49117	520464	2	1	1	0	0	2
49117	520472	2	1	2	0	0	3
49117	520474	2	0	1	0	0	1
49117	520476	2	0	0	0	0	0
49117	520489	2	0	1	0	0	1
49117	520496	2	0	0	0	0	0
49117	520417	1	0	1	0	1	2
49117	520419	1	0	1	0	0	1
49117	520420	1	0	0	0	0	0
49117	520422	1	0	0	0	0	0
49117	520423	1	0	0	0	0	0
49117	520424	1	1	1	0	1	3
49117	520448	1	1	0	0	0	1
49117	520449	1	0	0	0	1	1
49117	520466	1	1	0	0	0	1
49117	520467	1	0	0	0	0	0
49117	520491	1	0	1	0	1	2
49117	520492	1	0	2	0	2	4
49117	520493	1	0	0	0	0	0
49117	54487	1	0	1	0	0	1
8720	616525	16	1	4	1	0	6
8720	186143	14	1	1	0	1	3
8720	275799	13	1	1	0	1	3
8720	616569	13	2	1	1	1	5
8720	616528	11	2	0	0	1	3
8720	219031	9	0	0	2	0	2
8720	616529	9	1	3	2	0	6
8720	616587	9	0	0	0	1	1
8720	616588	9	1	3	1	0	5
8720	616591	9	3	2	0	2	7
8720	616602	9	0	2	0	1	3
8720	616519	8	1	2	0	2	5
8720	616527	8	2	2	0	1	5
8720	616555	8	0	2	0	1	3
8720	616559	8	1	2	0	1	4
8720	616524	7	1	2	0	0	3
8720	616521	6	1	0	0	1	2
8720	616523	6	0	0	0	0	0
8720	616541	6	1	1	1	1	4
8720	616550	6	1	2	2	0	5
8720	616552	6	0	0	0	3	3
8720	616563	6	0	3	0	2	5
8720	616565	6	1	0	0	0	1
8720	616570	6	0	2	0	1	3
8720	616586	6	0	0	0	0	0
8720	616592	6	0	1	0	0	1
8720	616605	6	0	0	0	0	0
8720	192662	5	0	0	0	0	0
8720	209483	5	2	2	1	1	6
8720	275802	5	0	0	0	0	0
8720	616526	5	1	0	0	0	1
8720	616531	5	1	0	0	2	3
8720	616535	5	0	1	0	2	3
8720	616539	5	0	1	0	0	1
8720	616544	5	0	0	0	0	0
8720	616551	5	1	0	0	1	2
8720	616573	5	1	1	0	3	5
8720	616600	5	1	0	0	0	1
8720	616606	5	1	0	0	1	2
8720	616609	5	1	1	0	1	3
8720	616517	4	2	1	0	3	6
8720	616522	4	1	2	0	1	4
8720	616530	4	0	0	0	0	0
8720	616534	4	1	2	0	2	5
8720	616542	4	0	2	0	2	4
8720	616545	4	2	0	0	0	2
8720	616547	4	0	1	0	4	5
8720	616548	4	1	0	0	2	3
8720	616557	4	1	2	0	0	3
8720	616562	4	1	3	0	5	9
8720	616564	4	1	1	0	0	2
8720	616566	4	0	1	0	1	2
8720	616567	4	0	2	0	1	3
8720	616579	4	1	1	0	1	3
8720	616585	4	1	2	0	0	3
8720	616589	4	0	0	0	0	0
8720	616590	4	0	0	0	0	0
8720	616595	4	0	0	0	1	1
8720	616603	4	2	0	0	0	2
8720	195770	3	0	1	0	1	2
8720	616532	3	2	0	0	1	3
8720	616533	3	2	2	0	1	5
8720	616537	3	1	1	0	0	2
8720	616549	3	1	1	0	1	3
8720	616553	3	0	0	1	0	1
8720	616554	3	0	0	0	0	0
8720	616568	3	1	1	0	0	2
8720	616574	3	0	1	0	3	4
8720	616580	3	0	1	0	0	1
8720	616582	3	1	0	0	1	2
8720	616593	3	2	0	1	0	3
8720	616594	3	1	0	1	0	2
8720	616596	3	1	0	0	0	1
8720	616599	3	0	1	0	3	4
8720	616601	3	0	0	0	0	0
8720	616604	3	0	0	0	0	0
8720	616607	3	0	2	0	1	3
8720	616608	3	1	1	0	2	4
8720	187514	2	0	0	0	1	1
8720	219832	2	0	1	0	0	1
8720	275800	2	0	0	1	0	1
8720	275801	2	1	1	0	1	3
8720	275803	2	0	1	0	0	1
8720	616520	2	2	2	0	1	5
8720	616536	2	0	0	0	1	1
8720	616538	2	0	0	0	0	0
8720	616540	2	0	0	0	0	0
8720	616556	2	0	0	0	0	0
8720	616558	2	0	0	0	1	1
8720	616560	2	0	1	0	0	1
8720	616571	2	1	2	0	0	3
8720	616575	2	1	0	0	1	2
8720	616576	2	1	0	0	1	2
8720	616577	2	0	0	0	1	1
8720	616578	2	0	0	0	0	0
8720	616581	2	1	0	0	0	1
8720	616583	2	0	2	0	0	2
8720	616584	2	0	0	0	0	0
8720	616597	2	1	1	1	1	4
8720	616598	2	0	0	0	0	0
8720	186602	1	0	0	0	1	1
8720	616516	1	1	1	0	1	3
8720	616518	1	0	1	1	1	3
8720	616543	1	1	1	0	1	3
8720	616546	1	1	1	0	0	2
8720	616561	1	0	1	0	0	1
8720	616572	1	0	0	0	0	0
23731	95991	50	6	12	1	4	23
23731	107512	44	7	8	1	2	18
23731	437497	44	7	8	1	2	18
23731	437485	43	4	4	2	4	14
23731	83196	43	4	4	2	4	14
23731	437496	39	5	4	0	3	12
23731	62497	32	5	3	1	1	10
23731	80369	24	4	4	0	4	12
23731	437499	22	2	1	1	1	5
23731	204258	17	1	2	0	2	5
23731	78503	17	0	3	0	0	3
23731	84406	16	1	2	0	2	5
23731	63357	15	7	4	0	0	11
23731	437500	12	0	4	0	0	4
23731	54423	11	1	2	0	2	5
23731	78502	11	1	1	0	2	4
23731	90124	10	1	4	2	6	13
23731	95677	10	1	0	0	2	3
23731	437489	9	3	2	0	0	5
23731	437473	7	0	2	0	0	2
23731	437481	7	0	1	2	0	3
23731	437494	7	4	1	0	0	5
23731	50651	7	4	1	0	0	5
23731	437446	6	1	0	0	3	4
23731	437467	6	1	1	0	1	3
23731	437479	6	1	0	0	0	1
23731	437483	6	0	1	1	4	6
23731	437487	6	3	0	1	1	5
23731	437488	6	2	1	0	0	3
23731	437492	6	1	1	0	2	4
23731	437498	6	5	5	0	4	14
23731	437458	5	2	1	0	1	4
23731	437471	5	0	2	0	1	3
23731	437472	5	1	1	0	1	3
23731	437484	5	2	1	0	2	5
23731	437501	5	1	0	0	0	1
23731	437419	4	1	0	1	0	2
23731	437435	4	0	1	0	0	1
23731	437440	4	0	1	0	3	4
23731	437457	4	2	2	0	0	4
23731	437460	4	4	2	0	1	7
23731	437465	4	1	0	0	0	1
23731	437486	4	1	1	0	1	3
23731	59685	4	0	0	0	0	0
23731	182112	3	0	0	0	1	1
23731	198835	3	0	0	0	0	0
23731	437414	3	0	0	0	0	0
23731	437421	3	3	1	0	0	4
23731	437422	3	2	1	0	0	3
23731	437425	3	1	0	1	0	2
23731	437429	3	0	1	0	0	1
23731	437433	3	0	1	0	2	3
23731	437437	3	2	1	0	0	3
23731	437443	3	0	1	0	0	1
23731	437445	3	0	2	0	0	2
23731	437447	3	0	0	0	1	1
23731	437452	3	0	0	0	1	1
23731	437454	3	1	0	0	0	1
23731	437459	3	2	0	0	0	2
23731	437462	3	0	0	0	1	1
23731	437464	3	1	0	0	0	1
23731	437466	3	0	2	0	2	4
23731	437476	3	2	0	0	0	2
23731	437482	3	0	3	0	0	3
23731	437491	3	1	1	0	0	2
23731	437493	3	0	1	0	0	1
23731	437495	3	2	0	0	1	3
23731	81303	3	0	0	1	0	1
23731	99998	3	1	0	0	0	1
23731	437423	2	0	1	0	1	2
23731	437424	2	2	0	0	0	2
23731	437426	2	0	2	0	0	2
23731	437428	2	0	3	0	0	3
23731	437434	2	0	0	0	0	0
23731	437436	2	0	0	0	0	0
23731	437438	2	0	0	0	1	1
23731	437439	2	2	1	0	0	3
23731	437441	2	1	0	0	1	2
23731	437442	2	0	1	0	0	1
23731	437451	2	2	1	0	0	3
23731	437455	2	1	1	0	0	2
23731	437456	2	1	0	0	2	3
23731	437468	2	0	0	0	0	0
23731	437469	2	4	2	0	0	6
23731	437470	2	0	0	0	0	0
23731	437475	2	1	0	0	0	1
23731	437477	2	2	0	0	0	2
23731	437478	2	0	0	0	0	0
23731	437490	2	0	0	0	0	0
23731	437415	1	0	0	0	0	0
23731	437416	1	0	1	0	1	2
23731	437417	1	1	0	0	1	2
23731	437418	1	0	0	0	1	1
23731	437420	1	0	0	0	0	0
23731	437427	1	0	1	0	0	1
23731	437430	1	1	1	0	0	2
23731	437431	1	0	1	0	1	2
23731	437432	1	0	0	0	1	1
23731	437444	1	1	0	1	0	2
23731	437448	1	0	0	0	1	1
23731	437449	1	0	0	0	0	0
23731	437450	1	1	0	0	0	1
23731	437453	1	0	0	0	1	1
23731	437461	1	1	0	0	0	1
23731	437463	1	0	1	0	1	2
23731	437474	1	1	1	0	1	3
23731	437480	1	2	0	0	0	2
44479	495635	13	1	1	0	0	2
44479	505699	13	6	1	0	1	8
44479	593204	13	3	1	0	0	4
44479	593205	11	3	0	0	0	3
44479	505690	8	0	1	0	0	1
44479	539394	8	1	0	1	0	2
44479	539406	8	1	0	0	0	1
44479	593186	8	2	0	0	0	2
44479	593189	8	1	0	1	2	4
44479	593207	8	1	1	0	1	3
44479	480745	7	1	1	0	1	3
44479	505684	7	3	1	0	5	9
44479	593195	7	1	0	0	1	2
44479	480738	6	4	0	0	0	4
44479	480739	6	3	0	0	0	3
44479	480742	6	2	1	0	0	3
44479	480743	6	0	0	0	0	0
44479	480764	6	2	0	0	0	2
44479	505691	6	3	0	0	1	4
44479	505693	6	2	0	0	0	2
44479	505700	6	1	0	0	2	3
44479	539401	6	3	0	0	1	4
44479	593209	6	1	1	0	1	3
44479	593210	6	0	0	0	0	0
44479	593211	6	3	0	1	2	6
44479	480744	5	0	1	0	0	1
44479	480746	5	4	0	0	0	4
44479	480755	5	2	0	0	0	2
44479	505687	5	0	0	0	1	1
44479	505689	5	2	0	0	0	2
44479	539395	5	2	0	0	0	2
44479	539398	5	4	0	1	0	5
44479	539403	5	4	0	0	1	5
44479	593179	5	3	0	0	0	3
44479	593180	5	1	0	0	0	1
44479	593181	5	4	1	0	0	5
44479	593190	5	0	0	0	0	0
44479	593193	5	1	0	0	0	1
44479	593201	5	1	0	0	1	2
44479	593203	5	0	0	0	0	0
44479	593206	5	3	0	0	0	3
44479	480748	4	6	0	0	0	6
44479	480753	4	1	0	0	0	1
44479	480756	4	1	0	0	0	1
44479	495636	4	1	0	0	0	1
44479	505685	4	3	0	0	0	3
44479	505688	4	0	0	0	2	2
44479	505697	4	1	0	0	0	1
44479	539390	4	1	0	0	1	2
44479	539400	4	2	0	1	1	4
44479	539402	4	1	0	0	0	1
44479	593178	4	2	0	0	0	2
44479	593185	4	1	0	0	0	1
44479	593202	4	1	0	0	2	3
44479	480749	3	2	0	0	0	2
44479	480750	3	0	0	0	0	0
44479	480751	3	0	0	2	0	2
44479	480754	3	0	0	0	0	0
44479	480757	3	1	0	0	0	1
44479	480763	3	0	0	0	0	0
44479	505695	3	0	0	0	1	1
44479	505698	3	2	0	0	1	3
44479	539391	3	1	0	0	0	1
44479	539392	3	1	0	0	0	1
44479	539393	3	0	0	0	2	2
44479	539404	3	1	0	1	1	3
44479	539405	3	2	0	0	0	2
44479	593175	3	0	0	0	1	1
44479	593182	3	2	0	0	0	2
44479	593184	3	2	0	0	0	2
44479	593188	3	2	0	0	0	2
44479	593192	3	0	0	0	0	0
44479	593196	3	4	0	0	0	4
44479	593197	3	0	0	0	0	0
44479	593212	3	0	0	0	0	0
44479	480740	2	0	0	0	0	0
44479	480741	2	2	0	0	0	2
44479	480747	2	2	0	0	1	3
44479	480752	2	2	0	0	0	2
44479	480758	2	1	0	0	0	1
44479	480759	2	0	0	0	0	0
44479	480762	2	1	0	0	0	1
44479	505686	2	1	0	0	0	1
44479	505692	2	4	0	0	1	5
44479	505694	2	2	0	0	0	2
44479	505696	2	1	0	0	0	1
44479	539389	2	1	0	0	1	2
44479	539397	2	1	0	0	0	1
44479	539399	2	2	0	0	0	2
44479	593172	2	2	0	0	0	2
44479	593173	2	0	0	0	1	1
44479	593174	2	1	0	0	0	1
44479	593187	2	2	1	0	0	3
44479	593191	2	3	0	0	0	3
44479	593194	2	2	0	0	1	3
44479	593198	2	1	0	0	0	1
44479	593199	2	2	0	0	0	2
44479	593200	2	2	0	0	0	2
44479	480760	1	1	0	0	0	1
44479	480761	1	1	1	1	0	3
44479	505683	1	0	0	0	0	0
44479	539388	1	0	0	0	0	0
44479	539396	1	0	0	0	0	0
44479	593176	1	0	0	0	0	0
44479	593177	1	3	0	1	0	4
44479	593183	1	0	0	0	1	1
44479	593208	1	0	0	0	1	1
25489	213719	45	2	5	1	2	10
25489	198854	41	2	5	0	2	9
25489	289988	41	2	5	0	2	9
25489	74391	41	2	5	0	2	9
25489	100445	28	0	5	2	0	7
25489	102980	21	1	7	1	2	11
25489	289980	21	1	7	1	2	11
25489	105929	19	1	4	0	1	6
25489	219339	19	1	4	0	1	6
25489	79872	19	1	3	0	0	4
25489	106637	18	1	2	1	0	4
25489	289986	16	1	4	0	1	6
25489	472826	16	1	4	0	1	6
25489	80725	16	1	4	0	1	6
25489	221569	14	1	2	0	2	5
25489	289976	14	0	0	0	0	0
25489	71365	14	0	0	0	0	0
25489	195460	13	0	2	1	0	3
25489	195289	12	0	3	0	1	4
25489	289984	12	1	0	0	0	1
25489	472836	12	1	4	2	2	9
25489	59258	12	1	4	2	2	9
25489	200820	11	1	0	0	0	1
25489	472803	11	0	2	2	0	4
25489	472837	11	0	1	1	3	5
25489	106886	10	3	2	1	2	8
25489	206024	10	0	3	0	2	5
25489	289981	10	1	0	0	0	1
25489	72640	10	3	0	0	3	6
25489	76625	10	1	0	0	0	1
25489	188092	9	0	1	1	0	2
25489	472834	9	0	5	0	0	5
25489	211018	8	0	1	1	0	2
25489	289989	8	0	3	0	0	3
25489	55465	8	0	1	1	0	2
25489	184946	7	0	3	0	0	3
25489	194706	7	0	1	0	2	3
25489	472806	7	0	2	0	1	3
25489	472813	7	1	0	0	2	3
25489	472838	7	2	3	0	3	8
25489	54180	7	0	3	0	0	3
25489	98121	7	3	1	0	1	5
25489	187699	6	0	0	0	0	0
25489	289992	6	1	2	0	0	3
25489	472817	6	0	0	0	0	0
25489	51226	6	1	2	0	0	3
25489	51330	6	0	0	0	3	3
25489	101033	5	0	0	0	0	0
25489	204252	5	1	4	1	0	6
25489	212645	5	0	0	0	2	2
25489	214163	5	0	0	0	0	0
25489	289979	5	0	1	0	1	2
25489	289991	5	0	0	0	0	0
25489	472815	5	1	2	0	0	3
25489	472816	5	4	2	0	0	6
25489	472821	5	1	1	0	0	2
25489	472822	5	3	1	0	3	7
25489	472827	5	3	1	0	0	4
25489	188669	4	0	2	0	0	2
25489	190703	4	0	1	0	0	1
25489	191161	4	0	1	0	1	2
25489	193443	4	1	2	0	0	3
25489	212657	4	2	0	0	0	2
25489	213403	4	0	0	0	0	0
25489	289982	4	0	1	0	0	1
25489	289985	4	0	2	0	0	2
25489	472802	4	2	1	0	0	3
25489	472820	4	0	0	0	0	0
25489	472828	4	0	2	1	1	4
25489	472832	4	0	0	0	0	0
25489	472835	4	0	0	0	0	0
25489	50872	4	0	1	0	0	1
25489	59802	4	0	2	0	0	2
25489	182243	3	0	0	0	0	0
25489	184392	3	0	0	0	0	0
25489	220639	3	0	1	0	0	1
25489	289977	3	0	1	0	1	2
25489	289983	3	0	0	0	0	0
25489	472805	3	1	1	0	0	2
25489	472808	3	1	1	0	2	4
25489	472809	3	0	3	0	0	3
25489	472810	3	0	1	0	0	1
25489	472818	3	1	2	0	1	4
25489	472819	3	2	0	0	0	2
25489	472823	3	0	1	0	0	1
25489	472825	3	0	0	0	1	1
25489	472829	3	0	0	0	0	0
25489	472833	3	0	1	0	0	1
25489	53670	3	0	0	0	0	0
25489	88527	3	1	0	0	0	1
25489	215989	2	0	0	0	0	0
25489	289978	2	0	1	0	2	3
25489	289987	2	1	1	0	2	4
25489	289990	2	0	0	0	0	0
25489	472804	2	0	0	0	0	0
25489	472807	2	0	1	0	0	1
25489	472811	2	0	1	0	0	1
25489	472814	2	2	0	0	0	2
25489	472830	2	0	0	0	0	0
25489	472831	2	0	0	0	0	0
25489	84408	2	1	1	0	2	4
25489	188449	1	0	1	0	1	2
25489	472801	1	0	2	0	0	2
25489	472812	1	0	2	0	0	2
25489	472824	1	0	1	0	0	1
22152	185378	39	1	6	1	0	8
22152	51271	38	0	0	0	0	0
22152	54803	38	1	6	1	0	8
22152	58032	31	2	1	1	2	6
22152	62405	21	1	2	1	2	6
22152	102037	15	0	1	0	0	1
22152	65421	14	4	1	0	8	13
22152	289180	12	0	0	1	2	3
22152	515451	12	0	0	0	1	1
22152	97715	12	0	0	1	2	3
22152	197761	10	0	1	1	0	2
22152	515453	10	2	1	0	1	4
22152	515463	10	2	3	0	3	8
22152	289169	9	5	0	0	0	5
22152	515460	9	1	0	0	1	2
22152	515487	8	2	3	0	0	5
22152	515493	8	2	2	0	0	4
22152	515446	7	1	0	0	0	1
22152	515450	7	1	1	0	0	2
22152	515492	7	3	1	0	1	5
22152	189953	6	0	3	0	0	3
22152	289175	6	0	1	0	0	1
22152	50858	6	0	1	0	0	1
22152	515470	6	1	1	0	0	2
22152	101655	5	1	0	0	0	1
22152	102036	5	1	0	0	1	2
22152	191091	5	2	3	0	0	5
22152	194771	5	0	2	0	1	3
22152	197051	5	0	4	0	0	4
22152	214789	5	1	0	0	1	2
22152	289171	5	0	0	0	2	2
22152	289174	5	1	0	0	0	1
22152	289176	5	0	1	0	0	1
22152	289177	5	1	1	1	0	3
22152	289183	5	0	0	0	0	0
22152	515447	5	2	1	0	1	4
22152	515456	5	1	3	3	2	9
22152	515464	5	0	0	0	1	1
22152	515477	5	0	2	1	0	3
22152	515478	5	1	2	0	0	3
22152	515480	5	2	4	0	0	6
22152	515485	5	1	2	0	1	4
22152	515494	5	0	1	0	0	1
22152	515496	5	0	0	0	0	0
22152	78498	5	2	1	0	1	4
22152	90678	5	0	0	0	2	2
22152	186181	4	1	0	0	0	1
22152	187001	4	0	1	0	0	1
22152	204362	4	0	1	0	0	1
22152	212011	4	1	1	0	0	2
22152	218623	4	0	2	0	1	3
22152	220317	4	1	1	0	0	2
22152	289172	4	1	0	0	1	2
22152	289173	4	0	1	0	0	1
22152	289181	4	1	0	0	0	1
22152	515452	4	0	0	0	0	0
22152	515454	4	1	0	0	0	1
22152	515462	4	1	0	1	1	3
22152	515466	4	0	1	0	0	1
22152	515473	4	1	2	0	0	3
22152	515479	4	0	4	1	0	5
22152	515484	4	0	0	0	0	0
22152	515486	4	0	1	1	0	2
22152	70986	4	1	0	0	0	1
22152	106729	3	0	1	0	1	2
22152	191579	3	1	4	1	0	6
22152	218540	3	0	2	0	0	2
22152	289168	3	0	1	0	0	1
22152	289170	3	0	1	0	1	2
22152	289182	3	0	2	0	0	2
22152	289184	3	0	0	0	0	0
22152	289186	3	0	0	0	0	0
22152	289187	3	0	0	0	0	0
22152	515448	3	0	4	0	0	4
22152	515457	3	1	2	0	0	3
22152	515459	3	1	3	0	0	4
22152	515468	3	2	1	0	0	3
22152	515471	3	1	0	0	0	1
22152	515488	3	0	1	0	0	1
22152	515489	3	2	2	0	2	6
22152	515491	3	0	2	0	0	2
22152	515495	3	0	1	0	0	1
22152	515497	3	0	1	0	0	1
22152	84401	3	0	1	0	0	1
22152	214723	2	0	0	0	0	0
22152	216735	2	0	4	0	0	4
22152	289179	2	0	1	0	0	1
22152	289185	2	1	0	0	0	1
22152	289188	2	0	0	0	0	0
22152	515455	2	0	4	0	0	4
22152	515458	2	1	2	0	0	3
22152	515461	2	0	0	0	0	0
22152	515465	2	1	1	0	2	4
22152	515469	2	1	1	0	0	2
22152	515475	2	1	0	0	0	1
22152	515476	2	0	2	0	0	2
22152	515481	2	1	1	0	0	2
22152	515490	2	0	2	0	0	2
22152	188483	1	1	0	0	0	1
22152	195801	1	0	0	0	0	0
22152	289178	1	0	0	0	0	0
22152	515449	1	1	1	0	0	2
22152	515467	1	0	0	0	0	0
22152	515472	1	0	1	0	0	1
22152	515474	1	0	3	0	0	3
22152	515482	1	0	1	0	0	1
22152	515483	1	0	0	0	0	0
65232	282404	108	9	8	1	5	23
65232	603199	21	3	1	1	3	8
65232	197104	17	6	4	0	2	12
65232	282405	17	6	0	0	2	8
65232	603210	16	2	0	2	0	4
65232	282403	13	2	1	0	6	9
65232	603206	13	3	0	0	3	6
65232	452061	11	4	1	0	3	8
65232	452053	9	1	0	0	1	2
65232	452057	9	1	0	2	1	4
65232	193167	8	2	4	1	0	7
65232	282406	8	1	0	0	2	3
65232	282411	8	2	0	0	3	5
65232	603216	8	1	0	0	1	2
65232	198644	7	2	0	0	0	2
65232	210001	7	0	2	1	1	4
65232	214759	7	2	2	0	0	4
65232	452041	7	0	0	0	0	0
65232	452047	7	2	1	3	0	6
65232	452051	7	1	1	1	3	6
65232	603201	7	4	1	0	0	5
65232	209152	6	0	2	0	1	3
65232	282412	6	2	2	0	0	4
65232	452030	6	1	1	0	0	2
65232	452052	6	1	0	0	0	1
65232	452056	6	0	0	0	0	0
65232	193140	5	0	2	1	2	5
65232	282410	5	0	2	0	1	3
65232	282416	5	0	1	0	2	3
65232	282418	5	0	2	0	0	2
65232	452032	5	1	0	0	1	2
65232	452043	5	3	1	0	0	4
65232	603204	5	1	0	0	1	2
65232	188847	4	1	2	1	1	5
65232	189461	4	2	2	0	0	4
65232	207097	4	0	2	0	0	2
65232	207334	4	1	0	0	0	1
65232	452029	4	0	0	0	0	0
65232	452031	4	2	0	0	1	3
65232	452035	4	1	1	0	2	4
65232	452037	4	0	0	0	1	1
65232	452044	4	0	2	1	1	4
65232	452058	4	1	0	0	1	2
65232	603200	4	0	1	0	0	1
65232	603202	4	2	0	0	1	3
65232	603218	4	0	1	0	0	1
65232	603220	4	0	0	0	0	0
65232	603222	4	3	0	0	1	4
65232	189973	3	0	0	0	0	0
65232	192077	3	0	1	0	2	3
65232	203804	3	0	2	0	0	2
65232	208149	3	0	1	0	0	1
65232	213962	3	0	1	0	1	2
65232	215793	3	0	1	2	1	4
65232	282407	3	0	1	0	0	1
65232	282408	3	2	0	0	1	3
65232	282409	3	0	1	0	1	2
65232	282414	3	0	1	0	1	2
65232	282417	3	1	2	1	1	5
65232	452036	3	2	0	0	0	2
65232	452038	3	0	1	0	0	1
65232	452042	3	2	0	0	0	2
65232	452049	3	1	2	0	0	3
65232	452050	3	2	0	0	0	2
65232	452054	3	1	1	0	1	3
65232	452055	3	1	0	0	0	1
65232	452059	3	0	0	0	0	0
65232	452060	3	3	1	0	1	5
65232	603203	3	2	1	0	0	3
65232	603207	3	1	1	1	1	4
65232	603213	3	2	4	0	1	7
65232	603219	3	0	1	0	0	1
65232	603221	3	0	0	0	1	1
65232	192467	2	0	1	0	0	1
65232	193647	2	0	0	2	1	3
65232	202940	2	1	0	0	1	2
65232	203273	2	0	0	0	0	0
65232	204605	2	0	0	0	0	0
65232	208762	2	0	1	0	0	1
65232	213999	2	0	0	0	1	1
65232	217436	2	0	2	0	1	3
65232	218031	2	0	2	0	0	2
65232	219884	2	0	3	0	1	4
65232	282413	2	1	0	1	0	2
65232	282419	2	0	0	0	0	0
65232	452033	2	0	2	0	1	3
65232	452039	2	0	3	0	1	4
65232	452048	2	0	0	0	1	1
65232	452062	2	0	0	0	1	1
65232	603205	2	0	0	0	3	3
65232	603212	2	0	1	0	0	1
65232	193202	1	0	2	0	0	2
65232	195855	1	0	0	0	0	0
65232	205990	1	0	0	0	0	0
65232	205991	1	0	0	0	0	0
65232	282415	1	0	1	0	1	2
65232	452034	1	1	0	0	0	1
65232	452040	1	0	0	0	1	1
65232	452045	1	0	1	0	1	2
65232	452046	1	2	1	0	0	3
65232	452063	1	2	1	0	2	5
65232	603197	1	0	1	0	2	3
65232	603198	1	0	1	0	0	1
65232	603211	1	0	0	0	1	1
65232	603214	1	0	1	0	0	1
65232	603217	1	4	0	0	2	6
28543	186215	46	3	13	3	2	21
28543	553585	46	3	14	3	2	22
28543	53178	42	3	9	0	2	14
28543	553582	42	3	5	3	4	15
28543	220467	40	3	4	3	3	13
28543	553596	36	1	4	1	1	7
28543	79880	36	1	4	1	1	7
28543	107651	27	3	2	3	3	11
28543	553572	27	0	0	0	2	2
28543	67313	27	0	0	0	2	2
28543	553573	25	2	4	0	1	7
28543	290728	19	2	4	0	1	7
28543	553598	19	2	4	0	1	7
28543	58098	19	1	2	1	1	5
28543	91410	19	2	4	0	1	7
28543	103317	18	3	7	0	1	11
28543	96141	18	1	1	0	0	2
28543	290717	17	2	2	1	0	5
28543	67749	17	1	1	0	4	6
28543	76660	17	1	1	0	0	2
28543	290739	16	2	1	0	3	6
28543	63951	16	1	4	0	1	6
28543	290721	15	1	0	0	0	1
28543	553583	15	2	1	0	0	3
28543	553602	15	1	1	0	0	2
28543	553604	15	2	1	0	3	6
28543	56933	15	1	0	0	0	1
28543	67195	15	0	2	1	1	4
28543	72516	15	2	1	0	0	3
28543	83723	15	1	1	0	0	2
28543	97728	15	2	1	0	3	6
28543	195878	14	3	0	1	0	4
28543	553597	14	3	0	1	0	4
28543	553599	14	3	0	1	0	4
28543	69984	14	3	0	1	0	4
28543	200569	13	2	2	0	1	5
28543	78765	13	2	2	0	1	5
28543	104392	12	0	2	0	2	4
28543	553578	12	0	1	1	0	2
28543	65620	12	0	1	1	0	2
28543	68843	12	3	1	0	1	5
28543	290732	11	2	1	0	0	3
28543	290733	11	1	2	1	1	5
28543	53857	11	2	1	0	0	3
28543	553579	11	1	2	1	0	4
28543	553586	11	1	4	2	1	8
28543	553591	11	2	1	0	0	3
28543	553593	11	1	2	1	1	5
28543	74067	11	1	2	1	1	5
28543	184772	10	4	3	0	0	7
28543	290718	10	3	4	0	3	10
28543	290736	10	4	3	0	0	7
28543	50073	10	3	4	0	3	10
28543	54189	10	4	3	0	0	7
28543	553574	10	3	4	0	3	10
28543	553588	10	2	3	0	0	5
28543	553590	10	1	3	1	0	5
28543	553592	10	3	2	0	1	6
28543	70449	10	3	2	0	1	6
28543	91772	10	2	3	0	0	5
28543	189046	9	1	3	1	0	5
28543	290731	9	1	3	1	0	5
28543	553584	9	0	1	0	0	1
28543	553600	9	0	5	0	3	8
28543	61034	9	1	3	1	0	5
28543	53353	8	1	3	1	0	5
28543	553594	8	4	3	0	0	7
28543	62924	8	1	3	0	0	4
28543	65538	8	1	0	0	1	2
28543	106642	7	0	6	0	1	7
28543	553568	7	1	2	2	2	7
28543	88566	7	2	0	0	2	4
28543	92556	7	2	1	0	0	3
28543	101490	6	0	2	0	2	4
28543	105954	6	0	1	0	0	1
28543	219589	6	0	1	0	0	1
28543	553580	6	2	0	0	2	4
28543	553581	6	0	1	0	0	1
28543	553587	6	1	2	0	0	3
28543	70423	6	1	2	0	1	4
28543	76041	6	1	1	0	0	2
28543	51335	5	0	1	0	0	1
28543	85048	5	1	0	0	0	1
28543	189335	4	1	1	0	0	2
28543	290724	4	0	1	0	0	1
28543	553576	4	1	1	0	0	2
28543	553589	4	0	5	0	3	8
28543	553595	4	0	2	0	0	2
28543	68102	4	0	1	0	0	1
28543	85400	4	0	1	0	0	1
28543	290725	3	0	2	0	0	2
28543	553569	3	0	0	0	0	0
28543	553575	3	1	2	0	0	3
28543	553577	3	0	1	0	1	2
28543	553603	3	1	2	0	0	3
28543	56158	3	0	2	0	0	2
28543	65529	3	0	4	0	2	6
28543	78106	3	1	0	0	0	1
28543	194423	2	0	0	0	0	0
28543	553566	2	1	2	0	0	3
28543	553571	2	1	1	0	0	2
28543	56300	2	0	0	0	0	0
28543	81775	2	2	0	0	0	2
28543	83488	2	0	3	0	0	3
28543	553567	1	0	0	0	0	0
28543	553570	1	0	1	0	0	1
31571	438969	15	1	2	0	4	7
31571	438981	12	3	0	2	0	5
31571	439028	12	0	0	0	0	0
31571	443634	12	0	2	0	0	2
31571	182626	11	1	0	2	1	4
31571	439002	11	3	2	1	1	7
31571	438967	10	1	1	1	0	3
31571	438976	10	0	1	0	3	4
31571	439024	9	0	2	0	0	2
31571	443631	9	0	3	0	1	4
31571	188512	8	1	0	0	0	1
31571	291533	8	1	1	0	0	2
31571	438978	8	1	0	0	1	2
31571	439009	8	0	0	0	0	0
31571	443633	8	2	4	0	0	6
31571	195958	7	2	0	0	0	2
31571	438990	7	1	1	0	2	4
31571	206438	6	1	0	0	0	1
31571	291530	6	1	0	0	3	4
31571	438964	6	2	1	0	0	3
31571	438966	6	4	1	0	0	5
31571	438984	6	7	0	0	0	7
31571	438995	6	2	1	0	0	3
31571	438998	6	0	0	0	0	0
31571	439012	6	0	1	0	1	2
31571	439013	6	1	0	0	0	1
31571	443630	6	0	0	0	0	0
31571	443636	6	0	2	0	0	2
31571	56308	6	1	0	0	3	4
31571	185826	5	2	1	0	1	4
31571	438961	5	0	2	1	1	4
31571	438962	5	1	1	1	0	3
31571	438963	5	0	1	0	0	1
31571	438980	5	2	0	0	0	2
31571	438987	5	2	0	0	0	2
31571	438991	5	0	0	1	0	1
31571	438994	5	0	0	0	0	0
31571	439001	5	4	2	1	1	8
31571	439003	5	2	0	0	0	2
31571	443629	5	1	1	0	0	2
31571	206369	4	0	0	0	0	0
31571	208923	4	1	0	0	0	1
31571	438965	4	0	0	0	0	0
31571	438968	4	1	0	0	1	2
31571	438977	4	1	0	0	0	1
31571	438982	4	1	1	1	1	4
31571	438988	4	0	1	0	1	2
31571	438993	4	2	0	0	0	2
31571	438997	4	1	1	0	0	2
31571	439011	4	0	1	0	0	1
31571	439021	4	1	1	0	0	2
31571	439022	4	0	0	0	0	0
31571	439025	4	0	0	0	0	0
31571	443624	4	1	1	0	0	2
31571	443625	4	1	0	0	0	1
31571	443627	4	1	1	1	0	3
31571	443632	4	0	1	0	0	1
31571	443637	4	0	0	0	0	0
31571	443639	4	0	1	0	0	1
31571	185098	3	0	2	0	0	2
31571	197992	3	1	0	0	0	1
31571	212358	3	2	0	0	0	2
31571	291529	3	1	0	0	0	1
31571	438971	3	2	0	0	0	2
31571	438973	3	0	0	0	0	0
31571	438974	3	0	0	0	0	0
31571	438975	3	0	0	0	0	0
31571	438979	3	0	1	0	0	1
31571	438983	3	0	0	0	1	1
31571	438989	3	0	2	1	0	3
31571	438992	3	0	1	0	0	1
31571	439000	3	0	0	0	1	1
31571	439005	3	0	0	0	0	0
31571	439006	3	1	0	0	0	1
31571	439007	3	1	0	0	0	1
31571	439014	3	0	0	0	0	0
31571	439026	3	0	0	0	1	1
31571	439029	3	0	0	0	0	0
31571	443626	3	1	0	0	0	1
31571	103768	2	0	0	0	0	0
31571	212907	2	2	0	0	0	2
31571	291531	2	0	0	0	0	0
31571	291532	2	2	0	0	0	2
31571	438970	2	0	1	0	0	1
31571	438972	2	0	2	0	0	2
31571	438985	2	0	1	0	1	2
31571	439004	2	0	0	0	0	0
31571	439010	2	0	0	0	0	0
31571	439015	2	0	0	0	0	0
31571	439016	2	1	0	0	0	1
31571	439020	2	0	0	0	0	0
31571	439023	2	0	0	0	0	0
31571	439027	2	0	0	0	0	0
31571	443623	2	2	1	0	0	3
31571	443635	2	0	1	0	0	1
31571	216287	1	0	2	0	0	2
31571	438986	1	1	1	0	0	2
31571	438996	1	1	1	0	1	3
31571	438999	1	1	0	0	0	1
31571	439008	1	0	0	0	0	0
31571	439017	1	1	0	0	0	1
31571	439018	1	0	0	0	0	0
31571	439019	1	1	0	0	0	1
31571	439030	1	0	0	0	0	0
31571	443628	1	0	1	0	0	1
31571	443638	1	3	2	0	2	7
35304	108362	49	3	3	2	1	9
35304	87051	37	6	9	2	3	20
35304	85666	33	2	3	4	2	11
35304	550625	32	3	2	1	2	8
35304	292682	27	2	4	1	0	7
35304	550617	27	2	13	1	1	17
35304	550624	26	6	3	1	1	11
35304	65153	25	2	4	1	0	7
35304	92963	24	1	3	3	1	8
35304	93402	24	2	6	0	0	8
35304	50215	21	0	4	2	4	10
35304	550626	21	1	3	2	4	10
35304	59236	21	5	4	1	2	12
35304	550628	20	2	0	0	2	4
35304	83209	19	3	4	0	2	9
35304	550627	18	0	1	0	0	1
35304	191553	16	0	1	0	1	2
35304	550623	15	2	4	1	2	9
35304	292681	14	6	8	0	3	17
35304	50086	14	6	8	0	3	17
35304	550629	14	3	4	1	0	8
35304	550632	14	4	5	1	2	12
35304	85998	14	3	5	2	2	12
35304	103920	12	2	2	0	1	5
35304	550630	12	4	4	0	0	8
35304	106021	11	0	0	0	0	0
35304	219532	11	0	0	0	0	0
35304	188049	10	3	4	0	3	10
35304	550658	10	0	1	1	0	2
35304	65344	10	0	0	0	0	0
35304	292678	9	2	4	0	0	6
35304	292679	9	1	1	1	1	4
35304	50933	9	2	4	0	0	6
35304	550618	9	0	2	0	0	2
35304	550621	9	1	1	0	1	3
35304	550663	9	0	3	0	0	3
35304	85156	9	1	1	1	1	4
35304	198705	7	2	3	0	1	6
35304	292680	7	4	3	0	0	7
35304	550613	7	0	1	2	0	3
35304	550631	7	1	2	1	0	4
35304	550651	7	2	4	0	0	6
35304	74624	7	2	3	0	1	6
35304	97948	7	4	3	0	0	7
35304	104293	6	0	1	0	0	1
35304	215299	6	2	4	0	1	7
35304	292685	6	0	3	0	0	3
35304	550611	6	1	1	0	0	2
35304	550642	6	0	4	1	5	10
35304	550661	6	3	1	0	0	4
35304	550664	6	1	0	0	0	1
35304	202201	5	1	0	0	0	1
35304	217767	5	1	2	0	2	5
35304	49800	5	2	2	0	0	4
35304	550614	5	1	0	0	0	1
35304	550662	5	0	0	0	0	0
35304	88569	5	2	1	0	0	3
35304	97585	5	2	1	0	0	3
35304	99762	5	0	0	0	1	1
35304	211775	4	1	0	0	0	1
35304	550615	4	0	1	0	0	1
35304	550650	4	1	1	0	2	4
35304	550657	4	3	1	0	0	4
35304	79428	4	2	1	0	0	3
35304	194486	3	0	1	0	0	1
35304	292683	3	0	1	0	0	1
35304	292684	3	0	1	0	0	1
35304	550635	3	0	2	0	2	4
35304	550637	3	2	1	0	0	3
35304	550640	3	0	1	0	0	1
35304	550641	3	0	0	0	0	0
35304	550644	3	0	1	1	0	2
35304	550656	3	3	2	0	3	8
35304	550660	3	0	1	0	0	1
35304	68129	3	0	1	0	0	1
35304	90810	3	0	1	0	0	1
35304	183723	2	0	1	0	0	1
35304	550608	2	1	2	0	0	3
35304	550612	2	2	0	0	0	2
35304	550616	2	1	1	0	0	2
35304	550620	2	0	1	0	0	1
35304	550634	2	0	0	0	0	0
35304	550638	2	0	0	0	0	0
35304	550639	2	0	2	0	0	2
35304	550645	2	0	0	0	0	0
35304	550646	2	1	2	0	0	3
35304	550647	2	1	1	0	0	2
35304	550655	2	1	2	0	0	3
35304	550659	2	1	1	0	0	2
35304	92097	2	0	0	0	0	0
35304	192850	1	0	2	0	0	2
35304	550609	1	0	0	0	0	0
35304	550610	1	2	1	0	0	3
35304	550619	1	1	0	0	0	1
35304	550622	1	1	0	0	0	1
35304	550633	1	1	1	1	2	5
35304	550636	1	0	3	0	0	3
35304	550643	1	1	1	1	0	3
35304	550648	1	1	0	0	0	1
35304	550649	1	0	0	0	0	0
35304	550652	1	0	0	0	0	0
35304	550653	1	0	1	0	0	1
35304	550654	1	0	1	0	0	1
48762	89613	33	4	8	1	1	14
48762	83142	25	2	5	2	1	10
48762	88338	16	0	5	0	1	6
48762	210975	15	4	3	1	0	8
48762	280595	15	0	5	0	1	6
48762	75108	15	1	2	0	1	4
48762	96249	15	0	1	0	2	3
48762	81156	13	1	4	0	0	5
48762	61951	12	2	4	0	0	6
48762	88479	11	2	1	0	1	4
48762	211818	10	0	1	1	0	2
48762	68878	10	4	1	0	2	7
48762	88539	10	2	1	0	2	5
48762	100274	9	2	1	1	1	5
48762	103748	9	3	2	1	0	6
48762	105277	9	1	3	0	0	4
48762	55404	9	0	4	1	0	5
48762	280586	8	0	2	1	0	3
48762	63979	8	2	1	0	0	3
48762	90418	8	3	2	1	0	6
48762	98645	8	1	1	0	0	2
48762	104229	7	0	1	0	0	1
48762	108389	7	2	0	0	0	2
48762	203157	7	0	2	0	0	2
48762	206155	7	2	1	0	0	3
48762	55497	7	4	1	1	0	6
48762	56051	7	2	0	0	1	3
48762	76087	7	0	0	1	2	3
48762	81171	7	2	1	0	0	3
48762	89761	7	2	2	0	1	5
48762	103825	6	2	0	0	0	2
48762	188233	6	0	2	0	0	2
48762	199249	6	0	2	0	0	2
48762	280593	6	1	0	0	0	1
48762	88844	6	0	0	0	0	0
48762	91989	6	2	0	0	0	2
48762	92619	6	1	0	0	0	1
48762	95531	6	2	3	0	0	5
48762	103820	5	0	1	1	2	4
48762	181889	5	0	1	0	0	1
48762	203031	5	0	2	0	0	2
48762	203762	5	0	0	0	0	0
48762	204520	5	1	0	0	0	1
48762	280584	5	0	0	0	0	0
48762	280588	5	1	0	1	0	2
48762	280590	5	1	0	0	0	1
48762	78066	5	1	0	0	0	1
48762	92630	5	2	0	0	0	2
48762	187224	4	0	0	0	0	0
48762	188953	4	1	0	0	0	1
48762	189247	4	0	0	0	0	0
48762	197174	4	0	0	0	0	0
48762	209161	4	0	2	0	0	2
48762	215882	4	0	0	0	0	0
48762	218786	4	1	2	0	0	3
48762	280583	4	0	0	0	3	3
48762	62411	4	1	0	0	0	1
48762	85290	4	0	1	1	1	3
48762	89634	4	1	3	0	0	4
48762	97391	4	1	0	0	0	1
48762	203856	3	0	1	0	0	1
48762	208332	3	2	2	0	1	5
48762	208938	3	0	0	0	0	0
48762	211703	3	0	0	0	0	0
48762	212613	3	0	3	0	0	3
48762	214357	3	2	0	0	0	2
48762	219842	3	1	1	0	0	2
48762	219983	3	0	2	0	1	3
48762	221093	3	0	0	0	0	0
48762	280587	3	0	0	0	0	0
48762	280589	3	0	1	0	1	2
48762	280592	3	0	1	0	0	1
48762	79521	3	0	1	0	0	1
48762	97504	3	2	0	0	0	2
48762	182055	2	0	1	0	0	1
48762	183871	2	0	0	1	1	2
48762	185736	2	0	1	0	0	1
48762	186816	2	0	0	0	0	0
48762	192377	2	0	1	0	0	1
48762	199151	2	2	0	0	0	2
48762	199157	2	0	0	0	0	0
48762	206427	2	0	0	0	0	0
48762	206538	2	0	1	1	0	2
48762	207426	2	0	2	1	0	3
48762	211687	2	0	0	0	0	0
48762	211882	2	0	1	0	0	1
48762	215708	2	1	1	0	0	2
48762	216325	2	0	1	0	2	3
48762	217700	2	0	1	0	0	1
48762	220986	2	1	0	0	0	1
48762	280585	2	1	1	0	0	2
48762	280591	2	0	0	0	0	0
48762	280594	2	0	0	0	0	0
48762	191060	1	1	0	0	0	1
48762	193198	1	0	1	1	0	2
48762	198254	1	0	0	0	0	0
48762	200076	1	0	1	0	0	1
48762	205924	1	2	1	0	0	3
48762	206005	1	0	0	0	0	0
48762	206223	1	0	1	0	0	1
48762	208801	1	1	1	0	1	3
48762	210767	1	0	1	0	0	1
48762	214680	1	0	0	0	0	0
38203	293496	34	5	5	1	3	14
38203	540000	33	5	5	1	3	14
38203	97748	30	4	5	0	3	12
38203	58217	25	0	4	2	1	7
38203	293489	22	2	2	0	2	6
38203	293477	21	3	2	0	0	5
38203	539978	21	3	2	0	0	5
38203	539996	21	2	2	0	2	6
38203	185427	18	5	0	0	0	5
38203	539989	18	5	0	0	0	5
38203	539982	17	1	1	0	1	3
38203	214777	16	2	4	2	1	9
38203	293486	15	2	4	2	1	9
38203	188864	14	0	4	0	0	4
38203	293479	14	4	1	0	0	5
38203	539980	14	2	4	0	2	8
38203	59851	13	0	2	0	0	2
38203	209643	12	2	11	0	2	15
38203	293498	12	0	4	0	0	4
38203	539977	12	1	1	0	3	5
38203	539998	12	2	11	0	2	15
38203	205514	11	1	1	0	0	2
38203	539999	11	2	0	0	0	2
38203	184880	10	1	2	0	0	3
38203	293482	10	1	0	1	2	4
38203	293492	10	2	1	0	0	3
38203	293495	10	1	2	0	0	3
38203	539991	10	1	2	0	0	3
38203	539995	10	1	3	0	0	4
38203	539997	10	1	1	0	0	2
38203	54225	10	1	2	0	0	3
38203	66674	10	1	0	1	2	4
38203	98139	10	2	2	0	0	4
38203	196794	9	0	2	0	0	2
38203	539987	9	0	1	0	0	1
38203	197366	8	2	2	0	1	5
38203	216666	8	2	1	0	0	3
38203	293475	8	2	2	0	1	5
38203	293503	8	1	1	0	0	2
38203	539976	8	1	0	0	1	2
38203	539985	8	2	1	0	0	3
38203	539988	8	4	3	0	0	7
38203	539993	8	1	3	0	1	5
38203	72752	8	2	2	0	1	5
38203	190561	7	1	2	0	0	3
38203	293488	7	2	0	0	0	2
38203	539972	7	1	5	0	0	6
38203	539990	7	3	1	0	2	6
38203	539994	7	4	5	0	0	9
38203	90839	7	2	0	0	0	2
38203	293471	6	1	0	0	0	1
38203	293476	6	2	3	0	2	7
38203	293481	6	2	1	0	0	3
38203	293499	6	1	1	0	0	2
38203	53876	6	1	1	0	0	2
38203	539984	6	0	1	0	0	1
38203	539992	6	2	1	1	0	4
38203	70261	6	2	3	0	2	7
38203	78780	6	0	1	0	2	3
38203	101727	5	1	0	0	2	3
38203	182300	5	1	1	0	1	3
38203	192826	5	0	3	0	0	3
38203	213891	5	1	0	1	2	4
38203	220179	5	0	0	0	0	0
38203	293480	5	2	1	0	1	4
38203	293490	5	1	0	0	2	3
38203	293491	5	1	2	0	2	5
38203	86272	5	2	1	0	1	4
38203	102989	4	0	1	0	2	3
38203	189892	4	0	2	0	0	2
38203	200236	4	0	1	0	2	3
38203	218748	4	0	1	0	1	2
38203	293472	4	0	1	0	0	1
38203	293473	4	0	1	0	2	3
38203	293484	4	0	0	1	0	1
38203	293485	4	0	0	0	0	0
38203	293493	4	1	0	0	0	1
38203	293497	4	0	0	0	0	0
38203	539973	4	0	1	0	0	1
38203	539979	4	0	2	0	2	4
38203	539981	4	1	1	0	0	2
38203	539986	4	0	3	0	0	3
38203	57356	4	0	0	0	0	0
38203	80785	4	0	1	0	0	1
38203	90233	4	1	0	0	0	1
38203	98505	4	0	0	1	0	1
38203	204310	3	1	1	0	0	2
38203	293483	3	1	0	0	0	1
38203	293487	3	1	0	0	0	1
38203	293501	3	0	0	0	0	0
38203	539974	3	0	1	0	0	1
38203	205871	2	0	2	0	0	2
38203	293474	2	1	1	0	0	2
38203	293478	2	1	1	0	0	2
38203	293494	2	0	2	0	0	2
38203	293500	2	0	0	0	0	0
38203	539975	2	2	0	0	0	2
38203	539983	2	1	2	0	0	3
38203	72003	2	1	1	0	0	2
38203	84434	2	1	1	0	0	2
38203	207376	1	0	1	0	1	2
38203	212019	1	1	1	0	0	2
38203	293502	1	0	0	0	0	0
38203	539971	1	0	2	0	0	2
69370	85720	35	6	4	1	4	15
69370	59468	22	2	0	0	1	3
69370	589516	21	2	0	0	1	3
69370	63912	21	1	1	0	0	2
69370	73261	20	7	1	0	0	8
69370	589509	17	8	3	0	1	12
69370	92768	17	8	3	0	1	12
69370	74860	15	4	3	1	3	11
69370	63265	14	3	2	0	0	5
69370	78568	13	1	1	0	3	5
69370	55215	12	1	0	0	0	1
69370	589500	10	3	1	0	6	10
69370	92815	10	3	1	0	6	10
69370	589478	8	2	2	0	2	6
69370	589510	8	1	0	0	1	2
69370	589444	7	2	1	0	4	7
69370	589482	7	2	0	1	2	5
69370	589488	7	1	1	0	1	3
69370	589446	6	1	3	0	2	6
69370	589507	6	3	1	2	0	6
69370	589517	6	4	2	2	3	11
69370	49578	5	2	0	0	1	3
69370	589432	5	1	0	0	1	2
69370	589437	5	1	1	0	2	4
69370	589458	5	1	1	0	2	4
69370	589465	5	2	0	0	1	3
69370	589508	5	2	2	0	1	5
69370	193339	4	1	0	0	0	1
69370	589440	4	2	1	0	3	6
69370	589445	4	0	0	0	0	0
69370	589451	4	4	0	0	0	4
69370	589453	4	2	0	0	0	2
69370	589456	4	1	0	0	0	1
69370	589462	4	2	1	1	2	6
69370	589472	4	2	1	1	1	5
69370	589479	4	2	0	1	1	4
69370	589495	4	2	1	0	1	4
69370	189268	3	1	1	0	0	2
69370	589431	3	2	1	0	1	4
69370	589436	3	0	0	0	3	3
69370	589438	3	1	1	1	2	5
69370	589449	3	1	0	0	0	1
69370	589459	3	2	1	0	1	4
69370	589461	3	0	0	0	1	1
69370	589463	3	0	0	0	0	0
69370	589467	3	2	0	0	0	2
69370	589469	3	1	1	0	0	2
69370	589476	3	2	0	0	2	4
69370	589477	3	1	0	1	2	4
69370	589481	3	1	0	0	0	1
69370	589483	3	1	0	0	0	1
69370	589484	3	1	1	0	1	3
69370	589485	3	2	1	0	0	3
69370	589486	3	1	1	0	0	2
69370	589487	3	1	1	0	1	3
69370	589493	3	1	0	0	1	2
69370	589497	3	1	0	0	1	2
69370	589499	3	3	0	0	0	3
69370	589501	3	2	1	0	0	3
69370	589502	3	2	0	0	0	2
69370	589503	3	2	2	1	1	6
69370	589504	3	2	1	0	1	4
69370	589505	3	0	0	1	0	1
69370	589506	3	1	1	0	0	2
69370	589513	3	0	0	0	0	0
69370	182114	2	1	0	0	0	1
69370	589434	2	0	1	0	1	2
69370	589435	2	0	0	0	0	0
69370	589460	2	2	1	0	0	3
69370	589466	2	0	0	0	1	1
69370	589471	2	0	0	0	2	2
69370	589473	2	1	1	0	1	3
69370	589475	2	1	1	0	0	2
69370	589480	2	0	1	0	1	2
69370	589491	2	1	1	0	1	3
69370	589492	2	1	3	0	0	4
69370	589512	2	1	1	0	0	2
69370	589514	2	2	0	0	0	2
69370	582833	1	0	0	0	1	1
69370	589429	1	0	1	0	1	2
69370	589430	1	0	0	0	0	0
69370	589433	1	0	0	0	1	1
69370	589439	1	2	0	0	1	3
69370	589441	1	0	0	0	0	0
69370	589442	1	0	0	0	1	1
69370	589443	1	0	0	0	0	0
69370	589447	1	1	1	0	0	2
69370	589448	1	0	0	0	0	0
69370	589450	1	2	0	0	0	2
69370	589452	1	1	0	0	1	2
69370	589454	1	0	0	0	2	2
69370	589455	1	0	0	0	1	1
69370	589457	1	0	0	0	0	0
69370	589464	1	0	0	0	1	1
69370	589468	1	1	0	0	0	1
69370	589470	1	1	0	0	0	1
69370	589474	1	1	0	0	0	1
69370	589489	1	1	0	0	1	2
69370	589490	1	1	0	0	0	1
69370	589494	1	0	2	0	0	2
69370	589496	1	0	0	0	0	0
69370	589498	1	0	0	0	2	2
69370	589511	1	0	1	0	0	1
69370	589515	1	0	0	0	0	0
63071	93153	33	4	8	2	2	16
63071	58498	23	1	4	0	0	5
63071	66292	19	0	8	3	2	13
63071	76195	19	1	5	1	1	8
63071	100221	11	2	4	0	1	7
63071	421285	11	1	4	0	1	6
63071	421288	11	0	3	0	2	5
63071	200547	10	2	1	0	0	3
63071	421282	10	2	1	0	0	3
63071	72337	10	2	1	0	0	3
63071	50419	9	1	8	1	1	11
63071	85825	9	3	1	0	1	5
63071	421292	8	0	2	0	1	3
63071	98586	8	1	1	0	0	2
63071	198522	7	0	3	0	0	3
63071	211350	7	0	2	1	0	3
63071	421275	7	3	7	2	0	12
63071	102779	6	1	1	1	0	3
63071	103378	6	0	1	1	0	2
63071	104231	6	0	0	2	0	2
63071	195682	6	0	1	0	1	2
63071	421276	6	2	1	1	1	5
63071	421279	6	1	3	0	0	4
63071	421289	6	0	3	0	0	3
63071	421293	6	2	3	0	2	7
63071	100288	5	4	0	1	0	5
63071	101883	5	2	0	0	0	2
63071	299855	5	0	1	0	1	2
63071	299858	5	2	0	0	0	2
63071	299859	5	0	0	0	0	0
63071	299861	5	1	0	0	0	1
63071	421255	5	1	2	1	0	4
63071	421258	5	1	1	0	0	2
63071	421263	5	0	1	0	0	1
63071	421273	5	1	3	0	0	4
63071	421278	5	0	1	0	0	1
63071	421283	5	0	3	0	0	3
63071	421290	5	1	2	0	2	5
63071	421291	5	1	1	0	0	2
63071	421295	5	2	4	0	0	6
63071	56403	5	2	1	1	0	4
63071	56621	5	0	3	0	0	3
63071	97257	5	0	1	0	0	1
63071	106273	4	0	0	0	0	0
63071	182695	4	0	0	0	0	0
63071	203041	4	1	1	0	0	2
63071	209267	4	0	2	0	0	2
63071	215937	4	1	3	0	0	4
63071	216660	4	0	1	0	0	1
63071	219595	4	0	0	0	0	0
63071	299854	4	0	1	0	0	1
63071	299856	4	0	0	0	0	0
63071	299860	4	0	0	0	0	0
63071	421254	4	1	0	0	0	1
63071	421261	4	0	1	0	0	1
63071	421266	4	0	1	0	0	1
63071	421267	4	0	2	0	0	2
63071	421268	4	1	2	0	0	3
63071	421270	4	0	1	0	0	1
63071	421277	4	1	1	0	0	2
63071	421281	4	1	0	0	0	1
63071	421284	4	2	4	0	1	7
63071	421294	4	0	1	0	0	1
63071	421297	4	0	1	0	0	1
63071	77030	4	0	0	0	0	0
63071	92420	4	0	1	0	0	1
63071	104981	3	1	1	1	0	3
63071	189444	3	2	0	0	0	2
63071	193562	3	0	1	0	0	1
63071	194391	3	0	1	0	0	1
63071	216028	3	0	2	0	0	2
63071	421253	3	0	1	0	0	1
63071	421256	3	0	1	0	0	1
63071	421265	3	0	1	0	0	1
63071	421272	3	1	1	0	0	2
63071	421280	3	1	2	0	0	3
63071	421287	3	1	1	0	0	2
63071	92506	3	0	1	0	0	1
63071	182204	2	0	1	0	1	2
63071	192061	2	0	1	0	0	1
63071	204527	2	0	0	0	1	1
63071	217217	2	0	0	0	0	0
63071	218594	2	0	1	0	1	2
63071	299862	2	1	0	0	0	1
63071	421259	2	1	2	0	0	3
63071	421264	2	0	1	0	1	2
63071	421274	2	0	3	0	0	3
63071	421296	2	0	1	0	1	2
63071	106740	1	0	1	0	0	1
63071	191236	1	1	0	0	0	1
63071	204567	1	0	1	0	0	1
63071	205768	1	1	3	0	0	4
63071	205975	1	1	2	0	0	3
63071	214218	1	0	0	0	0	0
63071	221084	1	0	0	0	0	0
63071	299857	1	0	1	0	0	1
63071	421257	1	0	0	0	0	0
63071	421260	1	2	2	0	0	4
63071	421262	1	2	0	0	0	2
63071	421269	1	1	1	0	0	2
63071	421271	1	1	1	0	0	2
63071	421286	1	0	1	0	0	1
63071	84114	1	0	0	0	0	0
34135	59422	32	7	1	2	2	12
34135	617703	32	7	1	2	2	12
34135	85695	29	11	3	4	4	22
34135	292300	23	3	2	0	2	7
34135	292297	22	4	1	3	1	9
34135	75523	22	4	1	3	1	9
34135	292299	21	5	2	0	2	9
34135	88875	21	5	2	0	2	9
34135	106005	18	2	1	0	1	4
34135	219376	18	2	1	0	1	4
34135	292298	17	1	3	0	0	4
34135	71543	17	1	3	0	0	4
34135	292294	16	0	4	0	2	6
34135	292295	16	2	2	3	0	7
34135	66709	16	2	2	3	0	7
34135	75394	16	5	1	3	2	11
34135	81028	16	3	0	0	3	6
34135	292296	15	2	1	0	1	4
34135	56005	15	2	1	0	1	4
34135	108896	14	4	1	2	3	10
34135	222116	14	4	1	2	3	10
34135	292301	14	3	1	1	3	8
34135	68919	14	0	3	0	2	5
34135	96476	14	3	1	1	3	8
34135	534351	13	9	1	0	4	14
34135	617693	13	6	1	0	0	7
34135	617704	13	4	1	2	3	10
34135	292291	12	8	1	0	2	11
34135	617698	12	8	1	0	2	11
34135	86480	12	8	1	0	2	11
34135	292288	11	2	0	1	2	5
34135	292293	11	2	1	0	1	4
34135	59267	11	4	0	0	0	4
34135	617684	11	2	0	1	2	5
34135	61980	11	2	0	1	2	5
34135	74620	11	2	1	0	1	4
34135	617683	9	2	0	1	1	4
34135	617702	9	4	3	1	0	8
34135	188243	8	4	0	0	1	5
34135	212165	8	4	4	0	0	8
34135	292292	8	0	0	0	1	1
34135	534354	8	4	4	0	0	8
34135	194573	7	2	0	1	1	4
34135	292290	7	0	2	0	1	3
34135	68981	7	1	0	0	0	1
34135	82211	7	1	1	0	1	3
34135	85893	7	0	2	0	1	3
34135	534350	6	2	2	0	1	5
34135	61215	6	1	2	1	2	6
34135	617677	6	1	1	0	1	3
34135	617689	6	0	0	1	0	1
34135	617690	6	0	0	1	3	4
34135	617701	6	1	1	0	0	2
34135	209346	5	3	0	0	0	3
34135	292289	5	1	1	0	1	3
34135	534355	5	0	0	0	0	0
34135	617675	5	2	0	0	0	2
34135	617685	5	0	1	0	0	1
34135	82048	5	1	1	0	2	4
34135	534344	4	3	0	0	0	3
34135	534357	4	3	0	1	0	4
34135	617672	4	3	1	0	2	6
34135	617678	4	3	0	0	0	3
34135	617681	4	3	2	1	0	6
34135	617694	4	1	0	0	3	4
34135	63506	4	3	0	0	0	3
34135	66616	4	2	0	0	0	2
34135	217853	3	0	0	0	1	1
34135	534352	3	1	0	0	0	1
34135	534356	3	1	2	0	1	4
34135	617676	3	2	0	0	0	2
34135	617679	3	0	0	0	0	0
34135	617682	3	3	1	0	0	4
34135	617687	3	1	1	0	1	3
34135	617692	3	0	0	0	0	0
34135	617695	3	2	0	0	0	2
34135	183768	2	1	0	0	1	2
34135	203946	2	1	1	0	0	2
34135	534342	2	1	1	0	1	3
34135	534347	2	0	0	0	0	0
34135	534353	2	1	0	2	0	3
34135	617669	2	0	0	0	0	0
34135	617671	2	0	1	0	0	1
34135	617688	2	0	1	0	0	1
34135	617691	2	2	0	0	0	2
34135	617697	2	0	2	0	1	3
34135	196670	1	0	0	0	0	0
34135	534341	1	0	0	0	0	0
34135	534343	1	1	0	0	0	1
34135	534345	1	0	0	0	0	0
34135	534346	1	1	0	0	0	1
34135	534348	1	2	0	0	0	2
34135	534349	1	4	0	0	1	5
34135	617668	1	2	0	0	0	2
34135	617670	1	1	0	0	0	1
34135	617673	1	0	0	0	1	1
34135	617674	1	2	0	0	0	2
34135	617680	1	0	1	0	0	1
34135	617686	1	1	2	0	2	5
34135	617696	1	0	0	0	0	0
34135	617699	1	2	1	0	0	3
34135	617700	1	1	0	0	1	2
32811	482143	25	5	3	0	3	11
32811	184207	24	4	3	0	3	10
32811	187586	20	0	4	0	8	12
32811	291858	20	3	1	1	6	11
32811	197402	16	0	4	0	1	5
32811	482139	15	4	4	0	3	11
32811	213678	11	2	3	0	2	7
32811	291854	11	2	3	0	2	7
32811	214847	9	1	2	0	0	3
32811	213053	7	1	1	0	0	2
32811	291852	7	4	0	2	1	7
32811	291886	7	1	2	0	0	3
32811	291893	7	2	0	0	3	5
32811	291871	6	0	2	0	4	6
32811	291873	6	0	0	0	3	3
32811	291877	6	0	1	0	1	2
32811	291895	6	0	2	0	0	2
32811	291900	6	0	1	0	4	5
32811	482142	6	1	1	0	3	5
32811	184924	5	0	4	1	3	8
32811	194639	5	1	0	0	4	5
32811	208291	5	0	2	0	0	2
32811	291869	5	0	1	0	0	1
32811	291872	5	0	0	0	0	0
32811	291882	5	1	0	0	1	2
32811	291890	5	3	1	0	0	4
32811	482145	5	0	0	0	1	1
32811	482150	5	1	0	0	2	3
32811	482151	5	2	2	1	0	5
32811	482155	5	1	2	0	0	3
32811	192322	4	1	1	0	1	3
32811	195236	4	1	0	0	1	2
32811	196825	4	0	0	1	0	1
32811	198447	4	2	1	0	0	3
32811	208212	4	1	3	0	0	4
32811	291855	4	1	0	0	2	3
32811	291857	4	0	1	0	1	2
32811	291862	4	0	2	0	2	4
32811	291864	4	1	3	0	0	4
32811	291867	4	1	1	1	3	6
32811	291878	4	0	1	0	2	3
32811	291889	4	5	1	0	5	11
32811	291896	4	0	4	1	3	8
32811	291901	4	0	1	2	1	4
32811	291902	4	0	2	0	2	4
32811	482146	4	1	0	0	0	1
32811	482147	4	0	1	0	1	2
32811	482148	4	0	2	0	2	4
32811	482149	4	0	4	1	3	8
32811	482153	4	1	1	0	1	3
32811	482159	4	0	3	0	1	4
32811	201890	3	0	1	1	2	4
32811	204786	3	5	1	1	0	7
32811	291859	3	0	0	0	2	2
32811	291861	3	0	3	0	1	4
32811	291866	3	0	0	0	1	1
32811	291874	3	1	1	0	1	3
32811	291875	3	0	2	0	3	5
32811	291885	3	0	0	0	0	0
32811	291892	3	1	2	0	3	6
32811	291894	3	0	0	0	0	0
32811	291898	3	0	0	0	1	1
32811	482157	3	0	0	0	1	1
32811	185442	2	0	1	0	3	4
32811	191343	2	0	1	0	1	2
32811	193459	2	0	2	0	2	4
32811	205459	2	1	0	0	0	1
32811	205634	2	1	1	0	0	2
32811	208825	2	1	1	0	1	3
32811	214543	2	1	0	0	1	2
32811	215268	2	2	0	0	0	2
32811	216637	2	0	1	1	1	3
32811	220578	2	0	1	0	0	1
32811	291860	2	0	0	0	1	1
32811	291863	2	1	1	0	1	3
32811	291868	2	0	0	0	1	1
32811	291881	2	2	0	0	0	2
32811	291883	2	0	0	0	0	0
32811	291897	2	0	0	0	0	0
32811	482144	2	0	1	1	1	3
32811	482152	2	2	0	0	2	4
32811	482156	2	0	0	0	1	1
32811	482158	2	0	0	0	1	1
32811	187856	1	0	0	0	1	1
32811	192679	1	0	0	0	0	0
32811	197265	1	0	0	0	2	2
32811	206123	1	0	0	0	0	0
32811	215062	1	0	0	0	0	0
32811	218631	1	0	0	0	0	0
32811	291853	1	0	0	0	1	1
32811	291865	1	0	0	0	0	0
32811	291870	1	0	0	1	0	1
32811	291876	1	0	1	0	0	1
32811	291879	1	0	0	0	0	0
32811	291880	1	0	1	0	0	1
32811	291884	1	0	1	0	0	1
32811	291887	1	0	1	0	0	1
32811	291888	1	0	1	0	0	1
32811	291891	1	0	1	0	0	1
32811	291899	1	1	0	0	0	1
32811	482138	1	0	0	0	1	1
32811	482140	1	0	0	0	0	0
32811	482141	1	1	2	0	1	4
32811	482154	1	0	1	0	0	1
15047	287112	78	6	12	2	8	28
15047	56756	78	6	12	2	8	28
15047	91731	54	3	7	0	2	12
15047	95969	52	5	7	1	11	24
15047	92201	50	5	5	0	4	14
15047	385799	44	2	5	0	1	8
15047	107499	36	1	2	1	0	4
15047	287104	35	1	2	1	0	4
15047	385793	34	1	1	1	0	3
15047	202310	33	4	9	0	1	14
15047	287100	32	4	9	0	1	14
15047	385787	32	4	9	0	1	14
15047	82673	32	4	9	0	1	14
15047	187555	30	5	4	3	4	16
15047	58827	30	5	4	3	4	16
15047	385792	29	4	4	3	4	15
15047	103450	28	2	3	0	4	9
15047	385811	25	3	8	0	6	17
15047	287106	24	3	5	1	1	10
15047	287113	24	3	3	0	0	6
15047	385812	24	3	3	0	0	6
15047	52200	24	3	3	0	0	6
15047	57902	24	2	1	1	0	4
15047	86591	24	3	5	1	1	10
15047	207891	23	3	5	0	4	12
15047	287111	23	3	5	0	4	12
15047	91333	23	3	5	0	4	12
15047	287105	22	3	3	1	1	8
15047	385810	22	3	5	0	4	12
15047	74581	22	3	3	1	1	8
15047	106963	21	4	4	0	6	14
15047	107009	21	4	4	0	6	14
15047	198689	21	3	3	1	1	8
15047	220915	21	4	4	0	6	14
15047	287110	21	4	4	0	6	14
15047	385796	21	3	3	1	1	8
15047	385807	21	4	4	0	6	14
15047	67190	21	3	3	0	1	7
15047	287108	20	1	0	0	4	5
15047	385798	20	1	0	0	4	5
15047	80686	20	1	0	0	4	5
15047	100601	18	5	6	0	5	16
15047	105806	18	0	0	0	0	0
15047	219394	18	0	0	0	0	0
15047	58704	17	2	0	0	4	6
15047	83620	17	1	1	2	1	5
15047	212925	15	1	0	0	0	1
15047	287103	15	0	6	2	1	9
15047	385790	15	3	2	2	0	7
15047	385791	15	0	6	2	1	9
15047	86472	15	0	6	2	1	9
15047	97696	15	1	3	0	2	6
15047	287109	14	1	3	0	2	6
15047	385804	14	0	0	0	0	0
15047	81741	14	2	1	0	2	5
15047	99877	14	0	0	0	0	0
15047	107414	13	3	1	0	2	6
15047	287107	12	3	2	1	5	11
15047	50806	12	3	2	1	5	11
15047	385802	11	0	3	0	1	4
15047	385803	11	2	2	0	1	5
15047	53317	11	2	2	0	1	5
15047	65471	11	1	2	0	1	4
15047	69446	11	0	3	0	1	4
15047	86721	11	1	1	2	0	4
15047	189021	10	1	0	0	2	3
15047	385795	10	1	1	0	0	2
15047	51191	10	1	4	1	1	7
15047	85418	10	1	1	0	0	2
15047	385797	9	1	0	0	2	3
15047	50502	8	1	1	2	0	4
15047	204522	7	1	1	0	0	2
15047	287101	7	1	2	0	0	3
15047	287102	7	3	0	0	4	7
15047	385785	7	0	2	0	0	2
15047	385788	7	3	0	0	4	7
15047	385805	7	3	0	0	0	3
15047	385806	7	1	0	0	0	1
15047	49509	7	1	2	0	0	3
15047	90619	7	3	0	0	4	7
15047	90620	7	3	0	0	4	7
15047	100902	6	0	3	0	0	3
15047	287099	6	1	1	0	0	2
15047	385784	6	1	3	0	0	4
15047	58955	6	0	1	0	0	1
15047	64819	6	3	3	0	1	7
15047	66958	6	1	3	0	3	7
15047	84384	6	1	1	0	0	2
15047	385789	5	2	2	0	1	5
15047	60996	5	1	1	0	0	2
15047	88560	5	2	2	1	0	5
15047	92363	5	0	2	0	0	2
15047	205749	4	0	2	0	0	2
15047	385800	4	2	1	0	2	5
15047	385801	3	0	2	0	0	2
15047	385808	3	2	2	0	0	4
15047	385809	3	1	1	0	0	2
15047	81758	3	1	1	0	1	3
15047	182262	2	0	0	0	0	0
15047	385786	2	2	0	0	0	2
15047	385794	2	0	2	0	0	2
15047	108549	1	0	0	0	0	0
15047	189573	1	0	0	0	0	0
15047	208461	1	0	0	0	0	0
20133	100426	34	1	7	0	0	8
20133	210258	29	1	4	2	1	8
20133	96599	29	0	2	0	0	2
20133	95981	25	7	1	1	1	10
20133	107193	22	0	4	0	0	4
20133	198200	21	0	4	0	0	4
20133	288600	20	0	4	0	0	4
20133	513152	19	0	4	0	0	4
20133	513169	19	0	4	0	0	4
20133	51385	19	0	4	0	0	4
20133	55149	18	7	1	0	0	8
20133	85953	17	1	4	0	0	5
20133	63797	15	0	0	0	1	1
20133	61373	14	0	2	0	0	2
20133	186172	13	0	3	0	0	3
20133	221643	13	3	4	0	1	8
20133	288599	12	2	6	0	0	8
20133	513167	12	2	6	0	0	8
20133	513174	12	1	0	0	0	1
20133	61015	12	2	6	0	0	8
20133	513177	11	2	1	1	1	5
20133	51647	11	2	5	0	2	9
20133	513163	9	1	4	2	2	9
20133	288595	8	2	1	0	0	3
20133	71418	8	2	1	0	0	3
20133	195100	7	0	3	0	1	4
20133	513153	7	1	2	0	0	3
20133	513161	7	2	2	0	0	4
20133	95770	7	2	0	0	1	3
20133	190693	6	1	0	0	0	1
20133	288601	6	1	1	1	0	3
20133	513168	6	1	4	0	1	6
20133	90654	6	1	1	1	0	3
20133	188600	5	0	1	1	2	4
20133	189324	5	1	1	0	0	2
20133	193392	5	0	3	0	0	3
20133	288593	5	1	1	0	1	3
20133	288598	5	0	1	1	2	4
20133	513132	5	3	1	0	0	4
20133	513140	5	2	0	0	0	2
20133	513150	5	1	1	0	1	3
20133	513154	5	1	2	1	0	4
20133	513155	5	0	1	0	0	1
20133	513156	5	1	2	0	0	3
20133	513164	5	0	1	0	0	1
20133	513173	5	3	0	0	0	3
20133	513180	5	1	0	0	0	1
20133	513184	5	1	1	0	0	2
20133	59781	5	0	1	1	2	4
20133	92793	5	1	1	0	1	3
20133	196549	4	0	1	0	0	1
20133	288592	4	1	1	0	0	2
20133	288594	4	0	0	0	0	0
20133	288597	4	0	1	0	0	1
20133	50835	4	0	1	0	0	1
20133	513129	4	0	1	0	0	1
20133	513142	4	0	2	0	0	2
20133	513143	4	1	1	0	1	3
20133	513145	4	0	1	0	0	1
20133	513157	4	0	0	1	0	1
20133	513158	4	2	1	0	0	3
20133	513176	4	0	0	0	0	0
20133	513181	4	1	0	0	0	1
20133	513183	4	1	1	0	1	3
20133	215173	3	1	0	0	0	1
20133	513126	3	0	3	0	0	3
20133	513127	3	1	2	0	0	3
20133	513131	3	0	0	0	0	0
20133	513134	3	1	0	0	0	1
20133	513136	3	1	0	0	0	1
20133	513138	3	0	0	1	0	1
20133	513141	3	0	1	0	0	1
20133	513147	3	1	3	0	0	4
20133	513149	3	0	1	0	0	1
20133	513162	3	2	2	0	0	4
20133	513165	3	1	1	0	0	2
20133	513170	3	1	0	0	0	1
20133	513171	3	0	1	0	0	1
20133	513172	3	1	0	0	0	1
20133	513178	3	2	2	0	0	4
20133	513179	3	0	1	0	1	2
20133	513182	3	1	1	0	0	2
20133	182132	2	1	0	0	0	1
20133	191271	2	0	1	0	1	2
20133	196401	2	0	0	0	0	0
20133	201521	2	0	1	0	0	1
20133	513125	2	1	3	0	0	4
20133	513128	2	2	0	0	0	2
20133	513133	2	0	2	0	0	2
20133	513135	2	0	0	0	0	0
20133	513137	2	0	3	0	1	4
20133	513139	2	0	1	0	0	1
20133	513144	2	0	1	0	0	1
20133	513148	2	0	1	0	0	1
20133	513151	2	1	0	0	0	1
20133	513159	2	0	1	0	0	1
20133	513160	2	0	1	0	0	1
20133	513166	2	0	2	0	1	3
20133	513175	2	0	0	0	0	0
20133	83476	2	1	1	0	0	2
20133	288596	1	0	1	0	0	1
20133	513130	1	0	0	0	0	0
20133	513146	1	0	0	0	2	2
54971	71937	34	0	0	0	1	1
54971	404235	12	1	0	0	2	3
54971	404294	11	3	0	0	2	5
54971	404268	10	3	0	0	1	4
54971	404215	8	5	0	0	0	5
54971	404221	8	3	0	1	2	6
54971	404241	8	1	0	0	1	2
54971	404242	8	0	0	0	4	4
54971	404278	8	4	0	0	0	4
54971	404281	8	2	1	0	0	3
54971	404216	7	0	0	1	2	3
54971	404250	7	1	1	0	0	2
54971	404267	7	1	0	0	3	4
54971	404287	7	0	0	0	0	0
54971	404301	7	0	0	1	2	3
54971	404304	7	2	0	0	1	3
54971	404233	6	2	1	1	0	4
54971	404257	6	3	1	0	3	7
54971	404273	6	0	0	1	0	1
54971	404282	6	0	0	1	0	1
54971	404292	6	2	1	0	1	4
54971	404232	5	1	0	0	1	2
54971	404237	5	1	1	0	0	2
54971	404238	5	1	0	0	0	1
54971	404239	5	1	0	0	0	1
54971	404249	5	2	0	0	2	4
54971	404259	5	1	0	0	1	2
54971	404288	5	2	0	0	1	3
54971	404295	5	1	0	0	3	4
54971	404306	5	3	1	0	1	5
54971	404309	5	4	0	0	1	5
54971	404311	5	0	0	0	0	0
54971	404219	4	1	0	1	0	2
54971	404225	4	0	0	0	1	1
54971	404230	4	0	0	0	0	0
54971	404246	4	0	0	0	1	1
54971	404261	4	2	0	0	0	2
54971	404262	4	1	0	0	1	2
54971	404272	4	0	0	0	1	1
54971	404275	4	0	0	0	0	0
54971	404289	4	1	0	0	2	3
54971	404298	4	0	0	2	3	5
54971	404302	4	0	0	0	0	0
54971	404214	3	1	0	0	2	3
54971	404218	3	0	0	0	2	2
54971	404222	3	1	0	0	0	1
54971	404224	3	1	0	0	0	1
54971	404229	3	0	0	0	1	1
54971	404231	3	1	0	0	3	4
54971	404236	3	0	0	0	0	0
54971	404243	3	0	0	0	2	2
54971	404247	3	2	0	0	0	2
54971	404251	3	0	0	0	1	1
54971	404260	3	0	0	0	1	1
54971	404263	3	0	0	0	1	1
54971	404265	3	0	0	0	1	1
54971	404270	3	1	0	0	2	3
54971	404277	3	2	0	0	1	3
54971	404283	3	0	0	0	1	1
54971	404284	3	1	0	0	0	1
54971	404293	3	0	0	0	0	0
54971	404296	3	1	0	0	2	3
54971	404297	3	0	0	0	0	0
54971	404300	3	2	0	0	1	3
54971	404303	3	1	0	0	0	1
54971	404307	3	0	0	0	1	1
54971	404312	3	0	0	0	0	0
54971	404212	2	1	0	1	1	3
54971	404213	2	0	0	0	2	2
54971	404217	2	0	0	0	2	2
54971	404223	2	0	0	0	2	2
54971	404226	2	0	0	0	2	2
54971	404228	2	0	0	0	2	2
54971	404240	2	0	0	0	1	1
54971	404244	2	0	0	0	3	3
54971	404245	2	0	0	0	1	1
54971	404248	2	1	0	0	1	2
54971	404252	2	0	0	0	0	0
54971	404253	2	2	0	0	0	2
54971	404254	2	3	0	0	0	3
54971	404255	2	1	0	0	0	1
54971	404256	2	0	0	0	1	1
54971	404258	2	0	0	0	0	0
54971	404264	2	2	0	0	0	2
54971	404269	2	0	0	0	2	2
54971	404271	2	0	0	0	0	0
54971	404274	2	0	0	0	2	2
54971	404279	2	0	0	0	1	1
54971	404280	2	0	0	0	0	0
54971	404285	2	1	1	0	0	2
54971	404290	2	0	0	0	2	2
54971	404291	2	0	0	0	1	1
54971	404305	2	0	0	0	2	2
54971	404210	1	0	0	0	0	0
54971	404211	1	0	0	0	0	0
54971	404220	1	1	0	0	2	3
54971	404227	1	1	0	0	1	2
54971	404234	1	1	0	0	0	1
54971	404266	1	3	0	0	1	4
54971	404276	1	1	0	0	1	2
54971	404286	1	0	0	0	0	0
54971	404299	1	0	0	0	0	0
54971	404308	1	0	0	0	1	1
54971	404310	1	0	0	0	2	2
21875	68489	40	1	0	0	2	3
21875	106442	20	2	3	1	1	7
21875	221838	20	4	4	2	2	12
21875	198890	19	0	3	0	2	5
21875	289117	18	0	3	0	2	5
21875	74377	18	0	3	0	2	5
21875	78750	18	0	0	0	0	0
21875	85833	18	2	5	2	4	13
21875	289124	16	1	1	0	3	5
21875	200715	15	1	2	0	1	4
21875	289120	15	1	2	0	1	4
21875	76582	15	1	2	0	1	4
21875	58028	13	3	1	0	0	4
21875	213833	12	0	1	0	1	2
21875	289119	12	1	2	1	0	4
21875	70764	12	1	2	1	0	4
21875	99167	12	0	1	0	1	2
21875	58959	11	2	3	0	2	7
21875	79855	11	1	2	1	1	5
21875	103839	10	2	2	0	2	6
21875	506516	10	4	1	1	1	7
21875	86726	10	0	5	1	2	8
21875	53334	9	1	1	0	0	2
21875	55150	9	2	1	3	1	7
21875	193498	8	0	3	1	0	4
21875	289113	8	2	2	0	1	5
21875	289114	8	1	4	0	1	6
21875	289122	8	0	2	0	1	3
21875	506513	8	0	0	0	0	0
21875	53851	8	0	2	0	1	3
21875	57014	8	1	2	0	2	5
21875	94486	8	1	1	0	0	2
21875	105899	7	0	3	0	0	3
21875	106883	7	0	3	0	2	5
21875	184280	7	1	1	0	1	3
21875	219652	7	0	3	0	0	3
21875	448639	7	1	0	0	0	1
21875	506512	7	1	1	0	1	3
21875	506517	7	1	1	0	1	3
21875	85031	7	2	5	0	0	7
21875	98606	7	1	2	1	1	5
21875	101021	6	0	0	0	1	1
21875	195378	6	1	1	0	0	2
21875	221290	6	0	1	1	1	3
21875	289123	6	0	0	0	1	1
21875	448637	6	1	0	0	0	1
21875	448648	6	0	1	1	2	4
21875	506498	6	1	3	1	0	5
21875	506504	6	1	2	0	1	4
21875	506510	6	2	3	0	1	6
21875	506515	6	1	4	0	1	6
21875	57553	6	2	2	0	0	4
21875	66608	6	0	2	0	0	2
21875	91757	6	1	4	0	1	6
21875	205440	5	2	1	1	1	5
21875	289118	5	1	0	0	4	5
21875	188463	4	0	2	0	0	2
21875	191019	4	0	0	0	2	2
21875	211287	4	0	0	0	0	0
21875	215803	4	1	2	0	0	3
21875	289121	4	1	2	0	0	3
21875	448644	4	2	1	0	0	3
21875	506495	4	0	0	0	1	1
21875	506497	4	0	2	0	0	2
21875	506500	4	0	0	0	1	1
21875	506505	4	1	3	0	1	5
21875	506506	4	3	4	0	1	8
21875	506514	4	1	1	0	0	2
21875	79550	4	1	2	0	0	3
21875	187823	3	0	0	0	0	0
21875	213362	3	1	0	0	0	1
21875	213862	3	1	1	1	1	4
21875	289115	3	1	0	0	0	1
21875	448647	3	0	1	0	1	2
21875	448649	3	0	1	0	2	3
21875	506496	3	1	3	0	0	4
21875	506499	3	0	0	0	1	1
21875	506511	3	1	1	0	0	2
21875	71230	3	1	0	0	0	1
21875	88803	3	1	0	0	0	1
21875	100038	2	1	1	0	0	2
21875	182100	2	0	3	0	0	3
21875	184382	2	0	0	0	0	0
21875	188328	2	0	1	0	0	1
21875	207163	2	0	0	0	0	0
21875	217120	2	1	1	0	1	3
21875	289116	2	1	1	0	0	2
21875	448640	2	1	1	0	0	2
21875	448641	2	0	2	0	0	2
21875	448642	2	0	1	0	0	1
21875	448645	2	0	0	0	0	0
21875	448646	2	1	0	0	0	1
21875	448650	2	1	1	0	1	3
21875	448651	2	1	0	1	2	4
21875	506502	2	0	1	0	2	3
21875	506503	2	0	1	0	0	1
21875	506507	2	0	0	0	0	0
21875	506508	2	0	0	0	0	0
21875	506509	2	0	0	0	0	0
21875	183662	1	0	2	0	0	2
21875	448638	1	0	1	0	0	1
21875	448643	1	0	2	0	1	3
21875	506501	1	0	2	0	0	2
33858	199047	67	1	4	0	0	5
33858	292214	67	1	4	0	0	5
33858	199369	20	1	2	0	1	4
33858	422354	20	0	2	0	3	5
33858	422323	19	2	0	0	0	2
33858	212247	17	2	2	2	0	6
33858	422326	17	2	2	2	0	6
33858	191463	13	3	0	2	1	6
33858	201704	11	1	2	0	1	4
33858	204762	11	1	0	2	0	3
33858	185203	10	3	2	2	1	8
33858	211619	10	2	1	2	1	6
33858	219736	10	3	2	1	2	8
33858	292220	10	1	1	2	1	5
33858	422348	10	1	1	2	1	5
33858	422330	9	1	2	2	0	5
33858	292216	8	0	4	0	0	4
33858	292218	8	0	0	3	2	5
33858	422309	8	0	1	0	0	1
33858	422338	8	1	2	0	1	4
33858	188849	7	2	0	0	0	2
33858	207701	7	1	2	0	0	3
33858	422324	7	0	2	0	0	2
33858	422352	7	0	2	0	1	3
33858	183326	6	1	1	0	2	4
33858	190306	6	0	0	0	0	0
33858	204809	6	0	1	1	1	3
33858	292211	6	0	1	0	2	3
33858	292223	6	2	0	0	0	2
33858	422332	6	0	0	1	3	4
33858	422342	6	0	0	1	0	1
33858	422357	6	2	0	0	0	2
33858	192737	5	1	0	2	0	3
33858	194907	5	1	0	2	0	3
33858	212569	5	0	0	0	2	2
33858	292222	5	1	2	1	1	5
33858	422312	5	0	0	0	3	3
33858	422314	5	0	0	1	0	1
33858	422315	5	0	1	0	0	1
33858	422316	5	1	2	0	0	3
33858	422319	5	0	0	1	0	1
33858	422331	5	1	0	0	0	1
33858	422333	5	0	1	0	1	2
33858	422334	5	0	2	0	0	2
33858	422336	5	2	1	0	2	5
33858	422339	5	2	3	2	0	7
33858	422346	5	0	0	1	1	2
33858	422347	5	0	0	0	1	1
33858	422358	5	1	0	0	0	1
33858	184482	4	1	0	0	0	1
33858	184890	4	2	0	1	0	3
33858	191056	4	1	0	0	1	2
33858	204849	4	0	0	0	0	0
33858	206637	4	0	0	0	1	1
33858	210744	4	1	0	1	0	2
33858	292210	4	0	0	1	0	1
33858	292212	4	1	1	0	2	4
33858	292213	4	1	1	1	1	4
33858	292217	4	0	0	0	1	1
33858	292221	4	2	0	1	0	3
33858	422305	4	0	1	1	0	2
33858	422310	4	0	0	0	1	1
33858	422313	4	0	0	0	2	2
33858	422318	4	1	0	1	0	2
33858	422329	4	0	1	0	0	1
33858	422335	4	1	0	0	3	4
33858	422340	4	1	1	3	1	6
33858	422344	4	1	4	0	0	5
33858	422349	4	1	2	1	0	4
33858	422355	4	0	0	0	0	0
33858	422356	4	0	0	0	0	0
33858	196107	3	0	0	0	0	0
33858	202801	3	0	0	0	3	3
33858	292215	3	1	1	0	1	3
33858	292219	3	0	0	0	1	1
33858	422311	3	0	0	0	2	2
33858	422317	3	0	0	0	0	0
33858	422321	3	0	1	1	0	2
33858	422322	3	1	1	0	1	3
33858	422327	3	1	2	2	0	5
33858	422341	3	1	0	0	2	3
33858	422343	3	4	6	0	0	10
33858	422350	3	1	0	0	0	1
33858	422353	3	0	0	0	0	0
33858	185703	2	0	0	0	0	0
33858	192477	2	0	0	0	2	2
33858	212483	2	0	0	1	0	1
33858	422303	2	0	0	0	0	0
33858	422304	2	0	0	1	0	1
33858	422306	2	0	0	0	0	0
33858	422307	2	1	0	0	0	1
33858	422308	2	0	0	0	1	1
33858	422325	2	0	0	0	0	0
33858	422328	2	0	0	0	1	1
33858	422337	2	2	0	0	0	2
33858	422351	2	2	0	0	0	2
33858	422359	2	3	0	1	0	4
33858	220004	1	1	0	0	1	2
33858	422300	1	0	0	0	0	0
33858	422301	1	0	1	0	0	1
33858	422302	1	0	0	0	1	1
33858	422320	1	1	2	0	1	4
33858	422345	1	0	0	0	0	0
5774	85593	36	1	1	0	0	2
5774	51262	32	0	0	0	0	0
5774	57796	31	3	2	1	1	7
5774	284407	15	0	3	0	1	4
5774	509531	15	0	3	0	1	4
5774	509582	15	1	3	0	0	4
5774	82619	15	0	3	0	1	4
5774	100959	11	2	2	2	1	7
5774	284423	11	2	2	2	1	7
5774	509583	11	1	6	0	3	10
5774	284424	9	2	3	1	0	6
5774	509534	9	1	4	0	0	5
5774	509570	9	2	7	0	2	11
5774	101605	7	1	1	0	0	2
5774	284418	7	1	1	0	0	2
5774	509529	7	0	1	0	0	1
5774	509537	7	1	1	0	1	3
5774	509552	7	1	1	1	0	3
5774	509558	7	2	3	0	0	5
5774	509585	7	1	2	0	2	5
5774	284421	6	2	1	0	1	4
5774	509533	6	1	0	1	1	3
5774	509540	6	1	2	0	2	5
5774	509543	6	0	1	0	2	3
5774	509555	6	0	2	0	0	2
5774	509576	6	1	1	1	0	3
5774	78483	6	0	1	0	0	1
5774	93652	6	2	1	0	1	4
5774	284411	5	0	1	0	0	1
5774	284417	5	0	2	0	0	2
5774	509527	5	1	1	0	0	2
5774	509544	5	2	1	0	0	3
5774	509549	5	2	1	0	0	3
5774	509559	5	2	0	0	0	2
5774	509560	5	1	0	0	0	1
5774	509568	5	1	1	0	0	2
5774	509572	5	1	1	0	0	2
5774	100015	4	0	0	0	0	0
5774	102961	4	0	2	1	0	3
5774	284408	4	0	2	1	0	3
5774	284409	4	0	0	0	0	0
5774	284413	4	0	0	0	0	0
5774	284416	4	0	0	0	0	0
5774	284419	4	0	0	0	0	0
5774	509535	4	0	0	0	0	0
5774	509538	4	0	4	0	0	4
5774	509550	4	1	2	0	0	3
5774	509553	4	1	2	0	0	3
5774	509556	4	1	0	0	0	1
5774	509561	4	0	2	1	0	3
5774	509564	4	0	0	0	0	0
5774	509567	4	0	2	0	0	2
5774	509571	4	1	1	1	0	3
5774	509580	4	1	1	0	0	2
5774	509587	4	1	0	0	0	1
5774	509589	4	2	0	0	0	2
5774	509590	4	0	1	0	0	1
5774	509591	4	1	1	0	0	2
5774	284414	3	1	1	0	0	2
5774	284415	3	0	1	0	0	1
5774	284420	3	0	1	0	1	2
5774	509528	3	0	1	0	0	1
5774	509539	3	1	0	0	0	1
5774	509541	3	0	2	0	0	2
5774	509545	3	1	1	0	0	2
5774	509546	3	0	1	0	2	3
5774	509547	3	1	1	0	0	2
5774	509548	3	2	1	0	0	3
5774	509551	3	0	0	0	0	0
5774	509557	3	2	0	0	2	4
5774	509565	3	1	0	0	0	1
5774	509566	3	1	2	0	0	3
5774	509574	3	1	0	1	0	2
5774	509577	3	0	1	0	0	1
5774	509581	3	0	2	1	2	5
5774	509584	3	0	2	0	0	2
5774	81799	3	1	1	0	0	2
5774	90563	3	0	1	0	0	1
5774	98523	3	0	2	1	0	3
5774	101969	2	1	2	0	0	3
5774	284410	2	1	0	0	0	1
5774	284412	2	0	0	1	2	3
5774	509530	2	1	2	0	0	3
5774	509532	2	0	1	0	0	1
5774	509536	2	0	0	0	0	0
5774	509554	2	0	1	0	0	1
5774	509562	2	0	1	0	0	1
5774	509563	2	0	2	0	0	2
5774	509569	2	1	1	0	1	3
5774	509573	2	0	0	0	0	0
5774	509575	2	0	0	0	0	0
5774	509578	2	0	1	0	0	1
5774	509586	2	2	1	0	0	3
5774	509592	2	0	0	0	0	0
5774	284406	1	0	2	0	0	2
5774	284422	1	0	0	0	1	1
5774	509526	1	1	1	0	0	2
5774	509542	1	1	0	0	1	2
5774	509579	1	1	0	0	0	1
5774	509588	1	0	1	0	1	2
5774	71534	1	0	2	0	0	2
41790	515612	13	2	5	0	2	9
41790	199682	11	2	1	1	0	4
41790	515610	11	6	1	1	0	8
41790	515605	10	1	0	0	2	3
41790	515639	9	2	1	0	1	4
41790	515648	9	0	1	0	2	3
41790	515660	9	0	0	0	0	0
41790	279865	8	2	0	0	0	2
41790	515606	7	1	2	0	1	4
41790	515619	7	0	3	1	0	4
41790	515621	7	2	0	0	0	2
41790	193893	6	1	3	0	0	4
41790	206480	6	1	1	0	2	4
41790	279866	6	1	0	0	0	1
41790	279867	6	0	0	2	3	5
41790	515609	6	2	1	0	0	3
41790	515625	6	1	2	0	2	5
41790	515626	6	1	2	0	2	5
41790	515635	6	1	1	0	0	2
41790	515637	6	2	0	0	0	2
41790	515647	6	1	2	1	1	5
41790	515654	6	0	0	0	1	1
41790	204922	5	0	0	0	0	0
41790	215968	5	0	1	0	0	1
41790	279868	5	1	3	0	0	4
41790	515627	5	1	0	1	0	2
41790	515634	5	2	2	0	2	6
41790	515641	5	1	0	0	1	2
41790	515650	5	2	1	0	1	4
41790	515662	5	0	1	0	3	4
41790	515676	5	2	0	0	0	2
41790	515681	5	1	3	0	1	5
41790	213388	4	4	0	0	0	4
41790	515604	4	0	0	0	1	1
41790	515608	4	3	2	1	1	7
41790	515611	4	1	0	0	1	2
41790	515617	4	0	0	0	0	0
41790	515620	4	2	0	0	0	2
41790	515622	4	1	0	0	0	1
41790	515630	4	2	0	0	0	2
41790	515631	4	0	0	1	0	1
41790	515636	4	2	0	0	0	2
41790	515651	4	1	1	0	0	2
41790	515655	4	1	0	0	0	1
41790	515669	4	0	0	0	1	1
41790	515673	4	0	0	0	0	0
41790	515677	4	2	1	1	2	6
41790	515680	4	1	1	0	0	2
41790	187073	3	0	0	0	0	0
41790	208015	3	0	0	0	0	0
41790	216840	3	0	1	0	2	3
41790	217432	3	2	1	1	0	4
41790	515607	3	0	0	0	0	0
41790	515616	3	1	0	0	1	2
41790	515624	3	0	1	0	1	2
41790	515633	3	1	1	0	0	2
41790	515638	3	0	1	0	0	1
41790	515640	3	0	0	0	1	1
41790	515642	3	1	0	0	0	1
41790	515644	3	2	0	0	0	2
41790	515649	3	1	1	0	1	3
41790	515656	3	1	0	0	0	1
41790	515657	3	1	0	0	1	2
41790	515667	3	0	0	0	0	0
41790	515679	3	0	0	0	1	1
41790	515687	3	0	1	0	1	2
41790	191380	2	0	0	0	0	0
41790	214095	2	0	1	0	0	1
41790	217850	2	0	0	0	0	0
41790	515613	2	0	0	0	0	0
41790	515614	2	0	4	0	0	4
41790	515615	2	1	0	0	0	1
41790	515618	2	0	0	0	0	0
41790	515628	2	0	0	0	0	0
41790	515632	2	0	0	0	1	1
41790	515652	2	0	0	0	1	1
41790	515653	2	0	0	0	3	3
41790	515659	2	0	0	0	1	1
41790	515663	2	0	0	0	0	0
41790	515664	2	1	0	0	0	1
41790	515672	2	0	0	0	0	0
41790	515674	2	0	0	0	0	0
41790	515675	2	0	0	0	2	2
41790	515682	2	0	0	0	0	0
41790	515685	2	0	0	0	0	0
41790	515686	2	2	0	0	0	2
41790	515688	2	0	0	0	0	0
41790	515623	1	2	0	0	0	2
41790	515629	1	1	0	0	0	1
41790	515643	1	0	0	0	1	1
41790	515645	1	1	0	0	0	1
41790	515646	1	1	0	1	1	3
41790	515658	1	0	0	0	0	0
41790	515661	1	1	1	0	0	2
41790	515665	1	1	0	0	1	2
41790	515666	1	0	0	0	1	1
41790	515668	1	0	0	0	1	1
41790	515670	1	1	0	0	0	1
41790	515671	1	0	0	0	0	0
41790	515678	1	1	0	0	0	1
41790	515683	1	1	0	0	0	1
41790	515684	1	1	1	0	0	2
28772	453898	49	1	3	0	0	4
28772	453900	49	1	3	0	0	4
28772	78125	41	2	5	3	0	10
28772	193232	38	2	3	1	0	6
28772	290808	38	2	3	1	0	6
28772	78666	33	4	4	2	5	15
28772	453909	27	6	8	3	2	19
28772	83020	24	1	1	0	0	2
28772	290806	23	0	2	0	0	2
28772	68913	23	0	2	0	0	2
28772	96158	18	3	7	2	6	18
28772	193943	17	4	3	0	1	8
28772	453889	17	2	2	1	0	5
28772	83200	17	2	2	1	0	5
28772	290811	16	4	3	0	1	8
28772	453892	16	1	0	0	0	1
28772	88979	16	4	3	0	1	8
28772	290804	15	0	3	1	1	5
28772	453906	15	1	2	0	0	3
28772	74962	15	0	3	1	1	5
28772	453932	14	5	2	0	4	11
28772	192355	13	1	0	0	1	2
28772	79720	12	3	6	0	0	9
28772	202850	11	0	1	0	0	1
28772	290816	11	0	2	0	0	2
28772	453937	11	1	2	0	0	3
28772	59810	11	0	2	0	0	2
28772	188735	10	0	2	0	0	2
28772	453888	10	3	3	2	0	8
28772	453912	10	1	4	0	0	5
28772	453895	9	6	1	3	0	10
28772	453896	9	7	3	0	0	10
28772	453915	9	0	1	0	0	1
28772	453933	9	0	2	0	0	2
28772	183355	8	2	4	0	0	6
28772	453886	8	3	5	0	0	8
28772	453913	8	2	4	0	0	6
28772	208032	7	3	1	0	0	4
28772	453885	7	1	2	2	0	5
28772	453902	7	1	5	1	0	7
28772	453903	7	3	2	0	0	5
28772	453907	7	0	3	2	0	5
28772	83304	7	0	0	0	0	0
28772	90468	7	0	1	0	0	1
28772	101042	6	3	2	0	1	6
28772	217008	6	3	0	0	1	4
28772	290813	6	3	2	0	1	6
28772	453884	6	2	1	1	0	4
28772	453897	6	0	0	0	0	0
28772	453919	6	3	1	1	3	8
28772	453920	6	1	1	0	0	2
28772	453930	6	0	0	0	0	0
28772	453936	6	1	2	0	1	4
28772	100048	5	1	3	0	0	4
28772	104167	5	3	0	0	1	4
28772	204260	5	0	0	0	0	0
28772	208229	5	0	0	0	0	0
28772	214509	5	1	3	0	0	4
28772	217343	5	0	1	0	0	1
28772	290805	5	4	2	0	0	6
28772	290807	5	2	3	2	0	7
28772	290809	5	1	0	0	0	1
28772	290810	5	3	0	0	1	4
28772	290812	5	1	3	0	0	4
28772	290815	5	0	0	0	0	0
28772	453893	5	2	2	0	0	4
28772	453904	5	2	2	0	0	4
28772	453908	5	1	1	1	1	4
28772	453925	5	4	3	1	0	8
28772	453928	5	1	1	0	0	2
28772	453929	5	0	3	0	0	3
28772	453931	5	0	1	0	0	1
28772	453890	4	1	1	0	0	2
28772	453905	4	1	2	0	0	3
28772	453923	4	0	1	0	0	1
28772	453927	4	1	1	0	0	2
28772	453934	4	2	2	0	1	5
28772	453938	4	1	2	0	0	3
28772	453940	4	1	1	0	0	2
28772	191280	3	1	1	0	1	3
28772	195984	3	1	0	0	0	1
28772	453894	3	1	1	0	0	2
28772	453901	3	1	1	0	0	2
28772	453911	3	2	2	0	0	4
28772	453914	3	1	1	0	0	2
28772	453917	3	2	0	0	0	2
28772	453921	3	1	1	0	0	2
28772	453922	3	0	0	0	0	0
28772	453924	3	0	1	0	0	1
28772	453935	3	0	0	0	0	0
28772	453939	3	0	3	0	0	3
28772	453910	2	1	0	0	0	1
28772	453926	2	2	1	0	0	3
28772	103767	1	1	0	0	0	1
28772	185513	1	1	1	0	0	2
28772	211683	1	0	0	0	0	0
28772	290814	1	1	0	0	0	1
28772	453887	1	1	2	0	0	3
28772	453891	1	1	2	0	0	3
28772	453916	1	1	1	1	1	4
28772	453918	1	0	0	0	0	0
62936	299788	80	3	14	6	5	28
62936	56811	80	3	14	6	5	28
62936	81909	54	3	11	4	2	20
62936	299779	47	3	11	3	2	19
62936	537756	42	3	13	6	5	27
62936	187876	39	8	9	5	7	29
62936	58907	39	8	9	5	7	29
62936	537753	37	1	3	3	0	7
62936	537757	35	0	8	4	2	14
62936	537749	34	3	9	4	2	18
62936	299790	32	2	3	4	2	11
62936	537744	32	7	7	4	7	25
62936	91607	32	2	3	4	2	11
62936	537758	29	2	2	4	2	10
62936	299792	27	1	4	3	3	11
62936	82891	27	1	4	3	3	11
62936	80038	26	3	8	4	2	17
62936	299785	25	3	8	4	2	17
62936	537755	25	3	8	4	2	17
62936	299789	23	2	4	2	2	10
62936	53908	23	2	4	2	2	10
62936	103526	22	0	1	3	1	5
62936	299784	22	1	4	3	0	8
62936	537751	22	3	2	2	0	7
62936	299786	21	1	1	2	0	4
62936	299791	21	1	4	1	2	8
62936	60861	21	1	1	2	0	4
62936	85942	21	1	4	1	2	8
62936	147053	20	3	2	2	0	7
62936	299777	18	0	2	2	2	6
62936	299781	18	3	8	0	0	11
62936	299793	18	1	1	0	0	2
62936	537746	18	3	8	0	0	11
62936	56965	18	0	2	2	2	6
62936	86500	18	3	8	0	0	11
62936	91124	18	1	1	0	0	2
62936	299783	17	0	2	1	1	4
62936	299795	16	0	0	0	0	0
62936	537752	16	0	2	1	1	4
62936	55432	16	0	0	0	0	0
62936	70480	16	0	2	1	1	4
62936	204926	14	1	2	2	3	8
62936	537731	14	1	2	2	3	8
62936	85569	14	1	2	2	3	8
62936	106269	11	0	2	0	0	2
62936	219245	11	0	2	0	0	2
62936	49636	10	2	2	1	2	7
62936	51201	10	0	2	0	0	2
62936	537736	10	0	2	4	0	6
62936	537741	10	4	8	3	1	16
62936	537754	10	1	2	0	1	4
62936	537737	9	2	2	1	2	7
62936	92989	9	0	2	0	4	6
62936	105020	8	0	2	0	0	2
62936	299778	8	0	2	0	0	2
62936	299787	8	1	2	1	0	4
62936	66838	8	1	2	1	0	4
62936	84984	8	0	2	0	0	2
62936	72165	7	0	2	2	0	4
62936	86196	7	0	2	1	1	4
62936	100869	6	0	1	1	1	3
62936	299794	6	0	0	1	0	1
62936	537742	6	0	1	1	1	3
62936	537745	6	2	3	0	0	5
62936	57637	6	1	3	0	0	4
62936	85051	6	0	0	0	0	0
62936	299776	5	1	0	0	0	1
62936	537729	5	1	0	0	0	1
62936	537743	5	2	0	1	2	5
62936	70839	5	1	0	0	0	1
62936	74273	5	1	1	1	1	4
62936	537728	4	2	2	0	0	4
62936	537732	4	2	1	0	0	3
62936	537734	4	3	3	0	0	6
62936	537750	4	1	0	0	0	1
62936	103555	3	0	1	0	0	1
62936	193614	3	0	2	2	0	4
62936	196666	3	0	1	0	0	1
62936	214156	3	0	0	0	0	0
62936	299782	3	0	1	2	0	3
62936	537733	3	0	0	0	0	0
62936	537735	3	0	1	0	0	1
62936	537738	3	0	0	1	0	1
62936	537740	3	1	0	0	0	1
62936	537748	3	2	1	0	0	3
62936	66644	3	1	2	0	0	3
62936	85169	3	0	1	2	0	3
62936	182259	2	0	2	0	0	2
62936	186502	2	2	0	0	0	2
62936	191247	2	0	0	0	0	0
62936	299780	2	0	1	2	0	3
62936	537730	2	0	0	0	1	1
62936	56569	2	0	1	2	0	3
62936	83515	2	1	1	0	2	4
62936	195813	1	2	2	0	0	4
62936	198730	1	0	0	0	0	0
62936	208426	1	0	0	0	0	0
62936	537726	1	0	1	0	1	2
62936	537727	1	0	0	0	1	1
62936	537739	1	1	0	0	1	2
62936	537747	1	1	0	0	0	1
36814	89485	67	3	10	2	10	25
36814	543564	65	3	10	2	11	26
36814	82132	58	3	3	2	2	10
36814	96023	31	4	5	1	1	11
36814	293008	30	4	5	1	1	11
36814	202290	29	2	11	1	5	19
36814	543568	29	4	4	1	1	10
36814	293003	28	2	11	1	5	19
36814	543556	28	2	11	1	5	19
36814	82797	28	2	11	1	5	19
36814	293006	26	1	4	1	1	7
36814	50092	26	1	4	1	1	7
36814	543563	26	1	4	1	1	7
36814	181949	23	1	4	0	2	7
36814	49416	23	1	4	0	2	7
36814	543549	23	1	4	0	2	7
36814	51275	22	0	1	0	0	1
36814	293010	20	3	6	0	0	9
36814	68824	20	3	6	0	0	9
36814	80773	20	2	3	1	1	7
36814	53939	19	1	4	1	1	7
36814	51895	18	1	7	1	4	13
36814	101363	17	2	4	0	1	7
36814	293005	17	2	1	1	0	4
36814	56945	17	2	1	1	0	4
36814	106036	16	0	1	0	0	1
36814	219304	16	0	1	0	0	1
36814	293009	16	2	6	0	0	8
36814	52249	16	2	6	0	0	8
36814	543570	15	2	7	0	0	9
36814	102094	14	1	6	0	1	8
36814	188522	12	2	4	0	1	7
36814	60026	12	2	4	0	1	7
36814	68986	12	0	2	0	0	2
36814	106900	10	1	7	0	2	10
36814	204618	10	1	4	0	0	5
36814	543538	10	1	1	0	0	2
36814	102095	9	2	2	0	0	4
36814	108368	9	1	1	0	0	2
36814	293004	9	2	1	1	1	5
36814	293007	9	1	4	0	0	5
36814	71600	9	2	1	1	1	5
36814	84427	9	1	4	0	0	5
36814	543536	8	1	4	0	0	5
36814	94359	8	2	1	0	4	7
36814	543569	7	3	0	0	0	3
36814	187976	6	3	3	1	0	7
36814	191142	6	0	1	0	0	1
36814	195319	6	1	2	0	2	5
36814	293002	6	0	0	0	2	2
36814	543566	6	3	5	0	0	8
36814	543567	6	2	0	1	1	4
36814	79318	6	0	0	0	2	2
36814	183684	5	1	1	0	0	2
36814	543539	5	0	0	0	0	0
36814	543544	5	1	0	0	0	1
36814	543552	5	1	1	0	1	3
36814	543561	5	0	2	0	0	2
36814	66621	5	0	1	0	0	1
36814	75701	5	0	0	0	0	0
36814	98642	5	0	3	2	1	6
36814	195120	4	0	1	0	0	1
36814	543526	4	0	2	0	0	2
36814	543537	4	0	1	0	0	1
36814	543543	4	1	1	0	0	2
36814	543545	4	0	2	0	1	3
36814	543550	4	2	0	0	0	2
36814	543551	4	0	1	0	0	1
36814	99183	4	0	1	1	0	2
36814	181988	3	0	1	0	0	1
36814	189535	3	0	0	0	0	0
36814	543528	3	0	1	0	0	1
36814	543534	3	0	1	0	2	3
36814	543540	3	0	0	0	1	1
36814	543541	3	0	1	0	1	2
36814	543554	3	1	0	0	2	3
36814	543555	3	1	0	0	3	4
36814	543558	3	0	2	0	0	2
36814	543565	3	1	0	0	0	1
36814	79332	3	0	1	0	0	1
36814	202118	2	0	0	0	0	0
36814	220714	2	0	0	0	0	0
36814	543542	2	0	3	0	0	3
36814	543547	2	2	0	0	1	3
36814	543548	2	0	2	0	0	2
36814	543553	2	0	0	1	0	1
36814	543559	2	0	3	0	0	3
36814	543560	2	0	1	2	0	3
36814	187052	1	0	1	0	0	1
36814	189574	1	0	0	0	0	0
36814	199127	1	0	0	0	0	0
36814	208443	1	0	0	0	0	0
36814	543527	1	1	0	0	0	1
36814	543529	1	0	2	0	1	3
36814	543530	1	0	0	0	0	0
36814	543531	1	0	1	0	0	1
36814	543532	1	0	1	0	0	1
36814	543533	1	0	1	0	0	1
36814	543535	1	0	0	0	0	0
36814	543546	1	0	3	1	0	4
36814	543557	1	0	1	0	0	1
36814	543562	1	0	0	0	0	0
23354	63812	96	7	3	0	0	10
23354	187269	33	3	3	2	3	11
23354	217518	28	6	7	0	1	14
23354	381180	26	1	1	3	1	6
23354	614000	23	6	4	0	2	12
23354	186024	19	3	0	4	0	7
23354	108583	17	1	2	0	0	3
23354	289501	17	1	2	0	0	3
23354	381184	17	1	3	0	0	4
23354	184653	14	3	1	5	0	9
23354	381187	14	0	1	0	1	2
23354	614005	14	1	5	0	0	6
23354	55153	13	3	3	0	0	6
23354	381146	12	1	1	1	0	3
23354	381166	12	1	0	0	0	1
23354	381170	12	0	1	0	1	2
23354	194692	11	0	1	0	2	3
23354	381139	11	1	2	0	0	3
23354	105911	10	0	0	0	0	0
23354	187993	10	1	2	0	5	8
23354	208014	10	0	1	2	1	4
23354	219092	10	0	0	0	0	0
23354	64758	10	1	2	0	1	4
23354	289498	9	3	1	0	3	7
23354	289504	9	2	2	0	2	6
23354	381178	9	1	1	0	0	2
23354	381189	9	3	0	1	1	5
23354	381190	9	2	0	0	0	2
23354	381191	9	3	0	1	1	5
23354	53852	9	2	2	0	2	6
23354	76598	9	3	1	0	3	7
23354	191306	8	1	2	0	0	3
23354	381145	8	1	2	0	0	3
23354	381155	8	1	2	0	0	3
23354	381195	8	2	1	1	1	5
23354	208945	7	2	0	0	0	2
23354	381143	7	0	3	0	1	4
23354	381160	7	1	0	0	0	1
23354	381161	7	3	1	0	2	6
23354	381169	7	1	0	2	0	3
23354	381183	7	3	1	0	2	6
23354	381194	7	1	1	0	1	3
23354	101028	6	1	1	0	0	2
23354	220643	6	1	1	0	0	2
23354	289502	6	1	1	0	0	2
23354	381157	6	1	0	0	1	2
23354	381159	6	1	0	0	0	1
23354	381164	6	1	1	0	0	2
23354	381173	6	0	0	0	4	4
23354	381181	6	1	0	0	0	1
23354	75469	6	1	0	0	0	1
23354	381135	5	0	0	0	0	0
23354	381141	5	1	0	0	0	1
23354	381150	5	1	0	0	0	1
23354	381151	5	0	0	1	0	1
23354	381154	5	0	0	0	0	0
23354	381156	5	1	0	0	0	1
23354	381165	5	0	0	0	1	1
23354	381176	5	1	3	0	2	6
23354	381177	5	0	2	1	3	6
23354	381186	5	2	2	0	0	4
23354	614001	5	0	0	0	0	0
23354	614003	5	1	0	0	1	2
23354	614004	5	1	0	0	1	2
23354	213352	4	0	1	0	0	1
23354	289497	4	0	0	0	0	0
23354	381134	4	2	1	0	0	3
23354	381136	4	0	1	0	4	5
23354	381137	4	1	2	0	1	4
23354	381140	4	1	0	0	0	1
23354	381163	4	0	1	0	0	1
23354	381167	4	0	1	0	0	1
23354	381193	4	0	1	0	2	3
23354	614002	4	1	0	0	1	2
23354	289500	3	2	1	0	1	4
23354	381144	3	0	1	0	2	3
23354	381147	3	0	0	0	0	0
23354	381148	3	1	0	0	1	2
23354	381158	3	0	1	0	0	1
23354	381168	3	0	0	0	0	0
23354	381171	3	1	2	0	0	3
23354	381174	3	1	1	0	0	2
23354	381179	3	0	0	0	0	0
23354	381185	3	0	0	0	0	0
23354	381188	3	1	0	0	0	1
23354	289499	2	1	0	0	0	1
23354	381138	2	0	0	0	0	0
23354	381142	2	0	1	0	0	1
23354	381152	2	0	0	0	1	1
23354	381162	2	0	2	0	0	2
23354	381172	2	1	1	0	0	2
23354	381175	2	0	0	1	0	1
23354	381182	2	1	0	0	0	1
23354	381192	2	1	0	0	2	3
23354	614006	2	0	0	0	0	0
23354	99670	2	1	0	0	0	1
23354	205146	1	0	0	0	0	0
23354	211076	1	0	0	0	0	0
23354	289503	1	0	0	0	0	0
23354	381149	1	0	1	0	0	1
23354	381153	1	0	1	0	0	1
61814	299476	79	10	9	4	8	31
61814	56809	79	10	9	4	8	31
61814	70093	37	2	2	1	2	7
61814	299480	35	6	5	0	0	11
61814	49891	35	6	5	0	0	11
61814	104422	34	4	0	3	6	13
61814	299481	34	4	0	3	6	13
61814	533165	34	5	8	4	5	22
61814	533169	34	6	5	0	0	11
61814	533171	34	4	0	3	6	13
61814	299470	33	4	1	1	7	13
61814	71555	33	4	1	1	7	13
61814	67388	32	2	0	0	7	9
61814	93318	31	4	1	2	5	12
61814	533133	23	1	5	1	2	9
61814	75411	22	2	2	0	2	6
61814	299473	21	6	0	0	1	7
61814	66551	21	6	0	0	1	7
61814	299471	19	4	1	0	6	11
61814	53905	19	4	1	0	6	11
61814	299477	18	2	3	0	1	6
61814	533173	18	1	1	0	1	3
61814	72610	18	1	0	1	1	3
61814	99904	18	1	1	0	1	3
61814	100767	17	1	4	1	4	10
61814	299478	17	1	4	1	4	10
61814	299482	16	4	0	1	3	8
61814	533166	16	1	4	1	4	10
61814	533176	16	4	0	1	3	8
61814	86498	16	4	0	1	3	8
61814	99309	16	2	1	0	2	5
61814	299472	15	4	3	0	2	9
61814	533174	15	2	0	1	0	3
61814	299474	14	4	4	1	6	15
61814	64855	14	4	4	1	6	15
61814	106513	13	0	1	1	0	2
61814	195320	13	2	0	0	2	4
61814	299475	13	3	3	1	0	7
61814	50685	13	0	0	0	0	0
61814	56719	13	3	3	1	0	7
61814	533164	12	3	3	1	0	7
61814	81995	12	2	0	1	0	3
61814	84325	12	0	0	2	1	3
61814	533159	10	1	4	1	2	8
61814	533168	10	0	0	0	0	0
61814	533132	9	2	2	2	1	7
61814	533172	9	0	0	1	1	2
61814	533177	9	3	1	0	2	6
61814	65898	9	0	0	1	1	2
61814	97488	9	1	1	2	1	5
61814	299479	6	0	0	0	1	1
61814	49982	6	1	3	1	2	7
61814	51576	6	0	0	2	2	4
61814	533143	6	1	1	0	0	2
61814	533153	6	0	3	0	2	5
61814	533162	6	1	2	0	4	7
61814	533167	6	0	0	0	0	0
61814	533170	6	1	3	1	2	7
61814	66642	6	2	0	0	2	4
61814	533130	5	1	0	0	0	1
61814	533155	5	0	0	0	2	2
61814	533175	5	0	0	1	1	2
61814	533139	4	0	0	2	0	2
61814	533142	4	1	0	2	2	5
61814	533145	4	2	1	0	0	3
61814	533146	4	1	1	0	0	2
61814	533157	4	1	0	0	1	2
61814	533160	4	0	1	0	1	2
61814	533161	4	0	0	0	0	0
61814	56843	4	3	1	0	1	5
61814	533123	3	0	0	0	0	0
61814	533129	3	1	1	0	0	2
61814	533131	3	3	0	0	1	4
61814	533135	3	0	0	0	0	0
61814	533138	3	0	1	0	0	1
61814	533144	3	1	1	0	1	3
61814	533148	3	1	0	0	3	4
61814	533149	3	0	1	2	3	6
61814	533150	3	0	0	0	2	2
61814	533152	3	1	0	0	0	1
61814	533154	3	2	0	0	0	2
61814	533163	3	1	1	2	0	4
61814	196347	2	0	0	0	1	1
61814	533124	2	0	0	0	0	0
61814	533125	2	1	0	0	0	1
61814	533128	2	1	0	0	0	1
61814	533134	2	0	0	0	1	1
61814	533137	2	1	1	0	1	3
61814	533140	2	0	1	0	2	3
61814	533147	2	0	1	1	1	3
61814	533151	2	0	1	0	0	1
61814	533156	2	1	1	0	0	2
61814	533158	2	0	0	0	0	0
61814	66703	2	0	3	0	0	3
61814	208445	1	0	0	0	0	0
61814	533122	1	1	0	1	0	2
61814	533126	1	1	0	0	0	1
61814	533127	1	0	0	0	0	0
61814	533136	1	1	0	0	0	1
61814	533141	1	1	0	0	0	1
137	100361	32	2	2	1	0	5
137	86950	31	2	5	0	1	8
137	69014	30	1	2	3	1	7
137	187291	25	1	2	3	1	7
137	61161	23	0	2	1	2	5
137	77490	22	1	7	0	0	8
137	102819	16	1	0	0	0	1
137	104853	16	0	0	0	0	0
137	106602	16	1	3	0	1	5
137	201157	16	2	4	2	1	9
137	79767	16	0	6	0	1	7
137	98593	16	3	3	0	0	6
137	83456	15	1	2	0	0	3
137	200601	14	1	3	0	2	6
137	88684	14	2	2	2	0	6
137	187784	13	1	2	0	1	4
137	282956	13	0	1	0	2	3
137	76307	13	0	1	0	2	3
137	78703	13	0	2	0	2	4
137	82002	13	2	4	0	4	10
137	103025	12	1	1	0	0	2
137	106854	12	3	1	0	1	5
137	65412	12	2	1	0	1	4
137	69829	12	1	2	0	1	4
137	81710	12	2	3	0	2	7
137	96206	12	0	2	0	0	2
137	98603	12	1	5	0	0	6
137	184043	11	2	3	0	3	8
137	282963	11	2	3	0	3	8
137	217562	10	2	1	0	0	3
137	282962	10	0	1	1	1	3
137	528140	10	0	1	0	1	2
137	53827	10	0	1	1	1	3
137	62748	10	3	1	0	0	4
137	184936	9	1	2	0	0	3
137	282959	9	1	2	0	0	3
137	52171	9	2	3	0	3	8
137	528139	9	1	2	0	0	3
137	528141	9	2	3	0	3	8
137	528142	9	0	3	0	2	5
137	54079	9	1	2	0	0	3
137	528133	8	3	1	1	0	5
137	73737	8	3	2	0	0	5
137	528131	7	0	0	0	0	0
137	528134	7	1	0	1	2	4
137	528143	7	1	4	0	0	5
137	75057	7	1	3	0	2	6
137	79616	7	1	3	0	0	4
137	85734	7	1	2	0	0	3
137	86613	7	1	1	0	0	2
137	91700	7	3	2	1	0	6
137	99266	7	0	2	0	0	2
137	107338	6	1	5	0	1	7
137	193438	6	2	1	0	0	3
137	212640	6	1	2	0	0	3
137	282955	6	1	2	0	0	3
137	50134	6	1	0	0	1	2
137	528125	6	1	3	0	0	4
137	528127	6	0	2	0	0	2
137	528129	6	0	0	0	0	0
137	528132	6	4	0	0	0	4
137	528135	6	2	2	0	0	4
137	55114	6	2	4	0	0	6
137	68023	6	1	2	0	0	3
137	81201	6	2	3	0	1	6
137	215925	5	0	0	0	0	0
137	282960	5	0	0	0	0	0
137	282961	5	0	0	0	0	0
137	528128	5	1	0	0	0	1
137	528136	5	0	1	0	0	1
137	79535	5	0	0	0	0	0
137	80518	5	0	2	0	0	2
137	94552	5	1	0	0	0	1
137	102769	4	1	2	0	0	3
137	105229	4	0	3	0	2	5
137	217810	4	0	0	0	1	1
137	282957	4	1	1	0	1	3
137	528138	4	2	2	1	1	6
137	64201	4	1	1	0	1	3
137	98939	4	0	0	0	0	0
137	99237	4	1	3	0	2	6
137	184365	3	0	1	0	0	1
137	188457	3	0	2	0	0	2
137	528124	3	1	1	0	1	3
137	528126	3	1	1	0	1	3
137	528130	3	0	1	0	2	3
137	528137	3	1	1	0	0	2
137	74558	3	2	2	0	0	4
137	104598	2	1	2	0	0	3
137	198812	2	0	1	0	0	1
137	282958	2	0	1	0	0	1
137	51215	2	0	1	0	0	1
137	528123	2	0	1	0	1	2
137	81759	2	2	0	0	1	3
137	83461	2	0	1	0	0	1
137	86175	2	0	3	0	0	3
137	98030	2	0	1	0	0	1
137	282954	1	0	0	0	0	0
137	54457	1	1	3	0	2	6
137	86907	1	0	1	0	0	1
28838	524368	28	1	0	0	0	1
28838	389349	12	3	0	0	0	3
28838	524391	10	0	2	0	0	2
28838	389344	9	1	1	0	0	2
28838	524371	9	0	1	1	0	2
28838	389345	8	2	1	0	0	3
28838	389354	8	3	2	0	1	6
28838	524388	8	1	0	0	0	1
28838	524400	8	2	1	1	0	4
28838	389338	7	3	0	0	0	3
28838	389342	7	1	2	0	0	3
28838	389343	7	3	0	0	0	3
28838	507287	7	3	1	0	1	5
28838	524380	7	2	0	0	0	2
28838	524406	7	0	0	0	1	1
28838	524410	7	3	1	0	1	5
28838	524421	7	2	0	0	1	3
28838	591240	7	2	0	0	0	2
28838	507288	6	2	0	0	1	3
28838	524370	6	0	0	0	0	0
28838	524395	6	2	1	0	0	3
28838	524404	6	2	1	0	2	5
28838	290831	5	2	0	0	1	3
28838	389347	5	1	0	0	0	1
28838	389356	5	1	0	0	0	1
28838	524360	5	3	0	0	0	3
28838	524366	5	2	0	0	0	2
28838	524369	5	3	1	0	1	5
28838	524374	5	3	1	0	0	4
28838	524386	5	0	1	0	2	3
28838	524387	5	2	1	0	1	4
28838	524396	5	0	0	0	0	0
28838	524417	5	0	0	0	0	0
28838	524418	5	2	1	0	0	3
28838	524426	5	2	0	0	0	2
28838	591241	5	1	0	0	0	1
28838	389339	4	2	0	0	0	2
28838	389341	4	4	0	0	0	4
28838	389346	4	0	0	0	0	0
28838	389353	4	0	0	0	0	0
28838	524365	4	1	1	0	0	2
28838	524367	4	4	0	0	0	4
28838	524383	4	0	0	0	0	0
28838	524394	4	4	0	0	0	4
28838	524399	4	2	1	0	0	3
28838	524402	4	1	1	0	2	4
28838	524403	4	1	0	0	0	1
28838	524407	4	0	0	0	0	0
28838	524409	4	0	0	0	0	0
28838	524411	4	1	0	0	0	1
28838	524424	4	4	0	0	0	4
28838	524427	4	1	0	0	0	1
28838	591242	4	0	1	0	0	1
28838	389351	3	1	0	0	0	1
28838	389355	3	5	0	0	0	5
28838	524372	3	2	0	1	0	3
28838	524375	3	2	0	0	0	2
28838	524377	3	2	0	0	0	2
28838	524378	3	1	1	0	0	2
28838	524381	3	2	2	0	0	4
28838	524390	3	0	0	0	0	0
28838	524393	3	0	1	0	0	1
28838	524397	3	2	0	0	0	2
28838	524412	3	0	0	0	0	0
28838	524423	3	0	0	0	0	0
28838	591244	3	0	1	0	0	1
28838	591245	3	2	0	0	0	2
28838	389337	2	0	0	0	0	0
28838	389340	2	0	0	0	0	0
28838	389350	2	3	0	0	0	3
28838	524358	2	0	0	0	1	1
28838	524359	2	2	0	0	0	2
28838	524361	2	0	0	0	0	0
28838	524362	2	0	0	0	0	0
28838	524363	2	0	0	0	0	0
28838	524364	2	0	1	0	0	1
28838	524379	2	1	0	0	1	2
28838	524384	2	0	1	0	0	1
28838	524389	2	0	0	0	0	0
28838	524392	2	0	0	0	0	0
28838	524398	2	1	0	0	0	1
28838	524405	2	0	0	0	0	0
28838	524408	2	2	0	0	0	2
28838	524413	2	1	0	0	0	1
28838	524414	2	0	0	0	0	0
28838	524416	2	0	0	0	0	0
28838	524422	2	0	1	0	0	1
28838	524425	2	0	0	0	0	0
28838	591243	2	1	0	0	0	1
28838	389348	1	1	0	0	2	3
28838	389352	1	0	0	0	0	0
28838	524373	1	2	2	0	0	4
28838	524376	1	0	1	0	0	1
28838	524382	1	3	0	0	0	3
28838	524385	1	2	1	0	0	3
28838	524401	1	1	1	1	0	3
28838	524415	1	1	0	0	0	1
28838	524419	1	1	2	0	0	3
28838	524420	1	1	1	0	0	2
28838	591246	1	0	0	0	0	0
28838	591247	1	0	0	0	0	0
66159	53105	42	2	3	3	2	10
66159	80061	32	0	11	2	4	17
66159	300847	24	0	3	1	1	5
66159	198874	23	0	3	1	1	5
66159	74533	23	0	3	1	1	5
66159	84597	23	2	1	3	1	7
66159	188709	13	3	2	0	2	7
66159	221793	13	1	3	0	3	7
66159	300858	13	3	2	0	2	7
66159	59957	13	3	2	0	2	7
66159	203510	12	2	0	0	0	2
66159	190771	11	0	1	0	0	1
66159	216929	10	2	1	0	0	3
66159	300844	10	1	2	2	0	5
66159	300860	10	0	2	0	0	2
66159	435957	10	1	1	0	6	8
66159	51370	10	2	1	1	2	6
66159	53912	10	0	2	0	0	2
66159	91861	10	1	1	0	6	8
66159	300853	9	0	3	0	2	5
66159	435956	9	0	2	0	2	4
66159	435966	9	0	3	0	2	5
66159	80873	9	1	2	2	0	5
66159	106947	8	1	6	0	1	8
66159	184049	8	2	5	0	2	9
66159	300845	8	2	5	0	2	9
66159	435952	8	0	2	0	0	2
66159	435961	8	2	5	0	2	9
66159	52309	8	2	5	0	2	9
66159	101554	7	3	2	0	0	5
66159	103613	7	0	3	0	3	6
66159	211286	7	2	2	0	0	4
66159	214858	7	3	2	0	0	5
66159	300852	7	3	2	0	0	5
66159	435946	7	1	2	0	0	3
66159	435947	7	3	0	0	0	3
66159	435964	7	2	1	0	0	3
66159	435970	7	2	4	0	0	6
66159	59300	7	1	2	0	1	4
66159	300856	6	1	2	0	0	3
66159	435954	6	1	1	2	1	5
66159	435959	6	1	1	0	1	3
66159	435960	6	1	3	0	0	4
66159	435963	6	0	0	0	1	1
66159	435967	6	0	3	1	0	4
66159	435969	6	0	1	0	2	3
66159	435972	6	1	4	0	1	6
66159	62370	6	0	3	0	0	3
66159	91194	6	1	2	0	0	3
66159	98599	6	0	2	1	0	3
66159	194722	5	0	1	0	0	1
66159	205745	5	3	1	0	0	4
66159	214268	5	0	2	0	0	2
66159	300841	5	1	0	0	0	1
66159	300843	5	1	1	0	1	3
66159	300851	5	5	1	1	0	7
66159	435965	5	3	3	0	1	7
66159	435971	5	0	2	1	0	3
66159	51128	5	1	1	0	1	3
66159	53482	5	0	1	0	0	1
66159	575460	5	0	3	0	0	3
66159	64656	5	5	1	1	0	7
66159	95601	5	1	0	0	0	1
66159	101909	4	1	6	0	0	7
66159	104939	4	0	1	0	0	1
66159	193467	4	1	2	0	0	3
66159	213404	4	1	1	0	0	2
66159	220094	4	0	1	0	1	2
66159	300839	4	0	1	0	2	3
66159	300854	4	1	6	0	0	7
66159	435950	4	1	0	0	0	1
66159	435955	4	1	1	0	0	2
66159	435962	4	0	2	0	1	3
66159	62455	4	0	0	0	0	0
66159	75594	4	2	1	0	0	3
66159	86292	4	0	1	0	2	3
66159	201937	3	2	1	0	0	3
66159	300840	3	0	1	0	1	2
66159	435948	3	0	1	0	0	1
66159	435951	3	0	2	0	1	3
66159	435958	3	0	0	0	0	0
66159	57046	3	3	1	0	0	4
66159	86199	3	0	1	0	1	2
66159	204209	2	2	0	0	0	2
66159	300842	2	0	0	0	0	0
66159	300848	2	2	0	0	0	2
66159	300849	2	1	1	0	0	2
66159	300850	2	0	0	0	1	1
66159	300855	2	0	0	0	0	0
66159	300859	2	0	1	0	0	1
66159	435953	2	0	0	0	0	0
66159	435968	2	0	1	0	0	1
66159	54333	2	1	1	0	0	2
66159	87283	2	0	0	0	0	0
66159	204208	1	0	0	0	0	0
66159	300846	1	0	0	0	0	0
66159	300857	1	1	0	0	0	1
66159	435949	1	1	1	0	1	3
66159	53791	1	1	0	0	0	1
66159	61362	1	0	0	0	0	0
66725	75977	26	3	0	1	3	7
66725	74556	24	2	3	1	2	8
66725	622268	13	4	1	0	3	8
66725	622287	12	7	1	0	1	9
66725	622291	10	2	0	1	0	3
66725	622318	9	1	4	0	0	5
66725	622323	9	4	1	0	2	7
66725	622292	8	3	2	0	0	5
66725	101205	7	1	0	0	0	1
66725	301002	7	1	0	0	0	1
66725	622282	7	2	1	0	0	3
66725	622302	7	5	0	0	0	5
66725	622285	6	4	0	0	0	4
66725	622300	6	0	1	0	0	1
66725	622319	6	2	1	0	1	4
66725	101912	5	0	0	0	1	1
66725	186394	5	0	0	0	0	0
66725	188218	5	2	1	0	0	3
66725	205078	5	2	2	0	3	7
66725	300996	5	2	2	0	3	7
66725	300997	5	0	0	0	1	1
66725	301005	5	1	2	0	2	5
66725	51134	5	1	2	0	2	5
66725	622280	5	2	0	0	1	3
66725	622289	5	1	0	0	1	2
66725	622294	5	3	3	0	0	6
66725	622307	5	6	1	0	0	7
66725	622313	5	4	1	0	0	5
66725	622326	5	3	0	0	0	3
66725	85006	5	0	1	0	2	3
66725	100121	4	1	1	0	2	4
66725	218481	4	0	0	0	2	2
66725	300995	4	0	3	1	1	5
66725	300998	4	1	0	0	1	2
66725	301001	4	1	1	0	2	4
66725	301004	4	0	0	0	2	2
66725	622267	4	1	0	0	0	1
66725	622272	4	2	2	0	0	4
66725	622275	4	2	2	0	0	4
66725	622276	4	2	0	1	3	6
66725	622277	4	1	1	0	1	3
66725	622279	4	2	0	0	0	2
66725	622293	4	0	0	0	1	1
66725	622297	4	0	0	0	0	0
66725	622306	4	4	1	0	0	5
66725	622308	4	1	1	0	2	4
66725	622312	4	1	2	0	1	4
66725	622317	4	2	1	0	0	3
66725	622322	4	1	1	0	0	2
66725	94146	4	0	0	0	2	2
66725	206454	3	1	2	0	0	3
66725	206878	3	1	0	0	0	1
66725	301000	3	3	0	0	0	3
66725	301006	3	2	1	0	1	4
66725	502136	3	2	2	0	0	4
66725	56411	3	3	0	0	0	3
66725	59078	3	2	1	0	1	4
66725	622266	3	2	0	0	1	3
66725	622269	3	0	0	0	2	2
66725	622270	3	1	1	0	0	2
66725	622273	3	1	0	0	3	4
66725	622274	3	1	2	1	0	4
66725	622283	3	1	0	0	0	1
66725	622284	3	1	1	0	0	2
66725	622288	3	2	0	0	0	2
66725	622295	3	1	0	0	0	1
66725	622296	3	6	1	2	1	10
66725	622299	3	1	0	0	1	2
66725	622301	3	1	0	0	0	1
66725	622304	3	2	2	0	0	4
66725	622305	3	1	0	0	0	1
66725	622314	3	1	1	0	0	2
66725	622315	3	1	1	1	1	4
66725	622320	3	1	0	0	0	1
66725	622324	3	0	1	0	0	1
66725	622325	3	0	0	0	0	0
66725	215742	2	1	0	0	1	2
66725	216397	2	1	0	0	0	1
66725	219917	2	2	1	0	0	3
66725	300999	2	1	0	0	0	1
66725	301003	2	0	0	1	1	2
66725	301007	2	1	0	0	0	1
66725	622281	2	1	0	0	0	1
66725	622303	2	1	0	0	0	1
66725	622310	2	0	1	0	0	1
66725	622321	2	0	0	0	0	0
66725	79239	2	0	0	1	1	2
66725	90275	2	1	0	0	0	1
66725	186592	1	0	0	0	1	1
66725	201498	1	1	1	0	0	2
66725	205849	1	1	0	0	0	1
66725	207343	1	1	0	0	0	1
66725	213892	1	0	0	0	0	0
66725	622271	1	0	0	0	0	0
66725	622278	1	0	0	0	0	0
66725	622286	1	3	2	0	0	5
66725	622290	1	1	2	0	1	4
66725	622298	1	0	1	0	1	2
66725	622309	1	1	0	0	0	1
66725	622311	1	0	0	0	0	0
66725	622316	1	1	1	0	0	2
35643	593667	13	3	1	2	0	6
35643	593653	11	3	0	1	0	4
35643	593644	10	2	1	0	0	3
35643	593649	10	0	0	1	3	4
35643	593624	9	3	1	1	5	10
35643	593711	7	0	0	0	0	0
35643	593619	6	2	0	0	0	2
35643	593668	6	2	0	0	0	2
35643	593676	6	2	0	0	0	2
35643	593692	6	4	0	2	0	6
35643	593618	5	0	0	1	1	2
35643	593637	5	2	0	0	1	3
35643	593660	5	1	0	0	0	1
35643	593684	5	2	0	0	0	2
35643	593691	5	3	0	1	0	4
35643	593697	5	0	0	0	1	1
35643	593699	5	2	0	0	0	2
35643	593620	4	3	0	0	0	3
35643	593621	4	0	1	0	0	1
35643	593623	4	1	0	0	2	3
35643	593650	4	2	0	0	0	2
35643	593651	4	1	0	0	0	1
35643	593670	4	0	0	0	0	0
35643	593673	4	1	0	0	0	1
35643	593675	4	0	0	0	0	0
35643	593679	4	1	0	0	0	1
35643	593698	4	1	0	0	0	1
35643	593703	4	0	0	0	1	1
35643	593710	4	1	0	0	0	1
35643	593625	3	4	0	0	0	4
35643	593638	3	2	0	0	0	2
35643	593641	3	0	0	0	1	1
35643	593642	3	2	0	0	0	2
35643	593656	3	1	1	0	0	2
35643	593657	3	1	0	0	0	1
35643	593659	3	0	3	0	0	3
35643	593661	3	2	0	0	0	2
35643	593663	3	3	0	0	0	3
35643	593666	3	0	0	0	0	0
35643	593678	3	1	0	0	0	1
35643	593682	3	1	0	0	0	1
35643	593688	3	1	0	0	0	1
35643	593689	3	0	0	0	0	0
35643	593695	3	2	0	0	0	2
35643	593704	3	1	0	0	0	1
35643	593713	3	1	0	0	0	1
35643	593622	2	1	0	0	0	1
35643	593626	2	3	0	0	0	3
35643	593628	2	2	0	0	0	2
35643	593629	2	2	0	0	0	2
35643	593630	2	2	0	0	0	2
35643	593631	2	1	0	0	0	1
35643	593632	2	2	3	0	0	5
35643	593634	2	2	0	0	0	2
35643	593635	2	2	1	0	0	3
35643	593640	2	2	0	0	0	2
35643	593643	2	2	0	0	0	2
35643	593645	2	1	0	0	0	1
35643	593648	2	4	0	0	0	4
35643	593658	2	0	0	0	0	0
35643	593662	2	2	0	0	0	2
35643	593669	2	2	2	0	0	4
35643	593671	2	2	0	0	0	2
35643	593672	2	0	0	0	1	1
35643	593674	2	0	1	0	0	1
35643	593685	2	0	0	0	0	0
35643	593687	2	3	0	0	0	3
35643	593694	2	2	0	0	0	2
35643	593696	2	3	1	0	0	4
35643	593701	2	3	0	0	0	3
35643	593705	2	0	0	0	0	0
35643	593706	2	0	0	0	0	0
35643	593707	2	3	1	0	0	4
35643	593709	2	1	0	0	0	1
35643	593714	2	0	0	0	0	0
35643	593716	2	2	0	0	0	2
35643	593616	1	1	0	0	0	1
35643	593617	1	1	0	0	0	1
35643	593627	1	1	0	0	0	1
35643	593633	1	2	1	0	0	3
35643	593636	1	2	0	0	1	3
35643	593639	1	0	0	0	0	0
35643	593646	1	0	0	0	0	0
35643	593647	1	1	0	0	0	1
35643	593652	1	1	0	0	0	1
35643	593654	1	1	0	0	0	1
35643	593655	1	2	0	0	0	2
35643	593664	1	1	0	0	0	1
35643	593677	1	0	0	0	0	0
35643	593680	1	1	0	0	0	1
35643	593681	1	1	0	0	0	1
35643	593683	1	3	0	0	0	3
35643	593686	1	2	0	1	0	3
35643	593690	1	3	0	0	0	3
35643	593693	1	0	0	0	0	0
35643	593700	1	1	0	0	0	1
35643	593702	1	0	0	0	0	0
35643	593708	1	1	0	0	0	1
35643	593712	1	3	0	0	0	3
35643	593715	1	1	2	0	0	3
1385	82316	34	1	4	1	0	6
1385	283299	30	5	3	1	1	10
1385	52349	30	5	3	1	1	10
1385	77632	30	2	2	0	3	7
1385	73326	25	1	1	0	1	3
1385	53520	20	2	0	0	3	5
1385	76327	20	1	3	1	0	5
1385	200756	18	1	3	0	1	5
1385	283308	18	1	3	0	1	5
1385	200807	17	1	3	0	1	5
1385	92917	17	1	0	2	1	4
1385	55405	14	0	1	0	0	1
1385	86587	14	1	2	0	0	3
1385	61386	13	0	0	0	3	3
1385	69349	13	3	0	0	1	4
1385	283306	11	1	0	3	1	5
1385	55401	11	1	2	0	2	5
1385	78065	11	1	0	0	2	3
1385	79035	11	1	0	3	1	5
1385	104131	10	0	2	0	0	2
1385	186187	10	1	1	0	0	2
1385	217031	10	0	2	0	0	2
1385	283303	10	1	0	1	0	2
1385	283305	10	0	2	0	0	2
1385	95259	10	1	0	0	0	1
1385	100880	9	0	3	0	0	3
1385	283295	9	0	2	0	0	2
1385	283298	9	1	1	0	0	2
1385	56907	9	0	2	0	0	2
1385	81832	9	0	0	0	2	2
1385	96219	9	2	1	0	0	3
1385	101517	8	2	2	0	1	5
1385	283313	8	1	3	1	2	7
1385	75501	8	1	1	1	1	4
1385	89945	8	1	1	0	0	2
1385	92220	8	1	2	0	0	3
1385	220100	7	3	1	0	2	6
1385	283307	7	1	0	1	0	2
1385	71077	7	1	0	1	0	2
1385	104226	6	1	1	0	0	2
1385	107966	6	1	0	0	0	1
1385	195106	6	0	2	0	0	2
1385	189925	5	0	1	0	0	1
1385	283304	5	0	0	1	0	1
1385	49919	5	0	2	0	0	2
1385	86902	5	1	1	2	0	4
1385	98646	5	2	1	0	1	4
1385	198649	4	0	0	0	0	0
1385	200566	4	0	1	0	0	1
1385	206221	4	0	0	0	0	0
1385	212336	4	0	2	0	0	2
1385	216087	4	1	1	0	0	2
1385	216692	4	3	0	1	0	4
1385	283300	4	0	1	0	1	2
1385	283311	4	1	0	4	1	6
1385	54028	4	0	1	0	1	2
1385	55687	4	0	0	0	1	1
1385	75696	4	1	0	0	0	1
1385	78473	4	0	0	0	0	0
1385	85278	4	0	3	0	0	3
1385	194407	3	1	0	1	1	3
1385	196418	3	1	0	0	0	1
1385	200630	3	3	2	2	0	7
1385	202034	3	1	1	0	0	2
1385	203985	3	0	0	0	0	0
1385	208190	3	0	1	0	0	1
1385	211881	3	1	0	0	0	1
1385	213546	3	0	0	0	0	0
1385	217247	3	0	2	0	0	2
1385	218761	3	0	1	0	0	1
1385	218771	3	0	0	0	0	0
1385	283297	3	0	1	0	0	1
1385	283301	3	0	2	0	0	2
1385	283310	3	0	1	0	0	1
1385	71277	3	0	1	0	0	1
1385	93021	3	1	1	0	1	3
1385	96459	3	0	0	0	1	1
1385	196522	2	0	0	0	0	0
1385	199786	2	0	0	0	0	0
1385	201297	2	0	1	0	0	1
1385	203772	2	0	0	0	0	0
1385	205529	2	1	0	0	0	1
1385	219901	2	0	0	0	0	0
1385	219902	2	0	0	0	0	0
1385	283302	2	0	0	0	0	0
1385	283309	2	0	0	0	0	0
1385	99441	2	0	0	0	0	0
1385	182314	1	0	0	0	0	0
1385	190084	1	0	0	0	0	0
1385	192852	1	0	1	0	0	1
1385	200064	1	0	0	0	0	0
1385	203124	1	1	0	0	0	1
1385	204593	1	0	0	0	0	0
1385	218694	1	0	0	0	0	0
1385	221088	1	0	0	0	0	0
1385	283296	1	0	0	0	0	0
1385	283312	1	0	0	0	0	0
1385	56138	1	0	0	0	0	0
1385	95266	1	0	0	0	0	0
32265	71847	37	2	0	0	2	4
32265	530089	15	5	2	0	0	7
32265	530094	14	1	0	1	0	2
32265	530099	10	2	1	0	0	3
32265	530086	8	3	0	0	0	3
32265	530058	7	0	0	0	0	0
32265	530083	7	2	0	0	0	2
32265	530028	6	1	0	0	0	1
32265	530041	6	1	0	0	0	1
32265	530045	6	1	0	0	1	2
32265	530061	6	2	0	0	0	2
32265	530069	6	2	0	0	0	2
32265	530090	6	1	1	0	1	3
32265	530093	6	2	0	0	0	2
32265	530044	5	0	0	0	0	0
32265	530081	5	1	0	0	0	1
32265	530096	5	0	0	0	1	1
32265	55285	5	0	0	0	0	0
32265	530027	4	1	0	0	0	1
32265	530031	4	0	0	0	2	2
32265	530034	4	0	0	0	0	0
32265	530039	4	1	0	0	0	1
32265	530048	4	1	0	0	0	1
32265	530051	4	3	1	3	0	7
32265	530052	4	0	0	0	1	1
32265	530054	4	1	0	0	0	1
32265	530063	4	1	0	1	0	2
32265	530070	4	0	0	1	0	1
32265	530078	4	1	0	0	0	1
32265	530079	4	1	0	0	1	2
32265	530082	4	2	0	0	0	2
32265	530084	4	1	0	0	0	1
32265	530095	4	2	0	1	0	3
32265	530106	4	1	0	1	0	2
32265	530108	4	0	0	0	0	0
32265	530109	4	1	0	0	0	1
32265	530111	4	0	0	0	0	0
32265	530113	4	2	0	0	0	2
32265	196667	3	1	0	0	0	1
32265	530030	3	0	0	0	1	1
32265	530035	3	1	0	0	1	2
32265	530038	3	2	1	0	0	3
32265	530042	3	1	0	0	0	1
32265	530046	3	1	0	0	0	1
32265	530047	3	1	1	0	0	2
32265	530053	3	0	0	0	1	1
32265	530056	3	0	0	0	0	0
32265	530057	3	0	0	0	0	0
32265	530059	3	2	0	0	0	2
32265	530060	3	0	0	1	1	2
32265	530064	3	0	0	0	0	0
32265	530068	3	0	0	0	0	0
32265	530075	3	1	0	0	0	1
32265	530080	3	0	0	1	0	1
32265	530088	3	1	0	2	1	4
32265	530097	3	1	0	0	0	1
32265	530105	3	1	0	0	0	1
32265	530110	3	1	0	1	0	2
32265	530112	3	1	0	0	1	2
32265	530019	2	0	0	0	0	0
32265	530022	2	0	0	0	0	0
32265	530024	2	1	0	0	1	2
32265	530036	2	0	0	0	0	0
32265	530040	2	0	0	0	1	1
32265	530043	2	1	0	0	0	1
32265	530049	2	3	0	0	0	3
32265	530050	2	1	0	0	0	1
32265	530055	2	1	1	0	0	2
32265	530062	2	0	0	0	0	0
32265	530065	2	1	0	0	0	1
32265	530066	2	1	0	0	0	1
32265	530067	2	1	0	0	0	1
32265	530071	2	3	0	0	0	3
32265	530073	2	1	0	0	0	1
32265	530074	2	1	0	0	1	2
32265	530076	2	0	0	1	0	1
32265	530077	2	0	0	0	0	0
32265	530087	2	0	0	0	1	1
32265	530091	2	2	0	0	1	3
32265	530092	2	1	0	0	0	1
32265	530098	2	2	0	0	0	2
32265	530100	2	1	0	1	0	2
32265	530101	2	0	1	0	0	1
32265	530103	2	0	0	0	0	0
32265	530104	2	0	0	0	1	1
32265	530107	2	1	0	0	0	1
32265	530017	1	1	0	0	0	1
32265	530018	1	0	0	0	1	1
32265	530020	1	0	0	0	0	0
32265	530021	1	1	0	1	0	2
32265	530023	1	1	0	0	1	2
32265	530025	1	0	0	0	0	0
32265	530026	1	1	0	0	0	1
32265	530029	1	0	0	0	0	0
32265	530032	1	0	0	0	0	0
32265	530033	1	1	0	0	0	1
32265	530037	1	0	0	0	0	0
32265	530072	1	0	0	0	0	0
32265	530085	1	0	0	0	0	0
32265	530102	1	1	0	1	0	2
11648	399528	9	1	0	0	1	2
11648	399540	8	4	0	0	0	4
11648	399587	8	0	2	1	2	5
11648	399552	7	1	0	0	0	1
11648	399569	7	1	1	0	0	2
11648	399593	7	1	0	0	1	2
11648	399595	7	1	1	0	1	3
11648	399597	7	1	5	0	2	8
11648	399573	6	2	0	0	0	2
11648	399591	6	4	0	0	1	5
11648	399525	5	2	0	0	0	2
11648	399541	5	2	1	1	0	4
11648	399547	5	7	1	0	0	8
11648	399565	5	1	1	0	2	4
11648	399566	5	4	1	0	0	5
11648	399567	5	2	0	0	1	3
11648	399575	5	3	0	0	1	4
11648	399576	5	3	2	0	0	5
11648	399578	5	1	1	0	1	3
11648	399582	5	1	0	0	0	1
11648	399583	5	1	0	0	4	5
11648	399585	5	2	0	1	1	4
11648	399588	5	1	0	0	1	2
11648	399608	5	0	0	0	1	1
11648	399615	5	3	1	0	1	5
11648	399527	4	1	0	0	1	2
11648	399533	4	3	1	0	0	4
11648	399539	4	0	0	0	0	0
11648	399548	4	1	1	1	0	3
11648	399554	4	4	0	0	1	5
11648	399562	4	1	0	0	0	1
11648	399571	4	3	1	0	0	4
11648	399580	4	3	0	0	0	3
11648	399581	4	2	0	0	0	2
11648	399586	4	1	0	0	1	2
11648	399594	4	4	1	0	0	5
11648	399599	4	1	0	0	1	2
11648	399606	4	1	0	0	0	1
11648	399609	4	1	1	0	0	2
11648	399610	4	2	0	1	0	3
11648	207789	3	2	0	0	0	2
11648	399519	3	1	1	0	1	3
11648	399532	3	2	1	1	1	5
11648	399534	3	4	1	0	1	6
11648	399535	3	2	0	0	0	2
11648	399536	3	2	0	0	0	2
11648	399538	3	2	0	0	0	2
11648	399543	3	2	0	0	1	3
11648	399545	3	1	0	0	0	1
11648	399550	3	0	0	0	0	0
11648	399551	3	1	0	0	0	1
11648	399561	3	1	0	0	1	2
11648	399563	3	0	0	0	0	0
11648	399564	3	2	2	0	1	5
11648	399570	3	2	0	0	1	3
11648	399574	3	1	0	0	1	2
11648	399577	3	2	0	0	0	2
11648	399584	3	3	2	0	1	6
11648	399590	3	4	3	1	0	8
11648	399592	3	3	1	0	1	5
11648	399598	3	0	1	0	1	2
11648	399602	3	1	2	0	0	3
11648	399611	3	0	0	0	1	1
11648	399612	3	2	1	0	0	3
11648	399516	2	1	0	0	0	1
11648	399517	2	0	1	0	0	1
11648	399518	2	1	0	0	1	2
11648	399520	2	0	1	0	0	1
11648	399522	2	2	0	0	0	2
11648	399529	2	0	0	0	0	0
11648	399530	2	2	0	0	1	3
11648	399531	2	0	0	0	0	0
11648	399537	2	1	0	1	0	2
11648	399542	2	2	1	0	0	3
11648	399544	2	0	0	0	0	0
11648	399546	2	2	0	0	1	3
11648	399549	2	2	0	0	0	2
11648	399553	2	1	0	0	0	1
11648	399557	2	0	1	0	0	1
11648	399558	2	1	0	0	0	1
11648	399560	2	2	2	0	2	6
11648	399568	2	1	0	0	1	2
11648	399572	2	1	0	0	0	1
11648	399589	2	0	0	0	1	1
11648	399596	2	2	0	0	0	2
11648	399600	2	4	0	0	0	4
11648	399601	2	3	1	0	0	4
11648	399607	2	1	0	0	1	2
11648	399614	2	1	1	0	0	2
11648	399521	1	1	0	0	0	1
11648	399523	1	0	0	0	0	0
11648	399524	1	1	0	1	0	2
11648	399526	1	2	0	0	0	2
11648	399555	1	0	0	0	0	0
11648	399556	1	2	0	0	0	2
11648	399559	1	1	0	0	1	2
11648	399579	1	1	0	0	0	1
11648	399603	1	0	0	0	0	0
11648	399604	1	2	0	0	0	2
11648	399613	1	0	0	0	1	1
